county,office,candidate,party,precinct,mail_votes,early_votes,elec_day_votes,total_votes,district
Adair,President,Donald Trump,REP,10001,9,27,214,250,
Adair,President,Gary Johnson,LIB,10001,4,4,19,27,
Adair,President,Hillary Clinton,DEM,10001,4,2,72,78,
Adair,U.S. Senate,James Lankford,REP,10001,13,25,211,249,
Adair,U.S. Senate,Robert Murphy,LIB,10001,2,1,8,11,
Adair,U.S. Senate,Mike Workman,DEM,10001,0,6,73,79,
Adair,U.S. Senate,Mark Beard,IND,10001,0,0,4,4,
Adair,U.S. Senate,Sean Braddy,IND,10001,1,0,5,6,
Adair,U.S. House,Markwayne Mullin,REP,10001,14,25,245,284,02
Adair,U.S. House,Joshua Harris-Till,DEM,10001,2,5,54,61,02
Adair,U.S. House,John Mccarthy,IND,10001,1,3,9,13,02
Adair,State Senate,Wayne Shaw,REP,10001,7,21,141,169,3
Adair,State Senate,Rhonda Cox,DEM,10001,9,12,167,188,3
Adair,State House,Rhonda Hopkins,REP,10001,5,12,55,72,86
Adair,State House,Shannon Grimes,LIB,10001,3,1,8,12,86
Adair,State House,Will Fourkiller,DEM,10001,9,20,248,277,86
Adair,President,Donald Trump,REP,10002,4,21,201,226,
Adair,President,Gary Johnson,LIB,10002,0,1,10,11,
Adair,President,Hillary Clinton,DEM,10002,2,0,60,62,
Adair,U.S. Senate,James Lankford,REP,10002,5,18,192,215,
Adair,U.S. Senate,Robert Murphy,LIB,10002,0,1,8,9,
Adair,U.S. Senate,Mike Workman,DEM,10002,1,3,59,63,
Adair,U.S. Senate,Mark Beard,IND,10002,0,0,1,1,
Adair,U.S. Senate,Sean Braddy,IND,10002,0,0,4,4,
Adair,U.S. House,Markwayne Mullin,REP,10002,5,19,207,231,02
Adair,U.S. House,Joshua Harris-Till,DEM,10002,0,2,47,49,02
Adair,U.S. House,John Mccarthy,IND,10002,1,0,11,12,02
Adair,State Senate,Wayne Shaw,REP,10002,4,14,157,175,3
Adair,State Senate,Rhonda Cox,DEM,10002,2,7,106,115,3
Adair,State House,Rhonda Hopkins,REP,10002,4,9,82,95,86
Adair,State House,Shannon Grimes,LIB,10002,0,0,6,6,86
Adair,State House,Will Fourkiller,DEM,10002,2,12,182,196,86
Adair,President,Donald Trump,REP,10003,5,0,91,96,
Adair,President,Gary Johnson,LIB,10003,0,0,2,2,
Adair,President,Hillary Clinton,DEM,10003,1,0,31,32,
Adair,U.S. Senate,James Lankford,REP,10003,5,0,88,93,
Adair,U.S. Senate,Robert Murphy,LIB,10003,0,0,1,1,
Adair,U.S. Senate,Mike Workman,DEM,10003,1,0,38,39,
Adair,U.S. Senate,Mark Beard,IND,10003,0,0,0,0,
Adair,U.S. Senate,Sean Braddy,IND,10003,0,0,1,1,
Adair,U.S. House,Markwayne Mullin,REP,10003,5,0,88,93,02
Adair,U.S. House,Joshua Harris-Till,DEM,10003,1,0,33,34,02
Adair,U.S. House,John Mccarthy,IND,10003,0,0,7,7,02
Adair,State Senate,Wayne Shaw,REP,10003,5,0,61,66,3
Adair,State Senate,Rhonda Cox,DEM,10003,1,0,65,66,3
Adair,State House,Rhonda Hopkins,REP,10003,3,0,49,52,86
Adair,State House,Shannon Grimes,LIB,10003,0,0,2,2,86
Adair,State House,Will Fourkiller,DEM,10003,3,0,75,78,86
Adair,President,Donald Trump,REP,10004,8,36,154,198,
Adair,President,Gary Johnson,LIB,10004,0,2,16,18,
Adair,President,Hillary Clinton,DEM,10004,3,14,54,71,
Adair,U.S. Senate,James Lankford,REP,10004,7,35,156,198,
Adair,U.S. Senate,Robert Murphy,LIB,10004,0,2,4,6,
Adair,U.S. Senate,Mike Workman,DEM,10004,3,13,58,74,
Adair,U.S. Senate,Mark Beard,IND,10004,1,1,3,5,
Adair,U.S. Senate,Sean Braddy,IND,10004,0,1,3,4,
Adair,U.S. House,Markwayne Mullin,REP,10004,7,42,168,217,02
Adair,U.S. House,Joshua Harris-Till,DEM,10004,3,9,41,53,02
Adair,U.S. House,John Mccarthy,IND,10004,1,1,16,18,02
Adair,State Senate,Wayne Shaw,REP,10004,8,26,119,153,3
Adair,State Senate,Rhonda Cox,DEM,10004,3,26,105,134,3
Adair,State House,Rhonda Hopkins,REP,10004,1,8,49,58,86
Adair,State House,Shannon Grimes,LIB,10004,2,1,4,7,86
Adair,State House,Will Fourkiller,DEM,10004,8,43,174,225,86
Adair,President,Donald Trump,REP,10005,8,12,155,175,
Adair,President,Gary Johnson,LIB,10005,0,1,12,13,
Adair,President,Hillary Clinton,DEM,10005,1,4,40,45,
Adair,U.S. Senate,James Lankford,REP,10005,8,14,166,188,
Adair,U.S. Senate,Robert Murphy,LIB,10005,0,0,2,2,
Adair,U.S. Senate,Mike Workman,DEM,10005,0,1,34,35,
Adair,U.S. Senate,Mark Beard,IND,10005,1,1,1,3,
Adair,U.S. Senate,Sean Braddy,IND,10005,1,0,1,2,
Adair,U.S. House,Markwayne Mullin,REP,10005,9,14,168,191,02
Adair,U.S. House,Joshua Harris-Till,DEM,10005,1,1,32,34,02
Adair,U.S. House,John Mccarthy,IND,10005,0,2,8,10,02
Adair,State Senate,Wayne Shaw,REP,10005,5,10,120,135,3
Adair,State Senate,Rhonda Cox,DEM,10005,5,4,81,90,3
Adair,State House,Rhonda Hopkins,REP,10005,2,5,49,56,86
Adair,State House,Shannon Grimes,LIB,10005,1,1,7,9,86
Adair,State House,Will Fourkiller,DEM,10005,6,10,152,168,86
Adair,President,Donald Trump,REP,10006,10,27,308,345,
Adair,President,Gary Johnson,LIB,10006,0,2,19,21,
Adair,President,Hillary Clinton,DEM,10006,0,17,75,92,
Adair,U.S. Senate,James Lankford,REP,10006,10,24,287,321,
Adair,U.S. Senate,Robert Murphy,LIB,10006,0,1,6,7,
Adair,U.S. Senate,Mike Workman,DEM,10006,0,19,90,109,
Adair,U.S. Senate,Mark Beard,IND,10006,0,1,12,13,
Adair,U.S. Senate,Sean Braddy,IND,10006,0,3,3,6,
Adair,U.S. House,Markwayne Mullin,REP,10006,10,27,332,369,02
Adair,U.S. House,Joshua Harris-Till,DEM,10006,0,18,55,73,02
Adair,U.S. House,John Mccarthy,IND,10006,0,3,13,16,02
Adair,State Senate,Wayne Shaw,REP,10006,9,23,198,230,3
Adair,State Senate,Rhonda Cox,DEM,10006,1,25,207,233,3
Adair,State House,Rhonda Hopkins,REP,10006,5,13,100,118,86
Adair,State House,Shannon Grimes,LIB,10006,0,2,3,5,86
Adair,State House,Will Fourkiller,DEM,10006,5,34,304,343,86
Adair,President,Donald Trump,REP,10007,18,49,295,362,
Adair,President,Gary Johnson,LIB,10007,1,0,15,16,
Adair,President,Hillary Clinton,DEM,10007,5,22,128,155,
Adair,U.S. Senate,James Lankford,REP,10007,19,48,291,358,
Adair,U.S. Senate,Robert Murphy,LIB,10007,0,0,3,3,
Adair,U.S. Senate,Mike Workman,DEM,10007,4,21,132,157,
Adair,U.S. Senate,Mark Beard,IND,10007,0,0,5,5,
Adair,U.S. Senate,Sean Braddy,IND,10007,0,0,8,8,
Adair,U.S. House,Markwayne Mullin,REP,10007,22,50,329,401,02
Adair,U.S. House,Joshua Harris-Till,DEM,10007,2,18,89,109,02
Adair,U.S. House,John Mccarthy,IND,10007,0,2,23,25,02
Adair,State Senate,Wayne Shaw,REP,10007,11,42,224,277,3
Adair,State Senate,Rhonda Cox,DEM,10007,12,29,216,257,3
Adair,State House,Rhonda Hopkins,REP,10007,5,21,88,114,86
Adair,State House,Shannon Grimes,LIB,10007,2,0,8,10,86
Adair,State House,Will Fourkiller,DEM,10007,16,49,343,408,86
Adair,President,Donald Trump,REP,10008,6,17,233,256,
Adair,President,Gary Johnson,LIB,10008,1,4,20,25,
Adair,President,Hillary Clinton,DEM,10008,2,15,71,88,
Adair,U.S. Senate,James Lankford,REP,10008,4,15,233,252,
Adair,U.S. Senate,Robert Murphy,LIB,10008,0,1,8,9,
Adair,U.S. Senate,Mike Workman,DEM,10008,4,17,70,91,
Adair,U.S. Senate,Mark Beard,IND,10008,0,1,8,9,
Adair,U.S. Senate,Sean Braddy,IND,10008,1,0,5,6,
Adair,U.S. House,Markwayne Mullin,REP,10008,6,25,259,290,02
Adair,U.S. House,Joshua Harris-Till,DEM,10008,3,10,58,71,02
Adair,U.S. House,John Mccarthy,IND,10008,0,1,12,13,02
Adair,State Senate,Wayne Shaw,REP,10008,2,16,165,183,3
Adair,State Senate,Rhonda Cox,DEM,10008,7,20,161,188,3
Adair,State House,Rhonda Hopkins,REP,10008,2,8,62,72,86
Adair,State House,Shannon Grimes,LIB,10008,0,1,10,11,86
Adair,State House,Will Fourkiller,DEM,10008,6,27,257,290,86
Adair,President,Donald Trump,REP,10010,3,4,67,74,
Adair,President,Gary Johnson,LIB,10010,0,2,7,9,
Adair,President,Hillary Clinton,DEM,10010,0,1,25,26,
Adair,U.S. Senate,James Lankford,REP,10010,3,5,62,70,
Adair,U.S. Senate,Robert Murphy,LIB,10010,0,0,2,2,
Adair,U.S. Senate,Mike Workman,DEM,10010,1,1,29,31,
Adair,U.S. Senate,Mark Beard,IND,10010,0,1,2,3,
Adair,U.S. Senate,Sean Braddy,IND,10010,0,1,4,5,
Adair,U.S. House,Markwayne Mullin,REP,10010,4,5,75,84,02
Adair,U.S. House,Joshua Harris-Till,DEM,10010,0,1,21,22,02
Adair,U.S. House,John Mccarthy,IND,10010,0,1,3,4,02
Adair,State Senate,Wayne Shaw,REP,10010,0,4,46,50,3
Adair,State Senate,Rhonda Cox,DEM,10010,4,3,54,61,3
Adair,State House,Rhonda Hopkins,REP,10010,0,3,21,24,86
Adair,State House,Shannon Grimes,LIB,10010,0,0,4,4,86
Adair,State House,Will Fourkiller,DEM,10010,4,4,75,83,86
Adair,President,Donald Trump,REP,10011,5,13,110,128,
Adair,President,Gary Johnson,LIB,10011,0,3,19,22,
Adair,President,Hillary Clinton,DEM,10011,1,6,34,41,
Adair,U.S. Senate,James Lankford,REP,10011,5,16,114,135,
Adair,U.S. Senate,Robert Murphy,LIB,10011,0,0,3,3,
Adair,U.S. Senate,Mike Workman,DEM,10011,2,6,38,46,
Adair,U.S. Senate,Mark Beard,IND,10011,0,0,3,3,
Adair,U.S. Senate,Sean Braddy,IND,10011,0,0,7,7,
Adair,U.S. House,Markwayne Mullin,REP,10011,5,17,129,151,02
Adair,U.S. House,Joshua Harris-Till,DEM,10011,2,4,19,25,02
Adair,U.S. House,John Mccarthy,IND,10011,0,1,16,17,02
Adair,State Senate,Wayne Shaw,REP,10011,5,13,105,123,3
Adair,State Senate,Rhonda Cox,DEM,10011,2,9,58,69,3
Adair,State House,Rhonda Hopkins,REP,10011,3,10,42,55,86
Adair,State House,Shannon Grimes,LIB,10011,0,1,11,12,86
Adair,State House,Will Fourkiller,DEM,10011,4,11,113,128,86
Adair,President,Donald Trump,REP,10012,9,28,283,320,
Adair,President,Gary Johnson,LIB,10012,1,1,8,10,
Adair,President,Hillary Clinton,DEM,10012,6,6,50,62,
Adair,U.S. Senate,James Lankford,REP,10012,9,28,253,290,
Adair,U.S. Senate,Robert Murphy,LIB,10012,0,1,6,7,
Adair,U.S. Senate,Mike Workman,DEM,10012,6,6,73,85,
Adair,U.S. Senate,Mark Beard,IND,10012,0,0,4,4,
Adair,U.S. Senate,Sean Braddy,IND,10012,0,0,3,3,
Adair,U.S. House,Markwayne Mullin,REP,10012,10,27,282,319,02
Adair,U.S. House,Joshua Harris-Till,DEM,10012,5,5,51,61,02
Adair,U.S. House,John Mccarthy,IND,10012,0,2,14,16,02
Adair,State Senate,Wayne Shaw,REP,10012,7,25,209,241,3
Adair,State Senate,Rhonda Cox,DEM,10012,8,10,132,150,3
Adair,State House,Rhonda Hopkins,REP,10012,3,12,103,118,86
Adair,State House,Shannon Grimes,LIB,10012,1,3,10,14,86
Adair,State House,Will Fourkiller,DEM,10012,11,20,231,262,86
Adair,President,Donald Trump,REP,10013,6,22,183,211,
Adair,President,Gary Johnson,LIB,10013,0,0,15,15,
Adair,President,Hillary Clinton,DEM,10013,2,8,72,82,
Adair,U.S. Senate,James Lankford,REP,10013,7,22,189,218,
Adair,U.S. Senate,Robert Murphy,LIB,10013,0,0,3,3,
Adair,U.S. Senate,Mike Workman,DEM,10013,1,7,73,81,
Adair,U.S. Senate,Mark Beard,IND,10013,0,1,4,5,
Adair,U.S. Senate,Sean Braddy,IND,10013,0,0,2,2,
Adair,U.S. House,Markwayne Mullin,REP,10013,7,24,204,235,02
Adair,U.S. House,Joshua Harris-Till,DEM,10013,1,7,58,66,02
Adair,U.S. House,John Mccarthy,IND,10013,0,0,8,8,02
Adair,State Senate,Wayne Shaw,REP,10013,4,15,128,147,3
Adair,State Senate,Rhonda Cox,DEM,10013,4,16,139,159,3
Adair,State House,Rhonda Hopkins,REP,10013,1,4,58,63,86
Adair,State House,Shannon Grimes,LIB,10013,0,1,4,5,86
Adair,State House,Will Fourkiller,DEM,10013,7,26,208,241,86
Adair,President,Donald Trump,REP,10014,8,48,300,356,
Adair,President,Gary Johnson,LIB,10014,4,5,42,51,
Adair,President,Hillary Clinton,DEM,10014,3,17,113,133,
Adair,U.S. Senate,James Lankford,REP,10014,7,44,288,339,
Adair,U.S. Senate,Robert Murphy,LIB,10014,2,1,8,11,
Adair,U.S. Senate,Mike Workman,DEM,10014,4,22,143,169,
Adair,U.S. Senate,Mark Beard,IND,10014,0,1,7,8,
Adair,U.S. Senate,Sean Braddy,IND,10014,1,1,6,8,
Adair,U.S. House,Markwayne Mullin,REP,10014,10,55,347,412,02
Adair,U.S. House,Joshua Harris-Till,DEM,10014,2,11,92,105,02
Adair,U.S. House,John Mccarthy,IND,10014,1,4,17,22,02
Adair,State Senate,Wayne Shaw,REP,10014,6,35,212,253,3
Adair,State Senate,Rhonda Cox,DEM,10014,7,35,241,283,3
Adair,State House,Rhonda Hopkins,REP,10014,2,16,102,120,86
Adair,State House,Shannon Grimes,LIB,10014,3,2,6,11,86
Adair,State House,Will Fourkiller,DEM,10014,10,52,349,411,86
Adair,President,Donald Trump,REP,10016,13,9,262,284,
Adair,President,Gary Johnson,LIB,10016,2,2,24,28,
Adair,President,Hillary Clinton,DEM,10016,5,1,45,51,
Adair,U.S. Senate,James Lankford,REP,10016,14,8,269,291,
Adair,U.S. Senate,Robert Murphy,LIB,10016,1,2,13,16,
Adair,U.S. Senate,Mike Workman,DEM,10016,5,2,42,49,
Adair,U.S. Senate,Mark Beard,IND,10016,0,0,6,6,
Adair,U.S. Senate,Sean Braddy,IND,10016,0,0,3,3,
Adair,U.S. House,Markwayne Mullin,REP,10016,15,9,281,305,02
Adair,U.S. House,Joshua Harris-Till,DEM,10016,4,1,41,46,02
Adair,U.S. House,John Mccarthy,IND,10016,1,2,11,14,02
Adair,State Senate,Wayne Shaw,REP,10016,11,9,250,270,3
Adair,State Senate,Rhonda Cox,DEM,10016,9,3,80,92,3
Adair,State House,Rhonda Hopkins,REP,10016,8,8,177,193,86
Adair,State House,Shannon Grimes,LIB,10016,1,3,21,25,86
Adair,State House,Will Fourkiller,DEM,10016,11,1,130,142,86
Adair,President,Donald Trump,REP,10017,18,15,453,486,
Adair,President,Gary Johnson,LIB,10017,0,2,14,16,
Adair,President,Hillary Clinton,DEM,10017,23,6,96,125,
Adair,U.S. Senate,James Lankford,REP,10017,15,14,412,441,
Adair,U.S. Senate,Robert Murphy,LIB,10017,0,2,7,9,
Adair,U.S. Senate,Mike Workman,DEM,10017,15,8,114,137,
Adair,U.S. Senate,Mark Beard,IND,10017,0,0,9,9,
Adair,U.S. Senate,Sean Braddy,IND,10017,3,0,13,16,
Adair,U.S. House,Markwayne Mullin,REP,10017,12,17,450,479,02
Adair,U.S. House,Joshua Harris-Till,DEM,10017,26,4,94,124,02
Adair,U.S. House,John Mccarthy,IND,10017,2,2,22,26,02
Adair,State Senate,Wayne Shaw,REP,10017,14,16,354,384,3
Adair,State Senate,Rhonda Cox,DEM,10017,26,8,207,241,3
Adair,State House,Rhonda Hopkins,REP,10017,8,12,237,257,86
Adair,State House,Shannon Grimes,LIB,10017,1,2,24,27,86
Adair,State House,Will Fourkiller,DEM,10017,30,10,302,342,86
Adair,President,Donald Trump,REP,10018,16,17,399,432,
Adair,President,Gary Johnson,LIB,10018,7,1,17,25,
Adair,President,Hillary Clinton,DEM,10018,5,14,108,127,
Adair,U.S. Senate,James Lankford,REP,10018,14,16,355,385,
Adair,U.S. Senate,Robert Murphy,LIB,10018,4,1,11,16,
Adair,U.S. Senate,Mike Workman,DEM,10018,9,14,128,151,
Adair,U.S. Senate,Mark Beard,IND,10018,0,0,9,9,
Adair,U.S. Senate,Sean Braddy,IND,10018,1,1,16,18,
Adair,U.S. House,Markwayne Mullin,REP,10018,18,17,413,448,02
Adair,U.S. House,Joshua Harris-Till,DEM,10018,8,14,92,114,02
Adair,U.S. House,John Mccarthy,IND,10018,2,2,20,24,02
Adair,State Senate,Wayne Shaw,REP,10018,11,12,252,275,3
Adair,State Senate,Rhonda Cox,DEM,10018,17,20,268,305,3
Adair,State House,Rhonda Hopkins,REP,10018,4,11,153,168,86
Adair,State House,Shannon Grimes,LIB,10018,3,2,20,25,86
Adair,State House,Will Fourkiller,DEM,10018,19,19,349,387,86
Adair,President,Donald Trump,REP,10019,8,32,548,588,
Adair,President,Gary Johnson,LIB,10019,3,2,30,35,
Adair,President,Hillary Clinton,DEM,10019,10,4,98,112,
Adair,U.S. Senate,James Lankford,REP,10019,7,28,498,533,
Adair,U.S. Senate,Robert Murphy,LIB,10019,0,2,8,10,
Adair,U.S. Senate,Mike Workman,DEM,10019,11,5,140,156,
Adair,U.S. Senate,Mark Beard,IND,10019,2,1,13,16,
Adair,U.S. Senate,Sean Braddy,IND,10019,0,1,10,11,
Adair,U.S. House,Markwayne Mullin,REP,10019,11,28,549,588,02
Adair,U.S. House,Joshua Harris-Till,DEM,10019,9,6,94,109,02
Adair,U.S. House,John Mccarthy,IND,10019,1,4,31,36,02
Adair,State Senate,Wayne Shaw,REP,10019,8,21,372,401,3
Adair,State Senate,Rhonda Cox,DEM,10019,11,15,299,325,3
Adair,State House,Rhonda Hopkins,REP,10019,3,9,227,239,86
Adair,State House,Shannon Grimes,LIB,10019,0,3,28,31,86
Adair,State House,Will Fourkiller,DEM,10019,17,25,423,465,86
Alfalfa,President,Donald Trump,REP,20110,7,23,145,175,
Alfalfa,President,Gary Johnson,LIB,20110,0,0,4,4,
Alfalfa,President,Hillary Clinton,DEM,20110,0,0,15,15,
Alfalfa,U.S. Senate,James Lankford,REP,20110,7,23,150,180,
Alfalfa,U.S. Senate,Robert Murphy,LIB,20110,0,0,1,1,
Alfalfa,U.S. Senate,Mike Workman,DEM,20110,0,0,13,13,
Alfalfa,U.S. Senate,Mark Beard,IND,20110,0,0,2,2,
Alfalfa,U.S. Senate,Sean Braddy,IND,20110,0,0,2,2,
Alfalfa,U.S. House,Frank Lucas,REP,20110,6,23,153,182,03
Alfalfa,U.S. House,Frankie Robbins,DEM,20110,1,0,16,17,03
Alfalfa,State Senate,Roland Pederson,REP,20110,7,23,162,192,19
Alfalfa,State Senate,Rhonda Harlow,DEM,20110,0,0,4,4,19
Alfalfa,State Senate,Whitney Hall,IND,20110,0,0,4,4,19
Alfalfa,President,Donald Trump,REP,20120,19,25,143,187,
Alfalfa,President,Gary Johnson,LIB,20120,2,1,4,7,
Alfalfa,President,Hillary Clinton,DEM,20120,0,1,14,15,
Alfalfa,U.S. Senate,James Lankford,REP,20120,20,24,145,189,
Alfalfa,U.S. Senate,Robert Murphy,LIB,20120,0,0,4,4,
Alfalfa,U.S. Senate,Mike Workman,DEM,20120,0,3,7,10,
Alfalfa,U.S. Senate,Mark Beard,IND,20120,1,0,2,3,
Alfalfa,U.S. Senate,Sean Braddy,IND,20120,0,0,0,0,
Alfalfa,U.S. House,Frank Lucas,REP,20120,18,26,147,191,03
Alfalfa,U.S. House,Frankie Robbins,DEM,20120,2,1,11,14,03
Alfalfa,State Senate,Roland Pederson,REP,20120,21,24,148,193,19
Alfalfa,State Senate,Rhonda Harlow,DEM,20120,0,1,7,8,19
Alfalfa,State Senate,Whitney Hall,IND,20120,0,2,5,7,19
Alfalfa,President,Donald Trump,REP,20140,5,62,279,346,
Alfalfa,President,Gary Johnson,LIB,20140,1,2,17,20,
Alfalfa,President,Hillary Clinton,DEM,20140,2,6,23,31,
Alfalfa,U.S. Senate,James Lankford,REP,20140,5,62,272,339,
Alfalfa,U.S. Senate,Robert Murphy,LIB,20140,1,0,7,8,
Alfalfa,U.S. Senate,Mike Workman,DEM,20140,2,6,28,36,
Alfalfa,U.S. Senate,Mark Beard,IND,20140,0,2,6,8,
Alfalfa,U.S. Senate,Sean Braddy,IND,20140,0,0,6,6,
Alfalfa,U.S. House,Frank Lucas,REP,20140,6,63,281,350,03
Alfalfa,U.S. House,Frankie Robbins,DEM,20140,2,7,39,48,03
Alfalfa,State Senate,Roland Pederson,REP,20140,6,61,272,339,19
Alfalfa,State Senate,Rhonda Harlow,DEM,20140,1,6,32,39,19
Alfalfa,State Senate,Whitney Hall,IND,20140,1,3,15,19,19
Alfalfa,President,Donald Trump,REP,20220,26,75,257,358,
Alfalfa,President,Gary Johnson,LIB,20220,1,0,29,30,
Alfalfa,President,Hillary Clinton,DEM,20220,6,14,43,63,
Alfalfa,U.S. Senate,James Lankford,REP,20220,28,79,285,392,
Alfalfa,U.S. Senate,Robert Murphy,LIB,20220,0,0,6,6,
Alfalfa,U.S. Senate,Mike Workman,DEM,20220,4,10,25,39,
Alfalfa,U.S. Senate,Mark Beard,IND,20220,0,1,10,11,
Alfalfa,U.S. Senate,Sean Braddy,IND,20220,0,0,5,5,
Alfalfa,U.S. House,Frank Lucas,REP,20220,23,77,295,395,03
Alfalfa,U.S. House,Frankie Robbins,DEM,20220,8,12,33,53,03
Alfalfa,State Senate,Roland Pederson,REP,20220,28,75,292,395,19
Alfalfa,State Senate,Rhonda Harlow,DEM,20220,4,9,24,37,19
Alfalfa,State Senate,Whitney Hall,IND,20220,1,6,15,22,19
Alfalfa,President,Donald Trump,REP,20230,11,13,227,251,
Alfalfa,President,Gary Johnson,LIB,20230,2,1,13,16,
Alfalfa,President,Hillary Clinton,DEM,20230,3,0,26,29,
Alfalfa,U.S. Senate,James Lankford,REP,20230,13,13,223,249,
Alfalfa,U.S. Senate,Robert Murphy,LIB,20230,0,0,9,9,
Alfalfa,U.S. Senate,Mike Workman,DEM,20230,2,1,24,27,
Alfalfa,U.S. Senate,Mark Beard,IND,20230,0,0,8,8,
Alfalfa,U.S. Senate,Sean Braddy,IND,20230,0,0,4,4,
Alfalfa,U.S. House,Frank Lucas,REP,20230,12,13,224,249,03
Alfalfa,U.S. House,Frankie Robbins,DEM,20230,3,1,44,48,03
Alfalfa,State Senate,Roland Pederson,REP,20230,10,10,199,219,19
Alfalfa,State Senate,Rhonda Harlow,DEM,20230,4,1,40,45,19
Alfalfa,State Senate,Whitney Hall,IND,20230,1,3,27,31,19
Alfalfa,President,Donald Trump,REP,20310,4,9,260,273,
Alfalfa,President,Gary Johnson,LIB,20310,1,1,14,16,
Alfalfa,President,Hillary Clinton,DEM,20310,2,1,33,36,
Alfalfa,U.S. Senate,James Lankford,REP,20310,6,12,273,291,
Alfalfa,U.S. Senate,Robert Murphy,LIB,20310,0,0,7,7,
Alfalfa,U.S. Senate,Mike Workman,DEM,20310,1,0,18,19,
Alfalfa,U.S. Senate,Mark Beard,IND,20310,0,0,6,6,
Alfalfa,U.S. Senate,Sean Braddy,IND,20310,0,0,3,3,
Alfalfa,U.S. House,Frank Lucas,REP,20310,7,12,276,295,03
Alfalfa,U.S. House,Frankie Robbins,DEM,20310,0,0,29,29,03
Alfalfa,State Senate,Roland Pederson,REP,20310,5,12,252,269,19
Alfalfa,State Senate,Rhonda Harlow,DEM,20310,1,0,32,33,19
Alfalfa,State Senate,Whitney Hall,IND,20310,1,0,22,23,19
Alfalfa,President,Donald Trump,REP,20320,5,4,146,155,
Alfalfa,President,Gary Johnson,LIB,20320,1,3,7,11,
Alfalfa,President,Hillary Clinton,DEM,20320,1,0,16,17,
Alfalfa,U.S. Senate,James Lankford,REP,20320,6,7,142,155,
Alfalfa,U.S. Senate,Robert Murphy,LIB,20320,0,0,3,3,
Alfalfa,U.S. Senate,Mike Workman,DEM,20320,1,0,15,16,
Alfalfa,U.S. Senate,Mark Beard,IND,20320,0,0,6,6,
Alfalfa,U.S. Senate,Sean Braddy,IND,20320,0,0,3,3,
Alfalfa,U.S. House,Frank Lucas,REP,20320,6,7,140,153,03
Alfalfa,U.S. House,Frankie Robbins,DEM,20320,1,0,28,29,03
Alfalfa,State Senate,Roland Pederson,REP,20320,5,2,133,140,19
Alfalfa,State Senate,Rhonda Harlow,DEM,20320,1,0,17,18,19
Alfalfa,State Senate,Whitney Hall,IND,20320,1,5,19,25,19
Alfalfa,President,Donald Trump,REP,20330,4,12,172,188,
Alfalfa,President,Gary Johnson,LIB,20330,0,0,5,5,
Alfalfa,President,Hillary Clinton,DEM,20330,0,1,9,10,
Alfalfa,U.S. Senate,James Lankford,REP,20330,4,11,172,187,
Alfalfa,U.S. Senate,Robert Murphy,LIB,20330,0,1,1,2,
Alfalfa,U.S. Senate,Mike Workman,DEM,20330,0,1,8,9,
Alfalfa,U.S. Senate,Mark Beard,IND,20330,0,0,2,2,
Alfalfa,U.S. Senate,Sean Braddy,IND,20330,0,0,2,2,
Alfalfa,U.S. House,Frank Lucas,REP,20330,4,11,168,183,03
Alfalfa,U.S. House,Frankie Robbins,DEM,20330,0,2,16,18,03
Alfalfa,State Senate,Roland Pederson,REP,20330,4,12,172,188,19
Alfalfa,State Senate,Rhonda Harlow,DEM,20330,0,1,8,9,19
Alfalfa,State Senate,Whitney Hall,IND,20330,0,0,6,6,19
Atoka,President,Donald Trump,REP,30001,17,130,302,449,
Atoka,President,Gary Johnson,LIB,30001,0,7,10,17,
Atoka,President,Hillary Clinton,DEM,30001,4,27,72,103,
Atoka,U.S. Senate,James Lankford,REP,30001,15,119,256,390,
Atoka,U.S. Senate,Robert Murphy,LIB,30001,0,4,9,13,
Atoka,U.S. Senate,Mike Workman,DEM,30001,5,33,97,135,
Atoka,U.S. Senate,Mark Beard,IND,30001,1,1,8,10,
Atoka,U.S. Senate,Sean Braddy,IND,30001,0,6,8,14,
Atoka,U.S. House,Markwayne Mullin,REP,30001,14,123,278,415,02
Atoka,U.S. House,Joshua Harris-Till,DEM,30001,5,31,83,119,02
Atoka,U.S. House,John Mccarthy,IND,30001,2,8,19,29,02
Atoka,President,Donald Trump,REP,30002,24,82,212,318,
Atoka,President,Gary Johnson,LIB,30002,0,2,5,7,
Atoka,President,Hillary Clinton,DEM,30002,11,21,37,69,
Atoka,U.S. Senate,James Lankford,REP,30002,22,77,194,293,
Atoka,U.S. Senate,Robert Murphy,LIB,30002,0,3,3,6,
Atoka,U.S. Senate,Mike Workman,DEM,30002,7,18,50,75,
Atoka,U.S. Senate,Mark Beard,IND,30002,2,2,1,5,
Atoka,U.S. Senate,Sean Braddy,IND,30002,4,3,1,8,
Atoka,U.S. House,Markwayne Mullin,REP,30002,25,80,200,305,02
Atoka,U.S. House,Joshua Harris-Till,DEM,30002,9,19,48,76,02
Atoka,U.S. House,John Mccarthy,IND,30002,1,4,2,7,02
Atoka,President,Donald Trump,REP,30003,5,68,151,224,
Atoka,President,Gary Johnson,LIB,30003,0,3,7,10,
Atoka,President,Hillary Clinton,DEM,30003,3,31,61,95,
Atoka,U.S. Senate,James Lankford,REP,30003,5,67,121,193,
Atoka,U.S. Senate,Robert Murphy,LIB,30003,0,0,3,3,
Atoka,U.S. Senate,Mike Workman,DEM,30003,3,33,75,111,
Atoka,U.S. Senate,Mark Beard,IND,30003,0,2,8,10,
Atoka,U.S. Senate,Sean Braddy,IND,30003,0,1,8,9,
Atoka,U.S. House,Markwayne Mullin,REP,30003,5,75,133,213,02
Atoka,U.S. House,Joshua Harris-Till,DEM,30003,3,23,61,87,02
Atoka,U.S. House,John Mccarthy,IND,30003,0,3,17,20,02
Atoka,President,Donald Trump,REP,30006,10,45,153,208,
Atoka,President,Gary Johnson,LIB,30006,2,2,8,12,
Atoka,President,Hillary Clinton,DEM,30006,4,14,28,46,
Atoka,U.S. Senate,James Lankford,REP,30006,8,43,128,179,
Atoka,U.S. Senate,Robert Murphy,LIB,30006,0,0,2,2,
Atoka,U.S. Senate,Mike Workman,DEM,30006,5,17,50,72,
Atoka,U.S. Senate,Mark Beard,IND,30006,1,0,3,4,
Atoka,U.S. Senate,Sean Braddy,IND,30006,1,1,4,6,
Atoka,U.S. House,Markwayne Mullin,REP,30006,8,43,149,200,02
Atoka,U.S. House,Joshua Harris-Till,DEM,30006,2,16,31,49,02
Atoka,U.S. House,John Mccarthy,IND,30006,5,2,7,14,02
Atoka,President,Donald Trump,REP,30007,7,65,284,356,
Atoka,President,Gary Johnson,LIB,30007,0,2,14,16,
Atoka,President,Hillary Clinton,DEM,30007,3,4,59,66,
Atoka,U.S. Senate,James Lankford,REP,30007,9,52,234,295,
Atoka,U.S. Senate,Robert Murphy,LIB,30007,0,3,7,10,
Atoka,U.S. Senate,Mike Workman,DEM,30007,0,11,94,105,
Atoka,U.S. Senate,Mark Beard,IND,30007,0,1,7,8,
Atoka,U.S. Senate,Sean Braddy,IND,30007,0,2,7,9,
Atoka,U.S. House,Markwayne Mullin,REP,30007,8,56,267,331,02
Atoka,U.S. House,Joshua Harris-Till,DEM,30007,1,10,68,79,02
Atoka,U.S. House,John Mccarthy,IND,30007,0,5,21,26,02
Atoka,President,Donald Trump,REP,30008,19,67,526,612,
Atoka,President,Gary Johnson,LIB,30008,0,3,19,22,
Atoka,President,Hillary Clinton,DEM,30008,6,11,82,99,
Atoka,U.S. Senate,James Lankford,REP,30008,17,62,424,503,
Atoka,U.S. Senate,Robert Murphy,LIB,30008,0,0,17,17,
Atoka,U.S. Senate,Mike Workman,DEM,30008,9,14,146,169,
Atoka,U.S. Senate,Mark Beard,IND,30008,0,1,8,9,
Atoka,U.S. Senate,Sean Braddy,IND,30008,0,0,14,14,
Atoka,U.S. House,Markwayne Mullin,REP,30008,17,58,471,546,02
Atoka,U.S. House,Joshua Harris-Till,DEM,30008,7,13,100,120,02
Atoka,U.S. House,John Mccarthy,IND,30008,1,5,38,44,02
Atoka,President,Donald Trump,REP,30009,9,89,261,359,
Atoka,President,Gary Johnson,LIB,30009,1,1,7,9,
Atoka,President,Hillary Clinton,DEM,30009,1,11,49,61,
Atoka,U.S. Senate,James Lankford,REP,30009,7,80,219,306,
Atoka,U.S. Senate,Robert Murphy,LIB,30009,0,0,2,2,
Atoka,U.S. Senate,Mike Workman,DEM,30009,4,16,78,98,
Atoka,U.S. Senate,Mark Beard,IND,30009,0,1,5,6,
Atoka,U.S. Senate,Sean Braddy,IND,30009,0,1,6,7,
Atoka,U.S. House,Markwayne Mullin,REP,30009,7,88,243,338,02
Atoka,U.S. House,Joshua Harris-Till,DEM,30009,3,10,55,68,02
Atoka,U.S. House,John Mccarthy,IND,30009,1,2,16,19,02
Atoka,President,Donald Trump,REP,30010,4,8,132,144,
Atoka,President,Gary Johnson,LIB,30010,1,0,2,3,
Atoka,President,Hillary Clinton,DEM,30010,3,0,13,16,
Atoka,U.S. Senate,James Lankford,REP,30010,3,7,118,128,
Atoka,U.S. Senate,Robert Murphy,LIB,30010,1,0,3,4,
Atoka,U.S. Senate,Mike Workman,DEM,30010,4,0,17,21,
Atoka,U.S. Senate,Mark Beard,IND,30010,0,0,6,6,
Atoka,U.S. Senate,Sean Braddy,IND,30010,0,1,2,3,
Atoka,U.S. House,Markwayne Mullin,REP,30010,4,7,123,134,02
Atoka,U.S. House,Joshua Harris-Till,DEM,30010,4,0,15,19,02
Atoka,U.S. House,John Mccarthy,IND,30010,0,1,8,9,02
Atoka,State Senate,Joseph Silk,REP,30010,3,8,99,110,5
Atoka,State Senate,Stacey Allen Ebert,DEM,30010,5,0,45,50,5
Atoka,State House,Justin Humphrey,REP,30010,3,7,97,107,19
Atoka,State House,James Albert Campbell,DEM,30010,5,0,34,39,19
Atoka,State House,Morgan Hopson,IND,30010,0,1,11,12,19
Atoka,President,Donald Trump,REP,30011,20,181,451,652,
Atoka,President,Gary Johnson,LIB,30011,1,3,19,23,
Atoka,President,Hillary Clinton,DEM,30011,7,35,89,131,
Atoka,U.S. Senate,James Lankford,REP,30011,19,142,362,523,
Atoka,U.S. Senate,Robert Murphy,LIB,30011,0,3,12,15,
Atoka,U.S. Senate,Mike Workman,DEM,30011,6,58,142,206,
Atoka,U.S. Senate,Mark Beard,IND,30011,1,5,15,21,
Atoka,U.S. Senate,Sean Braddy,IND,30011,0,9,15,24,
Atoka,U.S. House,Markwayne Mullin,REP,30011,20,166,404,590,02
Atoka,U.S. House,Joshua Harris-Till,DEM,30011,6,45,106,157,02
Atoka,U.S. House,John Mccarthy,IND,30011,0,8,42,50,02
Atoka,State House,Justin Humphrey,REP,30011,13,155,379,547,19
Atoka,State House,James Albert Campbell,DEM,30011,12,59,135,206,19
Atoka,State House,Morgan Hopson,IND,30011,3,6,40,49,19
Atoka,President,Donald Trump,REP,30012,6,32,241,279,
Atoka,President,Gary Johnson,LIB,30012,0,0,6,6,
Atoka,President,Hillary Clinton,DEM,30012,0,6,32,38,
Atoka,U.S. Senate,James Lankford,REP,30012,6,28,213,247,
Atoka,U.S. Senate,Robert Murphy,LIB,30012,0,2,3,5,
Atoka,U.S. Senate,Mike Workman,DEM,30012,0,8,46,54,
Atoka,U.S. Senate,Mark Beard,IND,30012,0,0,6,6,
Atoka,U.S. Senate,Sean Braddy,IND,30012,0,0,7,7,
Atoka,U.S. House,Markwayne Mullin,REP,30012,6,28,225,259,02
Atoka,U.S. House,Joshua Harris-Till,DEM,30012,0,8,35,43,02
Atoka,U.S. House,John Mccarthy,IND,30012,0,2,18,20,02
Atoka,State Senate,Joseph Silk,REP,30012,6,26,186,218,5
Atoka,State Senate,Stacey Allen Ebert,DEM,30012,0,12,86,98,5
Atoka,State House,Justin Humphrey,REP,30012,5,26,165,196,19
Atoka,State House,James Albert Campbell,DEM,30012,0,10,73,83,19
Atoka,State House,Morgan Hopson,IND,30012,1,2,38,41,19
Atoka,President,Donald Trump,REP,30013,2,26,258,286,
Atoka,President,Gary Johnson,LIB,30013,0,2,4,6,
Atoka,President,Hillary Clinton,DEM,30013,5,8,23,36,
Atoka,U.S. Senate,James Lankford,REP,30013,2,20,203,225,
Atoka,U.S. Senate,Robert Murphy,LIB,30013,0,2,8,10,
Atoka,U.S. Senate,Mike Workman,DEM,30013,4,12,63,79,
Atoka,U.S. Senate,Mark Beard,IND,30013,1,0,3,4,
Atoka,U.S. Senate,Sean Braddy,IND,30013,0,2,3,5,
Atoka,U.S. House,Markwayne Mullin,REP,30013,2,27,232,261,02
Atoka,U.S. House,Joshua Harris-Till,DEM,30013,4,7,39,50,02
Atoka,U.S. House,John Mccarthy,IND,30013,1,2,10,13,02
Atoka,State Senate,Joseph Silk,REP,30013,3,19,198,220,5
Atoka,State Senate,Stacey Allen Ebert,DEM,30013,4,16,84,104,5
Atoka,State House,Justin Humphrey,REP,30013,2,22,193,217,19
Atoka,State House,James Albert Campbell,DEM,30013,5,10,74,89,19
Atoka,State House,Morgan Hopson,IND,30013,0,4,18,22,19
Atoka,President,Donald Trump,REP,30014,1,5,101,107,
Atoka,President,Gary Johnson,LIB,30014,0,0,4,4,
Atoka,President,Hillary Clinton,DEM,30014,1,3,10,14,
Atoka,U.S. Senate,James Lankford,REP,30014,2,4,83,89,
Atoka,U.S. Senate,Robert Murphy,LIB,30014,0,0,1,1,
Atoka,U.S. Senate,Mike Workman,DEM,30014,1,3,23,27,
Atoka,U.S. Senate,Mark Beard,IND,30014,0,0,0,0,
Atoka,U.S. Senate,Sean Braddy,IND,30014,0,0,4,4,
Atoka,U.S. House,Markwayne Mullin,REP,30014,1,5,88,94,02
Atoka,U.S. House,Joshua Harris-Till,DEM,30014,2,3,15,20,02
Atoka,U.S. House,John Mccarthy,IND,30014,0,0,8,8,02
Atoka,State Senate,Joseph Silk,REP,30014,2,5,99,106,5
Atoka,State Senate,Stacey Allen Ebert,DEM,30014,1,3,15,19,5
Atoka,State House,Justin Humphrey,REP,30014,1,4,75,80,19
Atoka,State House,James Albert Campbell,DEM,30014,2,3,26,31,19
Atoka,State House,Morgan Hopson,IND,30014,0,0,12,12,19
Atoka,President,Donald Trump,REP,30015,0,12,46,58,
Atoka,President,Gary Johnson,LIB,30015,0,1,2,3,
Atoka,President,Hillary Clinton,DEM,30015,0,1,18,19,
Atoka,U.S. Senate,James Lankford,REP,30015,0,11,35,46,
Atoka,U.S. Senate,Robert Murphy,LIB,30015,0,1,2,3,
Atoka,U.S. Senate,Mike Workman,DEM,30015,0,2,24,26,
Atoka,U.S. Senate,Mark Beard,IND,30015,0,0,1,1,
Atoka,U.S. Senate,Sean Braddy,IND,30015,0,0,2,2,
Atoka,U.S. House,Markwayne Mullin,REP,30015,0,13,45,58,02
Atoka,U.S. House,Joshua Harris-Till,DEM,30015,0,0,16,16,02
Atoka,U.S. House,John Mccarthy,IND,30015,0,1,4,5,02
Atoka,State Senate,Joseph Silk,REP,30015,0,9,40,49,5
Atoka,State Senate,Stacey Allen Ebert,DEM,30015,0,5,25,30,5
Atoka,State House,Justin Humphrey,REP,30015,0,9,42,51,19
Atoka,State House,James Albert Campbell,DEM,30015,0,5,21,26,19
Atoka,State House,Morgan Hopson,IND,30015,0,0,2,2,19
Atoka,President,Donald Trump,REP,30016,0,0,0,0,
Atoka,President,Gary Johnson,LIB,30016,0,0,0,0,
Atoka,President,Hillary Clinton,DEM,30016,0,0,0,0,
Atoka,U.S. Senate,James Lankford,REP,30016,0,0,0,0,
Atoka,U.S. Senate,Robert Murphy,LIB,30016,0,0,0,0,
Atoka,U.S. Senate,Mike Workman,DEM,30016,0,0,0,0,
Atoka,U.S. Senate,Mark Beard,IND,30016,0,0,0,0,
Atoka,U.S. Senate,Sean Braddy,IND,30016,0,0,0,0,
Atoka,U.S. House,Markwayne Mullin,REP,30016,0,0,0,0,02
Atoka,U.S. House,Joshua Harris-Till,DEM,30016,0,0,0,0,02
Atoka,U.S. House,John Mccarthy,IND,30016,0,0,0,0,02
Atoka,State House,Justin Humphrey,REP,30016,0,0,0,0,19
Atoka,State House,James Albert Campbell,DEM,30016,0,0,0,0,19
Atoka,State House,Morgan Hopson,IND,30016,0,0,0,0,19
Atoka,President,Donald Trump,REP,30017,0,0,0,0,
Atoka,President,Gary Johnson,LIB,30017,0,0,0,0,
Atoka,President,Hillary Clinton,DEM,30017,0,0,0,0,
Atoka,U.S. Senate,James Lankford,REP,30017,0,0,0,0,
Atoka,U.S. Senate,Robert Murphy,LIB,30017,0,0,0,0,
Atoka,U.S. Senate,Mike Workman,DEM,30017,0,0,0,0,
Atoka,U.S. Senate,Mark Beard,IND,30017,0,0,0,0,
Atoka,U.S. Senate,Sean Braddy,IND,30017,0,0,0,0,
Atoka,U.S. House,Markwayne Mullin,REP,30017,0,0,0,0,02
Atoka,U.S. House,Joshua Harris-Till,DEM,30017,0,0,0,0,02
Atoka,U.S. House,John Mccarthy,IND,30017,0,0,0,0,02
Atoka,State House,Justin Humphrey,REP,30017,0,0,0,0,19
Atoka,State House,James Albert Campbell,DEM,30017,0,0,0,0,19
Atoka,State House,Morgan Hopson,IND,30017,0,0,0,0,19
Atoka,President,Donald Trump,REP,30018,0,0,0,0,
Atoka,President,Gary Johnson,LIB,30018,0,0,0,0,
Atoka,President,Hillary Clinton,DEM,30018,0,0,0,0,
Atoka,U.S. Senate,James Lankford,REP,30018,0,0,0,0,
Atoka,U.S. Senate,Robert Murphy,LIB,30018,0,0,0,0,
Atoka,U.S. Senate,Mike Workman,DEM,30018,0,0,0,0,
Atoka,U.S. Senate,Mark Beard,IND,30018,0,0,0,0,
Atoka,U.S. Senate,Sean Braddy,IND,30018,0,0,0,0,
Atoka,U.S. House,Markwayne Mullin,REP,30018,0,0,0,0,02
Atoka,U.S. House,Joshua Harris-Till,DEM,30018,0,0,0,0,02
Atoka,U.S. House,John Mccarthy,IND,30018,0,0,0,0,02
Atoka,State Senate,Joseph Silk,REP,30018,0,0,0,0,5
Atoka,State Senate,Stacey Allen Ebert,DEM,30018,0,0,0,0,5
Atoka,State House,Justin Humphrey,REP,30018,0,0,0,0,19
Atoka,State House,James Albert Campbell,DEM,30018,0,0,0,0,19
Atoka,State House,Morgan Hopson,IND,30018,0,0,0,0,19
Atoka,President,Donald Trump,REP,30019,0,2,30,32,
Atoka,President,Gary Johnson,LIB,30019,0,0,1,1,
Atoka,President,Hillary Clinton,DEM,30019,0,0,2,2,
Atoka,U.S. Senate,James Lankford,REP,30019,0,2,22,24,
Atoka,U.S. Senate,Robert Murphy,LIB,30019,0,0,1,1,
Atoka,U.S. Senate,Mike Workman,DEM,30019,0,0,7,7,
Atoka,U.S. Senate,Mark Beard,IND,30019,0,0,0,0,
Atoka,U.S. Senate,Sean Braddy,IND,30019,0,0,2,2,
Atoka,U.S. House,Markwayne Mullin,REP,30019,0,2,27,29,02
Atoka,U.S. House,Joshua Harris-Till,DEM,30019,0,0,2,2,02
Atoka,U.S. House,John Mccarthy,IND,30019,0,0,3,3,02
Atoka,State House,Justin Humphrey,REP,30019,0,2,21,23,19
Atoka,State House,James Albert Campbell,DEM,30019,0,0,8,8,19
Atoka,State House,Morgan Hopson,IND,30019,0,0,3,3,19
Beaver,President,Donald Trump,REP,40011,8,9,156,173,
Beaver,President,Gary Johnson,LIB,40011,0,0,3,3,
Beaver,President,Hillary Clinton,DEM,40011,1,2,9,12,
Beaver,U.S. Senate,James Lankford,REP,40011,9,11,156,176,
Beaver,U.S. Senate,Robert Murphy,LIB,40011,0,0,1,1,
Beaver,U.S. Senate,Mike Workman,DEM,40011,0,0,9,9,
Beaver,U.S. Senate,Mark Beard,IND,40011,0,0,1,1,
Beaver,U.S. Senate,Sean Braddy,IND,40011,0,0,1,1,
Beaver,U.S. House,Frank Lucas,REP,40011,9,9,156,174,03
Beaver,U.S. House,Frankie Robbins,DEM,40011,0,2,9,11,03
Beaver,State House,Casey Murdock,REP,40011,8,9,158,175,61
Beaver,State House,Ashlee Renee Ortiz,DEM,40011,1,2,10,13,61
Beaver,President,Donald Trump,REP,40013,7,3,107,117,
Beaver,President,Gary Johnson,LIB,40013,0,0,1,1,
Beaver,President,Hillary Clinton,DEM,40013,0,1,4,5,
Beaver,U.S. Senate,James Lankford,REP,40013,7,3,106,116,
Beaver,U.S. Senate,Robert Murphy,LIB,40013,0,0,1,1,
Beaver,U.S. Senate,Mike Workman,DEM,40013,0,1,4,5,
Beaver,U.S. Senate,Mark Beard,IND,40013,0,0,0,0,
Beaver,U.S. Senate,Sean Braddy,IND,40013,0,0,2,2,
Beaver,U.S. House,Frank Lucas,REP,40013,7,4,107,118,03
Beaver,U.S. House,Frankie Robbins,DEM,40013,0,0,4,4,03
Beaver,State House,Casey Murdock,REP,40013,7,4,106,117,61
Beaver,State House,Ashlee Renee Ortiz,DEM,40013,0,0,7,7,61
Beaver,President,Donald Trump,REP,40023,45,134,584,763,
Beaver,President,Gary Johnson,LIB,40023,4,12,20,36,
Beaver,President,Hillary Clinton,DEM,40023,6,20,52,78,
Beaver,U.S. Senate,James Lankford,REP,40023,44,140,562,746,
Beaver,U.S. Senate,Robert Murphy,LIB,40023,1,5,15,21,
Beaver,U.S. Senate,Mike Workman,DEM,40023,6,17,56,79,
Beaver,U.S. Senate,Mark Beard,IND,40023,1,4,13,18,
Beaver,U.S. Senate,Sean Braddy,IND,40023,2,1,8,11,
Beaver,U.S. House,Frank Lucas,REP,40023,43,147,576,766,03
Beaver,U.S. House,Frankie Robbins,DEM,40023,8,20,74,102,03
Beaver,State House,Casey Murdock,REP,40023,47,143,579,769,61
Beaver,State House,Ashlee Renee Ortiz,DEM,40023,5,22,72,99,61
Beaver,President,Donald Trump,REP,40025,11,11,136,158,
Beaver,President,Gary Johnson,LIB,40025,0,0,6,6,
Beaver,President,Hillary Clinton,DEM,40025,0,1,17,18,
Beaver,U.S. Senate,James Lankford,REP,40025,9,13,125,147,
Beaver,U.S. Senate,Robert Murphy,LIB,40025,0,0,5,5,
Beaver,U.S. Senate,Mike Workman,DEM,40025,0,0,16,16,
Beaver,U.S. Senate,Mark Beard,IND,40025,0,0,5,5,
Beaver,U.S. Senate,Sean Braddy,IND,40025,0,0,3,3,
Beaver,U.S. House,Frank Lucas,REP,40025,10,12,135,157,03
Beaver,U.S. House,Frankie Robbins,DEM,40025,0,1,20,21,03
Beaver,State House,Casey Murdock,REP,40025,10,12,136,158,61
Beaver,State House,Ashlee Renee Ortiz,DEM,40025,1,1,20,22,61
Beaver,President,Donald Trump,REP,40026,3,3,33,39,
Beaver,President,Gary Johnson,LIB,40026,0,1,0,1,
Beaver,President,Hillary Clinton,DEM,40026,0,0,5,5,
Beaver,U.S. Senate,James Lankford,REP,40026,3,3,30,36,
Beaver,U.S. Senate,Robert Murphy,LIB,40026,0,0,0,0,
Beaver,U.S. Senate,Mike Workman,DEM,40026,0,1,5,6,
Beaver,U.S. Senate,Mark Beard,IND,40026,1,0,2,3,
Beaver,U.S. Senate,Sean Braddy,IND,40026,0,0,0,0,
Beaver,U.S. House,Frank Lucas,REP,40026,4,3,32,39,03
Beaver,U.S. House,Frankie Robbins,DEM,40026,0,1,6,7,03
Beaver,State House,Casey Murdock,REP,40026,4,3,32,39,61
Beaver,State House,Ashlee Renee Ortiz,DEM,40026,0,0,6,6,61
Beaver,President,Donald Trump,REP,40031,15,20,211,246,
Beaver,President,Gary Johnson,LIB,40031,1,2,3,6,
Beaver,President,Hillary Clinton,DEM,40031,0,0,10,10,
Beaver,U.S. Senate,James Lankford,REP,40031,12,21,204,237,
Beaver,U.S. Senate,Robert Murphy,LIB,40031,0,0,5,5,
Beaver,U.S. Senate,Mike Workman,DEM,40031,0,1,11,12,
Beaver,U.S. Senate,Mark Beard,IND,40031,0,0,3,3,
Beaver,U.S. Senate,Sean Braddy,IND,40031,1,0,1,2,
Beaver,U.S. House,Frank Lucas,REP,40031,13,21,210,244,03
Beaver,U.S. House,Frankie Robbins,DEM,40031,0,1,13,14,03
Beaver,State House,Casey Murdock,REP,40031,15,20,211,246,61
Beaver,State House,Ashlee Renee Ortiz,DEM,40031,0,2,16,18,61
Beaver,President,Donald Trump,REP,40033,26,15,456,497,
Beaver,President,Gary Johnson,LIB,40033,2,1,18,21,
Beaver,President,Hillary Clinton,DEM,40033,2,1,45,48,
Beaver,U.S. Senate,James Lankford,REP,40033,27,15,440,482,
Beaver,U.S. Senate,Robert Murphy,LIB,40033,0,0,13,13,
Beaver,U.S. Senate,Mike Workman,DEM,40033,2,1,39,42,
Beaver,U.S. Senate,Mark Beard,IND,40033,0,0,10,10,
Beaver,U.S. Senate,Sean Braddy,IND,40033,0,1,7,8,
Beaver,U.S. House,Frank Lucas,REP,40033,25,15,460,500,03
Beaver,U.S. House,Frankie Robbins,DEM,40033,5,2,51,58,03
Beaver,State House,Casey Murdock,REP,40033,27,13,462,502,61
Beaver,State House,Ashlee Renee Ortiz,DEM,40033,3,4,47,54,61
Beckham,President,Donald Trump,REP,50111,24,142,475,641,
Beckham,President,Gary Johnson,LIB,50111,2,4,21,27,
Beckham,President,Hillary Clinton,DEM,50111,10,32,73,115,
Beckham,U.S. Senate,James Lankford,REP,50111,24,149,458,631,
Beckham,U.S. Senate,Robert Murphy,LIB,50111,3,0,5,8,
Beckham,U.S. Senate,Mike Workman,DEM,50111,8,30,80,118,
Beckham,U.S. Senate,Mark Beard,IND,50111,2,1,15,18,
Beckham,U.S. Senate,Sean Braddy,IND,50111,0,0,11,11,
Beckham,U.S. House,Frank Lucas,REP,50111,25,151,490,666,03
Beckham,U.S. House,Frankie Robbins,DEM,50111,12,30,78,120,03
Beckham,State House,Todd Russ,REP,50111,21,98,313,432,55
Beckham,State House,Wayne Walters,DEM,50111,16,80,257,353,55
Beckham,President,Donald Trump,REP,50112,7,53,226,286,
Beckham,President,Gary Johnson,LIB,50112,0,1,11,12,
Beckham,President,Hillary Clinton,DEM,50112,5,8,42,55,
Beckham,U.S. Senate,James Lankford,REP,50112,9,53,222,284,
Beckham,U.S. Senate,Robert Murphy,LIB,50112,0,0,5,5,
Beckham,U.S. Senate,Mike Workman,DEM,50112,4,6,49,59,
Beckham,U.S. Senate,Mark Beard,IND,50112,0,2,3,5,
Beckham,U.S. Senate,Sean Braddy,IND,50112,1,0,2,3,
Beckham,U.S. House,Frank Lucas,REP,50112,10,53,228,291,03
Beckham,U.S. House,Frankie Robbins,DEM,50112,4,6,52,62,03
Beckham,State House,Todd Russ,REP,50112,8,37,157,202,55
Beckham,State House,Wayne Walters,DEM,50112,6,24,123,153,55
Beckham,President,Donald Trump,REP,50115,10,58,76,144,
Beckham,President,Gary Johnson,LIB,50115,0,1,0,1,
Beckham,President,Hillary Clinton,DEM,50115,0,6,7,13,
Beckham,U.S. Senate,James Lankford,REP,50115,11,58,71,140,
Beckham,U.S. Senate,Robert Murphy,LIB,50115,0,0,0,0,
Beckham,U.S. Senate,Mike Workman,DEM,50115,0,7,7,14,
Beckham,U.S. Senate,Mark Beard,IND,50115,0,0,2,2,
Beckham,U.S. Senate,Sean Braddy,IND,50115,0,0,1,1,
Beckham,U.S. House,Frank Lucas,REP,50115,9,61,70,140,03
Beckham,U.S. House,Frankie Robbins,DEM,50115,1,4,11,16,03
Beckham,State House,Todd Russ,REP,50115,7,37,51,95,55
Beckham,State House,Wayne Walters,DEM,50115,4,28,31,63,55
Beckham,President,Donald Trump,REP,50141,21,61,555,637,
Beckham,President,Gary Johnson,LIB,50141,2,1,32,35,
Beckham,President,Hillary Clinton,DEM,50141,6,2,81,89,
Beckham,U.S. Senate,James Lankford,REP,50141,22,57,573,652,
Beckham,U.S. Senate,Robert Murphy,LIB,50141,0,1,14,15,
Beckham,U.S. Senate,Mike Workman,DEM,50141,4,3,62,69,
Beckham,U.S. Senate,Mark Beard,IND,50141,1,1,4,6,
Beckham,U.S. Senate,Sean Braddy,IND,50141,1,2,18,21,
Beckham,U.S. House,Frank Lucas,REP,50141,22,52,582,656,03
Beckham,U.S. House,Frankie Robbins,DEM,50141,6,11,88,105,03
Beckham,State House,Todd Russ,REP,50141,17,36,375,428,55
Beckham,State House,Wayne Walters,DEM,50141,12,28,293,333,55
Beckham,President,Donald Trump,REP,50231,14,32,278,324,
Beckham,President,Gary Johnson,LIB,50231,1,1,15,17,
Beckham,President,Hillary Clinton,DEM,50231,2,3,32,37,
Beckham,U.S. Senate,James Lankford,REP,50231,14,32,272,318,
Beckham,U.S. Senate,Robert Murphy,LIB,50231,0,1,6,7,
Beckham,U.S. Senate,Mike Workman,DEM,50231,2,4,33,39,
Beckham,U.S. Senate,Mark Beard,IND,50231,1,0,9,10,
Beckham,U.S. Senate,Sean Braddy,IND,50231,0,0,6,6,
Beckham,U.S. House,Frank Lucas,REP,50231,16,33,286,335,03
Beckham,U.S. House,Frankie Robbins,DEM,50231,1,4,41,46,03
Beckham,President,Donald Trump,REP,50232,2,8,81,91,
Beckham,President,Gary Johnson,LIB,50232,0,1,4,5,
Beckham,President,Hillary Clinton,DEM,50232,1,1,6,8,
Beckham,U.S. Senate,James Lankford,REP,50232,2,10,80,92,
Beckham,U.S. Senate,Robert Murphy,LIB,50232,0,0,1,1,
Beckham,U.S. Senate,Mike Workman,DEM,50232,1,0,8,9,
Beckham,U.S. Senate,Mark Beard,IND,50232,0,0,1,1,
Beckham,U.S. Senate,Sean Braddy,IND,50232,0,0,1,1,
Beckham,U.S. House,Frank Lucas,REP,50232,3,10,84,97,03
Beckham,U.S. House,Frankie Robbins,DEM,50232,0,0,7,7,03
Beckham,State House,Todd Russ,REP,50232,0,5,49,54,55
Beckham,State House,Wayne Walters,DEM,50232,3,5,42,50,55
Beckham,President,Donald Trump,REP,50235,66,190,1256,1512,
Beckham,President,Gary Johnson,LIB,50235,3,5,63,71,
Beckham,President,Hillary Clinton,DEM,50235,7,14,192,213,
Beckham,U.S. Senate,James Lankford,REP,50235,66,182,1244,1492,
Beckham,U.S. Senate,Robert Murphy,LIB,50235,1,7,24,32,
Beckham,U.S. Senate,Mike Workman,DEM,50235,9,18,173,200,
Beckham,U.S. Senate,Mark Beard,IND,50235,0,2,23,25,
Beckham,U.S. Senate,Sean Braddy,IND,50235,1,1,40,42,
Beckham,U.S. House,Frank Lucas,REP,50235,68,178,1299,1545,03
Beckham,U.S. House,Frankie Robbins,DEM,50235,10,32,205,247,03
Beckham,State House,Todd Russ,REP,50235,44,119,813,976,55
Beckham,State House,Wayne Walters,DEM,50235,32,91,692,815,55
Beckham,President,Donald Trump,REP,50242,6,21,240,267,
Beckham,President,Gary Johnson,LIB,50242,0,0,11,11,
Beckham,President,Hillary Clinton,DEM,50242,0,3,37,40,
Beckham,U.S. Senate,James Lankford,REP,50242,4,21,247,272,
Beckham,U.S. Senate,Robert Murphy,LIB,50242,0,0,3,3,
Beckham,U.S. Senate,Mike Workman,DEM,50242,0,3,29,32,
Beckham,U.S. Senate,Mark Beard,IND,50242,2,0,2,4,
Beckham,U.S. Senate,Sean Braddy,IND,50242,0,0,2,2,
Beckham,U.S. House,Frank Lucas,REP,50242,5,19,247,271,03
Beckham,U.S. House,Frankie Robbins,DEM,50242,1,5,37,43,03
Beckham,State House,Todd Russ,REP,50242,5,13,149,167,55
Beckham,State House,Wayne Walters,DEM,50242,1,11,142,154,55
Beckham,President,Donald Trump,REP,50320,19,35,366,420,
Beckham,President,Gary Johnson,LIB,50320,0,1,20,21,
Beckham,President,Hillary Clinton,DEM,50320,2,4,59,65,
Beckham,U.S. Senate,James Lankford,REP,50320,19,34,357,410,
Beckham,U.S. Senate,Robert Murphy,LIB,50320,0,0,10,10,
Beckham,U.S. Senate,Mike Workman,DEM,50320,1,4,62,67,
Beckham,U.S. Senate,Mark Beard,IND,50320,0,0,5,5,
Beckham,U.S. Senate,Sean Braddy,IND,50320,0,1,9,10,
Beckham,U.S. House,Frank Lucas,REP,50320,18,33,370,421,03
Beckham,U.S. House,Frankie Robbins,DEM,50320,1,6,68,75,03
Beckham,State House,Todd Russ,REP,50320,16,24,283,323,55
Beckham,State House,Wayne Walters,DEM,50320,5,16,161,182,55
Beckham,President,Donald Trump,REP,50330,15,58,299,372,
Beckham,President,Gary Johnson,LIB,50330,1,2,9,12,
Beckham,President,Hillary Clinton,DEM,50330,1,1,24,26,
Beckham,U.S. Senate,James Lankford,REP,50330,13,53,306,372,
Beckham,U.S. Senate,Robert Murphy,LIB,50330,2,2,1,5,
Beckham,U.S. Senate,Mike Workman,DEM,50330,0,3,18,21,
Beckham,U.S. Senate,Mark Beard,IND,50330,0,1,3,4,
Beckham,U.S. Senate,Sean Braddy,IND,50330,1,1,1,3,
Beckham,U.S. House,Frank Lucas,REP,50330,16,52,301,369,03
Beckham,U.S. House,Frankie Robbins,DEM,50330,1,7,27,35,03
Beckham,State House,Todd Russ,REP,50330,12,32,196,240,55
Beckham,State House,Wayne Walters,DEM,50330,5,27,134,166,55
Beckham,President,Donald Trump,REP,50332,52,67,683,802,
Beckham,President,Gary Johnson,LIB,50332,0,1,25,26,
Beckham,President,Hillary Clinton,DEM,50332,10,14,97,121,
Beckham,U.S. Senate,James Lankford,REP,50332,53,72,685,810,
Beckham,U.S. Senate,Robert Murphy,LIB,50332,0,0,10,10,
Beckham,U.S. Senate,Mike Workman,DEM,50332,8,8,86,102,
Beckham,U.S. Senate,Mark Beard,IND,50332,1,1,4,6,
Beckham,U.S. Senate,Sean Braddy,IND,50332,0,2,14,16,
Beckham,U.S. House,Frank Lucas,REP,50332,54,71,691,816,03
Beckham,U.S. House,Frankie Robbins,DEM,50332,7,11,105,123,03
Beckham,President,Donald Trump,REP,50333,22,72,592,686,
Beckham,President,Gary Johnson,LIB,50333,1,2,35,38,
Beckham,President,Hillary Clinton,DEM,50333,14,19,120,153,
Beckham,U.S. Senate,James Lankford,REP,50333,22,74,608,704,
Beckham,U.S. Senate,Robert Murphy,LIB,50333,1,1,24,26,
Beckham,U.S. Senate,Mike Workman,DEM,50333,11,17,87,115,
Beckham,U.S. Senate,Mark Beard,IND,50333,0,1,11,12,
Beckham,U.S. Senate,Sean Braddy,IND,50333,0,1,21,22,
Beckham,U.S. House,Frank Lucas,REP,50333,27,73,621,721,03
Beckham,U.S. House,Frankie Robbins,DEM,50333,8,18,116,142,03
Beckham,President,Donald Trump,REP,50343,7,27,92,126,
Beckham,President,Gary Johnson,LIB,50343,0,3,5,8,
Beckham,President,Hillary Clinton,DEM,50343,3,7,15,25,
Beckham,U.S. Senate,James Lankford,REP,50343,6,27,95,128,
Beckham,U.S. Senate,Robert Murphy,LIB,50343,1,0,2,3,
Beckham,U.S. Senate,Mike Workman,DEM,50343,2,10,13,25,
Beckham,U.S. Senate,Mark Beard,IND,50343,0,1,1,2,
Beckham,U.S. Senate,Sean Braddy,IND,50343,1,0,1,2,
Beckham,U.S. House,Frank Lucas,REP,50343,8,27,91,126,03
Beckham,U.S. House,Frankie Robbins,DEM,50343,2,10,21,33,03
Beckham,State House,Todd Russ,REP,50343,7,19,76,102,55
Beckham,State House,Wayne Walters,DEM,50343,3,19,36,58,55
Blaine,President,Donald Trump,REP,60002,14,15,560,589,
Blaine,President,Gary Johnson,LIB,60002,1,0,24,25,
Blaine,President,Hillary Clinton,DEM,60002,6,4,71,81,
Blaine,U.S. Senate,James Lankford,REP,60002,17,16,567,600,
Blaine,U.S. Senate,Robert Murphy,LIB,60002,0,0,14,14,
Blaine,U.S. Senate,Mike Workman,DEM,60002,3,2,55,60,
Blaine,U.S. Senate,Mark Beard,IND,60002,0,0,3,3,
Blaine,U.S. Senate,Sean Braddy,IND,60002,0,1,9,10,
Blaine,U.S. House,Frank Lucas,REP,60002,16,16,572,604,03
Blaine,U.S. House,Frankie Robbins,DEM,60002,5,3,68,76,03
Blaine,President,Donald Trump,REP,60007,18,24,443,485,
Blaine,President,Gary Johnson,LIB,60007,2,0,22,24,
Blaine,President,Hillary Clinton,DEM,60007,3,6,88,97,
Blaine,U.S. Senate,James Lankford,REP,60007,22,27,453,502,
Blaine,U.S. Senate,Robert Murphy,LIB,60007,1,0,7,8,
Blaine,U.S. Senate,Mike Workman,DEM,60007,1,3,72,76,
Blaine,U.S. Senate,Mark Beard,IND,60007,0,0,17,17,
Blaine,U.S. Senate,Sean Braddy,IND,60007,0,0,5,5,
Blaine,U.S. House,Frank Lucas,REP,60007,22,24,453,499,03
Blaine,U.S. House,Frankie Robbins,DEM,60007,1,5,93,99,03
Blaine,President,Donald Trump,REP,60010,17,28,200,245,
Blaine,President,Gary Johnson,LIB,60010,2,3,19,24,
Blaine,President,Hillary Clinton,DEM,60010,2,8,66,76,
Blaine,U.S. Senate,James Lankford,REP,60010,18,28,213,259,
Blaine,U.S. Senate,Robert Murphy,LIB,60010,0,1,9,10,
Blaine,U.S. Senate,Mike Workman,DEM,60010,3,7,56,66,
Blaine,U.S. Senate,Mark Beard,IND,60010,0,0,3,3,
Blaine,U.S. Senate,Sean Braddy,IND,60010,1,3,7,11,
Blaine,U.S. House,Frank Lucas,REP,60010,19,31,215,265,03
Blaine,U.S. House,Frankie Robbins,DEM,60010,3,8,66,77,03
Blaine,President,Donald Trump,REP,60011,10,27,89,126,
Blaine,President,Gary Johnson,LIB,60011,0,0,11,11,
Blaine,President,Hillary Clinton,DEM,60011,2,11,106,119,
Blaine,U.S. Senate,James Lankford,REP,60011,10,27,105,142,
Blaine,U.S. Senate,Robert Murphy,LIB,60011,0,0,4,4,
Blaine,U.S. Senate,Mike Workman,DEM,60011,2,11,82,95,
Blaine,U.S. Senate,Mark Beard,IND,60011,0,0,4,4,
Blaine,U.S. Senate,Sean Braddy,IND,60011,0,0,8,8,
Blaine,U.S. House,Frank Lucas,REP,60011,10,25,114,149,03
Blaine,U.S. House,Frankie Robbins,DEM,60011,2,12,88,102,03
Blaine,President,Donald Trump,REP,60012,35,141,557,733,
Blaine,President,Gary Johnson,LIB,60012,2,5,46,53,
Blaine,President,Hillary Clinton,DEM,60012,8,36,130,174,
Blaine,U.S. Senate,James Lankford,REP,60012,38,151,595,784,
Blaine,U.S. Senate,Robert Murphy,LIB,60012,0,3,20,23,
Blaine,U.S. Senate,Mike Workman,DEM,60012,7,28,89,124,
Blaine,U.S. Senate,Mark Beard,IND,60012,0,3,8,11,
Blaine,U.S. Senate,Sean Braddy,IND,60012,0,2,18,20,
Blaine,U.S. House,Frank Lucas,REP,60012,36,151,603,790,03
Blaine,U.S. House,Frankie Robbins,DEM,60012,9,34,122,165,03
Blaine,President,Donald Trump,REP,60016,1,20,81,102,
Blaine,President,Gary Johnson,LIB,60016,0,1,10,11,
Blaine,President,Hillary Clinton,DEM,60016,0,3,13,16,
Blaine,U.S. Senate,James Lankford,REP,60016,1,20,93,114,
Blaine,U.S. Senate,Robert Murphy,LIB,60016,0,0,3,3,
Blaine,U.S. Senate,Mike Workman,DEM,60016,0,3,11,14,
Blaine,U.S. Senate,Mark Beard,IND,60016,0,0,1,1,
Blaine,U.S. Senate,Sean Braddy,IND,60016,0,1,2,3,
Blaine,U.S. House,Frank Lucas,REP,60016,1,20,97,118,03
Blaine,U.S. House,Frankie Robbins,DEM,60016,0,3,11,14,03
Blaine,President,Donald Trump,REP,60017,15,10,302,327,
Blaine,President,Gary Johnson,LIB,60017,2,0,34,36,
Blaine,President,Hillary Clinton,DEM,60017,6,5,104,115,
Blaine,U.S. Senate,James Lankford,REP,60017,17,12,318,347,
Blaine,U.S. Senate,Robert Murphy,LIB,60017,1,0,11,12,
Blaine,U.S. Senate,Mike Workman,DEM,60017,4,5,82,91,
Blaine,U.S. Senate,Mark Beard,IND,60017,0,0,10,10,
Blaine,U.S. Senate,Sean Braddy,IND,60017,1,0,13,14,
Blaine,U.S. House,Frank Lucas,REP,60017,18,11,314,343,03
Blaine,U.S. House,Frankie Robbins,DEM,60017,5,5,112,122,03
Blaine,President,Donald Trump,REP,60020,12,0,222,234,
Blaine,President,Gary Johnson,LIB,60020,1,0,11,12,
Blaine,President,Hillary Clinton,DEM,60020,2,0,25,27,
Blaine,U.S. Senate,James Lankford,REP,60020,12,0,235,247,
Blaine,U.S. Senate,Robert Murphy,LIB,60020,1,0,3,4,
Blaine,U.S. Senate,Mike Workman,DEM,60020,2,0,19,21,
Blaine,U.S. Senate,Mark Beard,IND,60020,0,0,2,2,
Blaine,U.S. Senate,Sean Braddy,IND,60020,0,0,3,3,
Blaine,U.S. House,Frank Lucas,REP,60020,12,0,236,248,03
Blaine,U.S. House,Frankie Robbins,DEM,60020,2,0,26,28,03
Blaine,President,Donald Trump,REP,60022,4,6,33,43,
Blaine,President,Gary Johnson,LIB,60022,0,0,2,2,
Blaine,President,Hillary Clinton,DEM,60022,1,1,4,6,
Blaine,U.S. Senate,James Lankford,REP,60022,4,6,36,46,
Blaine,U.S. Senate,Robert Murphy,LIB,60022,0,0,2,2,
Blaine,U.S. Senate,Mike Workman,DEM,60022,1,1,2,4,
Blaine,U.S. Senate,Mark Beard,IND,60022,0,0,0,0,
Blaine,U.S. Senate,Sean Braddy,IND,60022,0,0,0,0,
Blaine,U.S. House,Frank Lucas,REP,60022,4,6,34,44,03
Blaine,U.S. House,Frankie Robbins,DEM,60022,1,1,5,7,03
Bryan,President,Donald Trump,REP,70003,22,72,425,519,
Bryan,President,Gary Johnson,LIB,70003,0,3,47,50,
Bryan,President,Hillary Clinton,DEM,70003,8,31,154,193,
Bryan,U.S. Senate,James Lankford,REP,70003,20,67,393,480,
Bryan,U.S. Senate,Robert Murphy,LIB,70003,0,2,26,28,
Bryan,U.S. Senate,Mike Workman,DEM,70003,7,30,162,199,
Bryan,U.S. Senate,Mark Beard,IND,70003,1,3,13,17,
Bryan,U.S. Senate,Sean Braddy,IND,70003,1,3,21,25,
Bryan,U.S. House,Markwayne Mullin,REP,70003,20,67,395,482,02
Bryan,U.S. House,Joshua Harris-Till,DEM,70003,7,29,160,196,02
Bryan,U.S. House,John Mccarthy,IND,70003,2,9,61,72,02
Bryan,State House,Dustin Roberts,REP,70003,22,75,411,508,21
Bryan,State House,David Northcutt,DEM,70003,7,30,208,245,21
Bryan,President,Donald Trump,REP,70004,15,64,461,540,
Bryan,President,Gary Johnson,LIB,70004,2,2,49,53,
Bryan,President,Hillary Clinton,DEM,70004,14,38,175,227,
Bryan,U.S. Senate,James Lankford,REP,70004,17,59,411,487,
Bryan,U.S. Senate,Robert Murphy,LIB,70004,1,3,32,36,
Bryan,U.S. Senate,Mike Workman,DEM,70004,10,36,175,221,
Bryan,U.S. Senate,Mark Beard,IND,70004,0,3,19,22,
Bryan,U.S. Senate,Sean Braddy,IND,70004,2,4,30,36,
Bryan,U.S. House,Markwayne Mullin,REP,70004,14,56,416,486,02
Bryan,U.S. House,Joshua Harris-Till,DEM,70004,14,40,180,234,02
Bryan,U.S. House,John Mccarthy,IND,70004,2,9,71,82,02
Bryan,State House,Dustin Roberts,REP,70004,14,65,473,552,21
Bryan,State House,David Northcutt,DEM,70004,17,38,194,249,21
Bryan,President,Donald Trump,REP,70005,30,79,497,606,
Bryan,President,Gary Johnson,LIB,70005,1,3,37,41,
Bryan,President,Hillary Clinton,DEM,70005,12,33,192,237,
Bryan,U.S. Senate,James Lankford,REP,70005,29,73,448,550,
Bryan,U.S. Senate,Robert Murphy,LIB,70005,2,5,35,42,
Bryan,U.S. Senate,Mike Workman,DEM,70005,9,32,182,223,
Bryan,U.S. Senate,Mark Beard,IND,70005,0,2,30,32,
Bryan,U.S. Senate,Sean Braddy,IND,70005,1,3,26,30,
Bryan,U.S. House,Markwayne Mullin,REP,70005,32,82,464,578,02
Bryan,U.S. House,Joshua Harris-Till,DEM,70005,9,31,188,228,02
Bryan,U.S. House,John Mccarthy,IND,70005,0,4,66,70,02
Bryan,State House,Dustin Roberts,REP,70005,29,80,486,595,21
Bryan,State House,David Northcutt,DEM,70005,12,36,237,285,21
Bryan,President,Donald Trump,REP,70008,31,83,521,635,
Bryan,President,Gary Johnson,LIB,70008,2,4,34,40,
Bryan,President,Hillary Clinton,DEM,70008,23,26,156,205,
Bryan,U.S. Senate,James Lankford,REP,70008,30,87,506,623,
Bryan,U.S. Senate,Robert Murphy,LIB,70008,3,2,16,21,
Bryan,U.S. Senate,Mike Workman,DEM,70008,15,21,143,179,
Bryan,U.S. Senate,Mark Beard,IND,70008,0,1,14,15,
Bryan,U.S. Senate,Sean Braddy,IND,70008,5,1,28,34,
Bryan,U.S. House,Markwayne Mullin,REP,70008,30,87,492,609,02
Bryan,U.S. House,Joshua Harris-Till,DEM,70008,16,20,163,199,02
Bryan,U.S. House,John Mccarthy,IND,70008,4,5,53,62,02
Bryan,State House,Dustin Roberts,REP,70008,31,87,547,665,21
Bryan,State House,David Northcutt,DEM,70008,20,26,163,209,21
Bryan,President,Donald Trump,REP,70010,6,31,352,389,
Bryan,President,Gary Johnson,LIB,70010,0,0,11,11,
Bryan,President,Hillary Clinton,DEM,70010,3,4,95,102,
Bryan,U.S. Senate,James Lankford,REP,70010,6,30,312,348,
Bryan,U.S. Senate,Robert Murphy,LIB,70010,1,0,12,13,
Bryan,U.S. Senate,Mike Workman,DEM,70010,2,4,99,105,
Bryan,U.S. Senate,Mark Beard,IND,70010,0,1,10,11,
Bryan,U.S. Senate,Sean Braddy,IND,70010,0,0,15,15,
Bryan,U.S. House,Markwayne Mullin,REP,70010,6,33,325,364,02
Bryan,U.S. House,Joshua Harris-Till,DEM,70010,2,2,100,104,02
Bryan,U.S. House,John Mccarthy,IND,70010,1,0,29,30,02
Bryan,State House,Dustin Roberts,REP,70010,6,30,334,370,21
Bryan,State House,David Northcutt,DEM,70010,3,5,124,132,21
Bryan,President,Donald Trump,REP,70011,3,10,161,174,
Bryan,President,Gary Johnson,LIB,70011,0,0,2,2,
Bryan,President,Hillary Clinton,DEM,70011,0,1,36,37,
Bryan,U.S. Senate,James Lankford,REP,70011,2,9,131,142,
Bryan,U.S. Senate,Robert Murphy,LIB,70011,0,0,4,4,
Bryan,U.S. Senate,Mike Workman,DEM,70011,0,2,45,47,
Bryan,U.S. Senate,Mark Beard,IND,70011,0,0,4,4,
Bryan,U.S. Senate,Sean Braddy,IND,70011,1,0,5,6,
Bryan,U.S. House,Markwayne Mullin,REP,70011,2,9,145,156,02
Bryan,U.S. House,Joshua Harris-Till,DEM,70011,0,2,42,44,02
Bryan,U.S. House,John Mccarthy,IND,70011,1,0,8,9,02
Bryan,State House,Justin Humphrey,REP,70011,1,9,104,114,19
Bryan,State House,James Albert Campbell,DEM,70011,1,2,80,83,19
Bryan,State House,Morgan Hopson,IND,70011,1,0,7,8,19
Bryan,President,Donald Trump,REP,70013,21,18,410,449,
Bryan,President,Gary Johnson,LIB,70013,0,0,12,12,
Bryan,President,Hillary Clinton,DEM,70013,2,5,91,98,
Bryan,U.S. Senate,James Lankford,REP,70013,16,19,371,406,
Bryan,U.S. Senate,Robert Murphy,LIB,70013,1,0,13,14,
Bryan,U.S. Senate,Mike Workman,DEM,70013,5,2,99,106,
Bryan,U.S. Senate,Mark Beard,IND,70013,0,0,7,7,
Bryan,U.S. Senate,Sean Braddy,IND,70013,0,0,11,11,
Bryan,U.S. House,Markwayne Mullin,REP,70013,19,18,385,422,02
Bryan,U.S. House,Joshua Harris-Till,DEM,70013,3,4,83,90,02
Bryan,U.S. House,John Mccarthy,IND,70013,0,0,32,32,02
Bryan,State House,Justin Humphrey,REP,70013,15,17,319,351,19
Bryan,State House,James Albert Campbell,DEM,70013,6,5,166,177,19
Bryan,State House,Morgan Hopson,IND,70013,0,0,20,20,19
Bryan,President,Donald Trump,REP,70014,7,9,263,279,
Bryan,President,Gary Johnson,LIB,70014,0,2,10,12,
Bryan,President,Hillary Clinton,DEM,70014,1,6,37,44,
Bryan,U.S. Senate,James Lankford,REP,70014,7,9,214,230,
Bryan,U.S. Senate,Robert Murphy,LIB,70014,0,2,10,12,
Bryan,U.S. Senate,Mike Workman,DEM,70014,1,6,55,62,
Bryan,U.S. Senate,Mark Beard,IND,70014,0,0,9,9,
Bryan,U.S. Senate,Sean Braddy,IND,70014,0,0,9,9,
Bryan,U.S. House,Markwayne Mullin,REP,70014,7,10,238,255,02
Bryan,U.S. House,Joshua Harris-Till,DEM,70014,0,5,36,41,02
Bryan,U.S. House,John Mccarthy,IND,70014,0,2,26,28,02
Bryan,State House,Justin Humphrey,REP,70014,7,9,213,229,19
Bryan,State House,James Albert Campbell,DEM,70014,1,6,65,72,19
Bryan,State House,Morgan Hopson,IND,70014,0,2,15,17,19
Bryan,President,Donald Trump,REP,70015,11,21,452,484,
Bryan,President,Gary Johnson,LIB,70015,0,0,18,18,
Bryan,President,Hillary Clinton,DEM,70015,5,4,96,105,
Bryan,U.S. Senate,James Lankford,REP,70015,10,21,386,417,
Bryan,U.S. Senate,Robert Murphy,LIB,70015,0,0,13,13,
Bryan,U.S. Senate,Mike Workman,DEM,70015,5,4,136,145,
Bryan,U.S. Senate,Mark Beard,IND,70015,1,1,4,6,
Bryan,U.S. Senate,Sean Braddy,IND,70015,0,1,16,17,
Bryan,U.S. House,Markwayne Mullin,REP,70015,13,20,412,445,02
Bryan,U.S. House,Joshua Harris-Till,DEM,70015,3,5,118,126,02
Bryan,U.S. House,John Mccarthy,IND,70015,0,2,20,22,02
Bryan,State House,Justin Humphrey,REP,70015,10,19,342,371,19
Bryan,State House,James Albert Campbell,DEM,70015,5,5,189,199,19
Bryan,State House,Morgan Hopson,IND,70015,1,3,20,24,19
Bryan,President,Donald Trump,REP,70017,14,16,342,372,
Bryan,President,Gary Johnson,LIB,70017,1,0,13,14,
Bryan,President,Hillary Clinton,DEM,70017,2,4,79,85,
Bryan,U.S. Senate,James Lankford,REP,70017,13,14,284,311,
Bryan,U.S. Senate,Robert Murphy,LIB,70017,1,0,6,7,
Bryan,U.S. Senate,Mike Workman,DEM,70017,2,6,95,103,
Bryan,U.S. Senate,Mark Beard,IND,70017,1,1,10,12,
Bryan,U.S. Senate,Sean Braddy,IND,70017,0,0,22,22,
Bryan,U.S. House,Markwayne Mullin,REP,70017,14,16,301,331,02
Bryan,U.S. House,Joshua Harris-Till,DEM,70017,2,4,88,94,02
Bryan,U.S. House,John Mccarthy,IND,70017,1,1,28,30,02
Bryan,State House,Dustin Roberts,REP,70017,14,14,330,358,21
Bryan,State House,David Northcutt,DEM,70017,3,7,94,104,21
Bryan,President,Donald Trump,REP,70018,10,49,655,714,
Bryan,President,Gary Johnson,LIB,70018,0,0,29,29,
Bryan,President,Hillary Clinton,DEM,70018,4,18,137,159,
Bryan,U.S. Senate,James Lankford,REP,70018,10,47,588,645,
Bryan,U.S. Senate,Robert Murphy,LIB,70018,0,0,15,15,
Bryan,U.S. Senate,Mike Workman,DEM,70018,3,18,163,184,
Bryan,U.S. Senate,Mark Beard,IND,70018,0,0,15,15,
Bryan,U.S. Senate,Sean Braddy,IND,70018,0,0,26,26,
Bryan,U.S. House,Markwayne Mullin,REP,70018,8,48,604,660,02
Bryan,U.S. House,Joshua Harris-Till,DEM,70018,4,16,147,167,02
Bryan,U.S. House,John Mccarthy,IND,70018,1,2,64,67,02
Bryan,State House,Dustin Roberts,REP,70018,10,48,647,705,21
Bryan,State House,David Northcutt,DEM,70018,4,18,167,189,21
Bryan,President,Donald Trump,REP,70019,23,56,483,562,
Bryan,President,Gary Johnson,LIB,70019,1,3,27,31,
Bryan,President,Hillary Clinton,DEM,70019,3,10,110,123,
Bryan,U.S. Senate,James Lankford,REP,70019,24,51,450,525,
Bryan,U.S. Senate,Robert Murphy,LIB,70019,0,1,13,14,
Bryan,U.S. Senate,Mike Workman,DEM,70019,2,10,120,132,
Bryan,U.S. Senate,Mark Beard,IND,70019,1,5,9,15,
Bryan,U.S. Senate,Sean Braddy,IND,70019,0,1,12,13,
Bryan,U.S. House,Markwayne Mullin,REP,70019,25,54,450,529,02
Bryan,U.S. House,Joshua Harris-Till,DEM,70019,2,8,126,136,02
Bryan,U.S. House,John Mccarthy,IND,70019,0,7,29,36,02
Bryan,State House,Dustin Roberts,REP,70019,24,60,489,573,21
Bryan,State House,David Northcutt,DEM,70019,3,9,124,136,21
Bryan,President,Donald Trump,REP,70020,6,41,385,432,
Bryan,President,Gary Johnson,LIB,70020,0,1,9,10,
Bryan,President,Hillary Clinton,DEM,70020,2,5,98,105,
Bryan,U.S. Senate,James Lankford,REP,70020,5,40,333,378,
Bryan,U.S. Senate,Robert Murphy,LIB,70020,0,1,19,20,
Bryan,U.S. Senate,Mike Workman,DEM,70020,3,4,114,121,
Bryan,U.S. Senate,Mark Beard,IND,70020,0,1,13,14,
Bryan,U.S. Senate,Sean Braddy,IND,70020,0,1,10,11,
Bryan,U.S. House,Markwayne Mullin,REP,70020,6,40,349,395,02
Bryan,U.S. House,Joshua Harris-Till,DEM,70020,2,5,106,113,02
Bryan,U.S. House,John Mccarthy,IND,70020,0,2,35,37,02
Bryan,State House,Dustin Roberts,REP,70020,6,40,364,410,21
Bryan,State House,David Northcutt,DEM,70020,2,7,124,133,21
Bryan,President,Donald Trump,REP,70021,19,63,442,524,
Bryan,President,Gary Johnson,LIB,70021,0,1,22,23,
Bryan,President,Hillary Clinton,DEM,70021,5,11,87,103,
Bryan,U.S. Senate,James Lankford,REP,70021,20,51,402,473,
Bryan,U.S. Senate,Robert Murphy,LIB,70021,0,0,12,12,
Bryan,U.S. Senate,Mike Workman,DEM,70021,4,14,103,121,
Bryan,U.S. Senate,Mark Beard,IND,70021,0,1,7,8,
Bryan,U.S. Senate,Sean Braddy,IND,70021,0,5,17,22,
Bryan,U.S. House,Markwayne Mullin,REP,70021,18,55,402,475,02
Bryan,U.S. House,Joshua Harris-Till,DEM,70021,5,14,103,122,02
Bryan,U.S. House,John Mccarthy,IND,70021,1,4,36,41,02
Bryan,State House,Dustin Roberts,REP,70021,19,60,449,528,21
Bryan,State House,David Northcutt,DEM,70021,5,13,99,117,21
Bryan,President,Donald Trump,REP,70022,10,42,621,673,
Bryan,President,Gary Johnson,LIB,70022,1,0,24,25,
Bryan,President,Hillary Clinton,DEM,70022,13,7,190,210,
Bryan,U.S. Senate,James Lankford,REP,70022,9,35,555,599,
Bryan,U.S. Senate,Robert Murphy,LIB,70022,0,1,29,30,
Bryan,U.S. Senate,Mike Workman,DEM,70022,11,10,201,222,
Bryan,U.S. Senate,Mark Beard,IND,70022,1,2,18,21,
Bryan,U.S. Senate,Sean Braddy,IND,70022,2,0,19,21,
Bryan,U.S. House,Markwayne Mullin,REP,70022,11,37,584,632,02
Bryan,U.S. House,Joshua Harris-Till,DEM,70022,12,10,192,214,02
Bryan,U.S. House,John Mccarthy,IND,70022,2,2,46,50,02
Bryan,State House,Dustin Roberts,REP,70022,11,37,612,660,21
Bryan,State House,David Northcutt,DEM,70022,14,11,208,233,21
Bryan,President,Donald Trump,REP,70023,3,10,239,252,
Bryan,President,Gary Johnson,LIB,70023,0,0,5,5,
Bryan,President,Hillary Clinton,DEM,70023,2,2,79,83,
Bryan,U.S. Senate,James Lankford,REP,70023,3,8,211,222,
Bryan,U.S. Senate,Robert Murphy,LIB,70023,0,0,5,5,
Bryan,U.S. Senate,Mike Workman,DEM,70023,1,3,88,92,
Bryan,U.S. Senate,Mark Beard,IND,70023,0,0,8,8,
Bryan,U.S. Senate,Sean Braddy,IND,70023,0,0,8,8,
Bryan,U.S. House,Markwayne Mullin,REP,70023,3,8,220,231,02
Bryan,U.S. House,Joshua Harris-Till,DEM,70023,1,3,81,85,02
Bryan,U.S. House,John Mccarthy,IND,70023,0,0,19,19,02
Bryan,State House,Dustin Roberts,REP,70023,3,10,226,239,21
Bryan,State House,David Northcutt,DEM,70023,1,2,95,98,21
Bryan,President,Donald Trump,REP,70025,19,56,549,624,
Bryan,President,Gary Johnson,LIB,70025,0,1,24,25,
Bryan,President,Hillary Clinton,DEM,70025,7,12,156,175,
Bryan,U.S. Senate,James Lankford,REP,70025,17,51,488,556,
Bryan,U.S. Senate,Robert Murphy,LIB,70025,1,0,21,22,
Bryan,U.S. Senate,Mike Workman,DEM,70025,6,12,165,183,
Bryan,U.S. Senate,Mark Beard,IND,70025,0,1,25,26,
Bryan,U.S. Senate,Sean Braddy,IND,70025,1,2,20,23,
Bryan,U.S. House,Markwayne Mullin,REP,70025,16,49,512,577,02
Bryan,U.S. House,Joshua Harris-Till,DEM,70025,9,13,152,174,02
Bryan,U.S. House,John Mccarthy,IND,70025,1,4,53,58,02
Bryan,State House,Dustin Roberts,REP,70025,15,56,528,599,21
Bryan,State House,David Northcutt,DEM,70025,10,12,187,209,21
Bryan,President,Donald Trump,REP,70026,10,37,358,405,
Bryan,President,Gary Johnson,LIB,70026,0,1,26,27,
Bryan,President,Hillary Clinton,DEM,70026,4,19,79,102,
Bryan,U.S. Senate,James Lankford,REP,70026,10,37,338,385,
Bryan,U.S. Senate,Robert Murphy,LIB,70026,0,4,16,20,
Bryan,U.S. Senate,Mike Workman,DEM,70026,4,14,81,99,
Bryan,U.S. Senate,Mark Beard,IND,70026,0,2,10,12,
Bryan,U.S. Senate,Sean Braddy,IND,70026,0,0,13,13,
Bryan,U.S. House,Markwayne Mullin,REP,70026,9,40,337,386,02
Bryan,U.S. House,Joshua Harris-Till,DEM,70026,4,14,79,97,02
Bryan,U.S. House,John Mccarthy,IND,70026,0,4,39,43,02
Bryan,State House,Dustin Roberts,REP,70026,9,45,365,419,21
Bryan,State House,David Northcutt,DEM,70026,4,13,96,113,21
Bryan,President,Donald Trump,REP,70027,20,63,552,635,
Bryan,President,Gary Johnson,LIB,70027,0,4,38,42,
Bryan,President,Hillary Clinton,DEM,70027,7,12,130,149,
Bryan,U.S. Senate,James Lankford,REP,70027,21,61,536,618,
Bryan,U.S. Senate,Robert Murphy,LIB,70027,0,3,15,18,
Bryan,U.S. Senate,Mike Workman,DEM,70027,5,12,132,149,
Bryan,U.S. Senate,Mark Beard,IND,70027,1,0,6,7,
Bryan,U.S. Senate,Sean Braddy,IND,70027,0,2,23,25,
Bryan,U.S. House,Markwayne Mullin,REP,70027,20,62,555,637,02
Bryan,U.S. House,Joshua Harris-Till,DEM,70027,6,12,127,145,02
Bryan,U.S. House,John Mccarthy,IND,70027,1,3,32,36,02
Bryan,State House,Dustin Roberts,REP,70027,20,66,583,669,21
Bryan,State House,David Northcutt,DEM,70027,7,12,128,147,21
Bryan,President,Donald Trump,REP,70028,9,36,0,45,
Bryan,President,Gary Johnson,LIB,70028,2,3,0,5,
Bryan,President,Hillary Clinton,DEM,70028,1,8,0,9,
Bryan,U.S. Senate,James Lankford,REP,70028,11,36,0,47,
Bryan,U.S. Senate,Robert Murphy,LIB,70028,1,0,0,1,
Bryan,U.S. Senate,Mike Workman,DEM,70028,0,9,0,9,
Bryan,U.S. Senate,Mark Beard,IND,70028,0,1,0,1,
Bryan,U.S. Senate,Sean Braddy,IND,70028,0,1,0,1,
Bryan,U.S. House,Markwayne Mullin,REP,70028,10,37,0,47,02
Bryan,U.S. House,Joshua Harris-Till,DEM,70028,1,9,0,10,02
Bryan,U.S. House,John Mccarthy,IND,70028,1,1,0,2,02
Bryan,State House,Dustin Roberts,REP,70028,9,35,0,44,21
Bryan,State House,David Northcutt,DEM,70028,3,10,0,13,21
Bryan,President,Donald Trump,REP,70029,1,7,114,122,
Bryan,President,Gary Johnson,LIB,70029,1,0,8,9,
Bryan,President,Hillary Clinton,DEM,70029,0,1,42,43,
Bryan,U.S. Senate,James Lankford,REP,70029,2,5,98,105,
Bryan,U.S. Senate,Robert Murphy,LIB,70029,0,0,1,1,
Bryan,U.S. Senate,Mike Workman,DEM,70029,0,1,54,55,
Bryan,U.S. Senate,Mark Beard,IND,70029,0,1,3,4,
Bryan,U.S. Senate,Sean Braddy,IND,70029,0,1,5,6,
Bryan,U.S. House,Markwayne Mullin,REP,70029,1,6,109,116,02
Bryan,U.S. House,Joshua Harris-Till,DEM,70029,0,1,49,50,02
Bryan,U.S. House,John Mccarthy,IND,70029,1,1,6,8,02
Bryan,State House,Justin Humphrey,REP,70029,2,5,86,93,19
Bryan,State House,James Albert Campbell,DEM,70029,0,2,68,70,19
Bryan,State House,Morgan Hopson,IND,70029,0,1,9,10,19
Bryan,President,Donald Trump,REP,70033,43,136,864,1043,
Bryan,President,Gary Johnson,LIB,70033,1,8,43,52,
Bryan,President,Hillary Clinton,DEM,70033,15,24,171,210,
Bryan,U.S. Senate,James Lankford,REP,70033,42,139,838,1019,
Bryan,U.S. Senate,Robert Murphy,LIB,70033,1,3,21,25,
Bryan,U.S. Senate,Mike Workman,DEM,70033,15,19,174,208,
Bryan,U.S. Senate,Mark Beard,IND,70033,0,1,13,14,
Bryan,U.S. Senate,Sean Braddy,IND,70033,0,3,23,26,
Bryan,U.S. House,Markwayne Mullin,REP,70033,40,133,821,994,02
Bryan,U.S. House,Joshua Harris-Till,DEM,70033,15,20,175,210,02
Bryan,U.S. House,John Mccarthy,IND,70033,2,12,72,86,02
Bryan,State House,Dustin Roberts,REP,70033,48,141,894,1083,21
Bryan,State House,David Northcutt,DEM,70033,11,24,185,220,21
Caddo,President,Donald Trump,REP,80012,2,16,75,93,
Caddo,President,Gary Johnson,LIB,80012,0,0,19,19,
Caddo,President,Hillary Clinton,DEM,80012,3,12,163,178,
Caddo,U.S. Senate,James Lankford,REP,80012,2,17,97,116,
Caddo,U.S. Senate,Robert Murphy,LIB,80012,0,1,10,11,
Caddo,U.S. Senate,Mike Workman,DEM,80012,4,9,133,146,
Caddo,U.S. Senate,Mark Beard,IND,80012,0,0,7,7,
Caddo,U.S. Senate,Sean Braddy,IND,80012,0,1,8,9,
Caddo,U.S. House,Frank Lucas,REP,80012,3,18,104,125,03
Caddo,U.S. House,Frankie Robbins,DEM,80012,2,10,152,164,03
Caddo,State House,Chris Verser,REP,80012,1,8,28,37,56
Caddo,State House,David Perryman,DEM,80012,5,20,226,251,56
Caddo,President,Donald Trump,REP,80022,6,39,144,189,
Caddo,President,Gary Johnson,LIB,80022,1,4,20,25,
Caddo,President,Hillary Clinton,DEM,80022,4,22,132,158,
Caddo,U.S. Senate,James Lankford,REP,80022,8,47,166,221,
Caddo,U.S. Senate,Robert Murphy,LIB,80022,0,1,11,12,
Caddo,U.S. Senate,Mike Workman,DEM,80022,3,17,103,123,
Caddo,U.S. Senate,Mark Beard,IND,80022,0,1,5,6,
Caddo,U.S. Senate,Sean Braddy,IND,80022,0,0,11,11,
Caddo,U.S. House,Frank Lucas,REP,80022,9,40,172,221,03
Caddo,U.S. House,Frankie Robbins,DEM,80022,2,25,121,148,03
Caddo,State House,Chris Verser,REP,80022,2,22,68,92,56
Caddo,State House,David Perryman,DEM,80022,9,42,227,278,56
Caddo,President,Donald Trump,REP,80031,6,24,99,129,
Caddo,President,Gary Johnson,LIB,80031,1,4,15,20,
Caddo,President,Hillary Clinton,DEM,80031,2,27,106,135,
Caddo,U.S. Senate,James Lankford,REP,80031,6,30,114,150,
Caddo,U.S. Senate,Robert Murphy,LIB,80031,0,2,4,6,
Caddo,U.S. Senate,Mike Workman,DEM,80031,2,23,85,110,
Caddo,U.S. Senate,Mark Beard,IND,80031,0,0,8,8,
Caddo,U.S. Senate,Sean Braddy,IND,80031,0,0,9,9,
Caddo,U.S. House,Frank Lucas,REP,80031,7,30,115,152,03
Caddo,U.S. House,Frankie Robbins,DEM,80031,2,25,104,131,03
Caddo,State House,Chris Verser,REP,80031,5,13,57,75,56
Caddo,State House,David Perryman,DEM,80031,4,42,163,209,56
Caddo,President,Donald Trump,REP,80041,17,82,322,421,
Caddo,President,Gary Johnson,LIB,80041,4,3,28,35,
Caddo,President,Hillary Clinton,DEM,80041,8,47,199,254,
Caddo,U.S. Senate,James Lankford,REP,80041,18,95,347,460,
Caddo,U.S. Senate,Robert Murphy,LIB,80041,1,1,16,18,
Caddo,U.S. Senate,Mike Workman,DEM,80041,9,34,160,203,
Caddo,U.S. Senate,Mark Beard,IND,80041,0,1,16,17,
Caddo,U.S. Senate,Sean Braddy,IND,80041,0,2,14,16,
Caddo,U.S. House,Frank Lucas,REP,80041,18,92,350,460,03
Caddo,U.S. House,Frankie Robbins,DEM,80041,9,41,197,247,03
Caddo,State House,Chris Verser,REP,80041,9,36,147,192,56
Caddo,State House,David Perryman,DEM,80041,19,97,403,519,56
Caddo,President,Donald Trump,REP,80051,24,75,409,508,
Caddo,President,Gary Johnson,LIB,80051,2,7,47,56,
Caddo,President,Hillary Clinton,DEM,80051,6,56,292,354,
Caddo,U.S. Senate,James Lankford,REP,80051,25,87,475,587,
Caddo,U.S. Senate,Robert Murphy,LIB,80051,0,2,19,21,
Caddo,U.S. Senate,Mike Workman,DEM,80051,6,47,232,285,
Caddo,U.S. Senate,Mark Beard,IND,80051,0,1,7,8,
Caddo,U.S. Senate,Sean Braddy,IND,80051,1,1,16,18,
Caddo,U.S. House,Frank Lucas,REP,80051,25,86,467,578,03
Caddo,U.S. House,Frankie Robbins,DEM,80051,8,52,278,338,03
Caddo,State House,Chris Verser,REP,80051,17,26,156,199,56
Caddo,State House,David Perryman,DEM,80051,16,113,596,725,56
Caddo,President,Donald Trump,REP,80102,19,25,569,613,
Caddo,President,Gary Johnson,LIB,80102,1,0,33,34,
Caddo,President,Hillary Clinton,DEM,80102,9,10,211,230,
Caddo,U.S. Senate,James Lankford,REP,80102,23,28,576,627,
Caddo,U.S. Senate,Robert Murphy,LIB,80102,0,0,11,11,
Caddo,U.S. Senate,Mike Workman,DEM,80102,8,7,186,201,
Caddo,U.S. Senate,Mark Beard,IND,80102,0,0,15,15,
Caddo,U.S. Senate,Sean Braddy,IND,80102,0,1,16,17,
Caddo,U.S. House,Frank Lucas,REP,80102,23,27,581,631,03
Caddo,U.S. House,Frankie Robbins,DEM,80102,8,9,230,247,03
Caddo,State House,Rhonda Baker,REP,80102,15,23,393,431,60
Caddo,State House,Dennis Purifoy,DEM,80102,16,13,408,437,60
Caddo,President,Donald Trump,REP,80509,6,12,286,304,
Caddo,President,Gary Johnson,LIB,80509,0,0,13,13,
Caddo,President,Hillary Clinton,DEM,80509,0,1,76,77,
Caddo,U.S. Senate,James Lankford,REP,80509,4,10,281,295,
Caddo,U.S. Senate,Robert Murphy,LIB,80509,1,0,7,8,
Caddo,U.S. Senate,Mike Workman,DEM,80509,1,3,78,82,
Caddo,U.S. Senate,Mark Beard,IND,80509,0,0,6,6,
Caddo,U.S. Senate,Sean Braddy,IND,80509,0,0,6,6,
Caddo,U.S. House,Frank Lucas,REP,80509,6,9,271,286,03
Caddo,U.S. House,Frankie Robbins,DEM,80509,0,4,104,108,03
Caddo,State House,Scooter Park,REP,80509,5,9,241,255,65
Caddo,State House,Rick Gilleland,DEM,80509,1,4,135,140,65
Caddo,President,Donald Trump,REP,80510,14,31,466,511,
Caddo,President,Gary Johnson,LIB,80510,0,1,26,27,
Caddo,President,Hillary Clinton,DEM,80510,3,2,105,110,
Caddo,U.S. Senate,James Lankford,REP,80510,14,33,490,537,
Caddo,U.S. Senate,Robert Murphy,LIB,80510,0,0,10,10,
Caddo,U.S. Senate,Mike Workman,DEM,80510,4,0,85,89,
Caddo,U.S. Senate,Mark Beard,IND,80510,0,1,10,11,
Caddo,U.S. Senate,Sean Braddy,IND,80510,0,0,7,7,
Caddo,U.S. House,Frank Lucas,REP,80510,14,30,490,534,03
Caddo,U.S. House,Frankie Robbins,DEM,80510,4,4,111,119,03
Caddo,State House,Scooter Park,REP,80510,14,21,461,496,65
Caddo,State House,Rick Gilleland,DEM,80510,4,13,137,154,65
Caddo,President,Donald Trump,REP,80511,27,28,532,587,
Caddo,President,Gary Johnson,LIB,80511,1,2,51,54,
Caddo,President,Hillary Clinton,DEM,80511,7,8,221,236,
Caddo,U.S. Senate,James Lankford,REP,80511,29,29,595,653,
Caddo,U.S. Senate,Robert Murphy,LIB,80511,0,1,18,19,
Caddo,U.S. Senate,Mike Workman,DEM,80511,7,8,161,176,
Caddo,U.S. Senate,Mark Beard,IND,80511,1,0,11,12,
Caddo,U.S. Senate,Sean Braddy,IND,80511,0,0,13,13,
Caddo,U.S. House,Frank Lucas,REP,80511,30,26,595,651,03
Caddo,U.S. House,Frankie Robbins,DEM,80511,7,12,200,219,03
Caddo,State House,Scooter Park,REP,80511,29,25,542,596,65
Caddo,State House,Rick Gilleland,DEM,80511,8,13,253,274,65
Caddo,President,Donald Trump,REP,80712,11,21,321,353,
Caddo,President,Gary Johnson,LIB,80712,0,2,28,30,
Caddo,President,Hillary Clinton,DEM,80712,6,5,110,121,
Caddo,U.S. Senate,James Lankford,REP,80712,14,26,355,395,
Caddo,U.S. Senate,Robert Murphy,LIB,80712,1,0,11,12,
Caddo,U.S. Senate,Mike Workman,DEM,80712,2,2,85,89,
Caddo,U.S. Senate,Mark Beard,IND,80712,0,0,8,8,
Caddo,U.S. Senate,Sean Braddy,IND,80712,0,0,4,4,
Caddo,U.S. House,Frank Lucas,REP,80712,13,24,360,397,03
Caddo,U.S. House,Frankie Robbins,DEM,80712,4,4,101,109,03
Caddo,State House,Chris Verser,REP,80712,8,8,101,117,56
Caddo,State House,David Perryman,DEM,80712,9,20,363,392,56
Caddo,President,Donald Trump,REP,80715,4,3,66,73,
Caddo,President,Gary Johnson,LIB,80715,0,2,3,5,
Caddo,President,Hillary Clinton,DEM,80715,0,0,24,24,
Caddo,U.S. Senate,James Lankford,REP,80715,4,5,70,79,
Caddo,U.S. Senate,Robert Murphy,LIB,80715,1,0,0,1,
Caddo,U.S. Senate,Mike Workman,DEM,80715,0,0,16,16,
Caddo,U.S. Senate,Mark Beard,IND,80715,0,0,2,2,
Caddo,U.S. Senate,Sean Braddy,IND,80715,0,0,5,5,
Caddo,U.S. House,Frank Lucas,REP,80715,5,4,69,78,03
Caddo,U.S. House,Frankie Robbins,DEM,80715,0,1,24,25,03
Caddo,State House,Chris Verser,REP,80715,2,1,18,21,56
Caddo,State House,David Perryman,DEM,80715,3,4,75,82,56
Caddo,President,Donald Trump,REP,80810,10,13,146,169,
Caddo,President,Gary Johnson,LIB,80810,0,0,10,10,
Caddo,President,Hillary Clinton,DEM,80810,5,6,38,49,
Caddo,U.S. Senate,James Lankford,REP,80810,14,15,152,181,
Caddo,U.S. Senate,Robert Murphy,LIB,80810,0,0,1,1,
Caddo,U.S. Senate,Mike Workman,DEM,80810,1,3,34,38,
Caddo,U.S. Senate,Mark Beard,IND,80810,0,0,1,1,
Caddo,U.S. Senate,Sean Braddy,IND,80810,0,0,4,4,
Caddo,U.S. House,Frank Lucas,REP,80810,14,15,156,185,03
Caddo,U.S. House,Frankie Robbins,DEM,80810,1,3,38,42,03
Caddo,State House,Chris Verser,REP,80810,3,8,38,49,56
Caddo,State House,David Perryman,DEM,80810,12,11,156,179,56
Caddo,President,Donald Trump,REP,80811,17,34,206,257,
Caddo,President,Gary Johnson,LIB,80811,0,2,9,11,
Caddo,President,Hillary Clinton,DEM,80811,4,15,53,72,
Caddo,U.S. Senate,James Lankford,REP,80811,17,39,219,275,
Caddo,U.S. Senate,Robert Murphy,LIB,80811,0,0,0,0,
Caddo,U.S. Senate,Mike Workman,DEM,80811,5,10,41,56,
Caddo,U.S. Senate,Mark Beard,IND,80811,0,0,3,3,
Caddo,U.S. Senate,Sean Braddy,IND,80811,0,1,3,4,
Caddo,U.S. House,Frank Lucas,REP,80811,18,41,220,279,03
Caddo,U.S. House,Frankie Robbins,DEM,80811,4,9,49,62,03
Caddo,State House,Chris Verser,REP,80811,10,13,72,95,56
Caddo,State House,David Perryman,DEM,80811,12,35,198,245,56
Caddo,President,Donald Trump,REP,80812,6,7,138,151,
Caddo,President,Gary Johnson,LIB,80812,0,0,10,10,
Caddo,President,Hillary Clinton,DEM,80812,6,2,43,51,
Caddo,U.S. Senate,James Lankford,REP,80812,7,6,145,158,
Caddo,U.S. Senate,Robert Murphy,LIB,80812,0,0,4,4,
Caddo,U.S. Senate,Mike Workman,DEM,80812,5,3,35,43,
Caddo,U.S. Senate,Mark Beard,IND,80812,0,0,4,4,
Caddo,U.S. Senate,Sean Braddy,IND,80812,0,0,3,3,
Caddo,U.S. House,Frank Lucas,REP,80812,6,6,151,163,03
Caddo,U.S. House,Frankie Robbins,DEM,80812,6,3,40,49,03
Caddo,State House,Chris Verser,REP,80812,2,3,73,78,56
Caddo,State House,David Perryman,DEM,80812,10,6,117,133,56
Caddo,President,Donald Trump,REP,81009,5,15,219,239,
Caddo,President,Gary Johnson,LIB,81009,0,1,10,11,
Caddo,President,Hillary Clinton,DEM,81009,0,0,48,48,
Caddo,U.S. Senate,James Lankford,REP,81009,3,16,225,244,
Caddo,U.S. Senate,Robert Murphy,LIB,81009,0,0,6,6,
Caddo,U.S. Senate,Mike Workman,DEM,81009,2,0,39,41,
Caddo,U.S. Senate,Mark Beard,IND,81009,0,0,1,1,
Caddo,U.S. Senate,Sean Braddy,IND,81009,0,0,5,5,
Caddo,U.S. House,Frank Lucas,REP,81009,4,16,227,247,03
Caddo,U.S. House,Frankie Robbins,DEM,81009,1,0,46,47,03
Caddo,State House,Chris Verser,REP,81009,3,11,139,153,56
Caddo,State House,David Perryman,DEM,81009,2,5,134,141,56
Caddo,President,Donald Trump,REP,81010,3,12,346,361,
Caddo,President,Gary Johnson,LIB,81010,0,1,14,15,
Caddo,President,Hillary Clinton,DEM,81010,2,3,64,69,
Caddo,U.S. Senate,James Lankford,REP,81010,3,13,348,364,
Caddo,U.S. Senate,Robert Murphy,LIB,81010,0,0,7,7,
Caddo,U.S. Senate,Mike Workman,DEM,81010,1,3,56,60,
Caddo,U.S. Senate,Mark Beard,IND,81010,0,0,4,4,
Caddo,U.S. Senate,Sean Braddy,IND,81010,0,0,6,6,
Caddo,U.S. House,Frank Lucas,REP,81010,4,14,347,365,03
Caddo,U.S. House,Frankie Robbins,DEM,81010,1,2,72,75,03
Caddo,State House,Chris Verser,REP,81010,1,6,123,130,56
Caddo,State House,David Perryman,DEM,81010,3,10,293,306,56
Caddo,President,Donald Trump,REP,81011,14,2,242,258,
Caddo,President,Gary Johnson,LIB,81011,1,0,5,6,
Caddo,President,Hillary Clinton,DEM,81011,1,0,50,51,
Caddo,U.S. Senate,James Lankford,REP,81011,14,2,249,265,
Caddo,U.S. Senate,Robert Murphy,LIB,81011,1,0,6,7,
Caddo,U.S. Senate,Mike Workman,DEM,81011,1,0,38,39,
Caddo,U.S. Senate,Mark Beard,IND,81011,0,0,1,1,
Caddo,U.S. Senate,Sean Braddy,IND,81011,0,0,5,5,
Caddo,U.S. House,Frank Lucas,REP,81011,15,2,245,262,03
Caddo,U.S. House,Frankie Robbins,DEM,81011,1,0,52,53,03
Caddo,State House,Rhonda Baker,REP,81011,8,2,162,172,60
Caddo,State House,Dennis Purifoy,DEM,81011,8,0,133,141,60
Caddo,President,Donald Trump,REP,81013,20,0,225,245,
Caddo,President,Gary Johnson,LIB,81013,0,0,14,14,
Caddo,President,Hillary Clinton,DEM,81013,10,2,41,53,
Caddo,U.S. Senate,James Lankford,REP,81013,22,0,226,248,
Caddo,U.S. Senate,Robert Murphy,LIB,81013,0,0,4,4,
Caddo,U.S. Senate,Mike Workman,DEM,81013,7,2,35,44,
Caddo,U.S. Senate,Mark Beard,IND,81013,0,0,5,5,
Caddo,U.S. Senate,Sean Braddy,IND,81013,0,0,9,9,
Caddo,U.S. House,Frank Lucas,REP,81013,22,1,227,250,03
Caddo,U.S. House,Frankie Robbins,DEM,81013,7,1,52,60,03
Caddo,State House,Rhonda Baker,REP,81013,16,0,173,189,60
Caddo,State House,Dennis Purifoy,DEM,81013,11,2,103,116,60
Caddo,President,Donald Trump,REP,81111,20,11,729,760,
Caddo,President,Gary Johnson,LIB,81111,0,2,35,37,
Caddo,President,Hillary Clinton,DEM,81111,2,4,107,113,
Caddo,U.S. Senate,James Lankford,REP,81111,21,14,738,773,
Caddo,U.S. Senate,Robert Murphy,LIB,81111,0,0,14,14,
Caddo,U.S. Senate,Mike Workman,DEM,81111,1,3,93,97,
Caddo,U.S. Senate,Mark Beard,IND,81111,0,0,9,9,
Caddo,U.S. Senate,Sean Braddy,IND,81111,0,0,14,14,
Caddo,U.S. House,Frank Lucas,REP,81111,21,11,748,780,03
Caddo,U.S. House,Frankie Robbins,DEM,81111,1,5,118,124,03
Caddo,State House,Rhonda Baker,REP,81111,18,10,604,632,60
Caddo,State House,Dennis Purifoy,DEM,81111,3,7,257,267,60
Caddo,President,Donald Trump,REP,81213,11,0,250,261,
Caddo,President,Gary Johnson,LIB,81213,3,0,11,14,
Caddo,President,Hillary Clinton,DEM,81213,1,0,36,37,
Caddo,U.S. Senate,James Lankford,REP,81213,12,0,254,266,
Caddo,U.S. Senate,Robert Murphy,LIB,81213,1,0,5,6,
Caddo,U.S. Senate,Mike Workman,DEM,81213,1,0,32,33,
Caddo,U.S. Senate,Mark Beard,IND,81213,0,0,2,2,
Caddo,U.S. Senate,Sean Braddy,IND,81213,1,0,4,5,
Caddo,U.S. House,Frank Lucas,REP,81213,12,0,253,265,03
Caddo,U.S. House,Frankie Robbins,DEM,81213,2,0,40,42,03
Canadian,President,Donald Trump,REP,90100,26,43,496,565,
Canadian,President,Gary Johnson,LIB,90100,0,2,37,39,
Canadian,President,Hillary Clinton,DEM,90100,5,17,156,178,
Canadian,U.S. Senate,James Lankford,REP,90100,26,41,498,565,
Canadian,U.S. Senate,Robert Murphy,LIB,90100,0,0,19,19,
Canadian,U.S. Senate,Mike Workman,DEM,90100,6,11,132,149,
Canadian,U.S. Senate,Mark Beard,IND,90100,0,4,12,16,
Canadian,U.S. Senate,Sean Braddy,IND,90100,0,4,24,28,
Canadian,U.S. House,Frank Lucas,REP,90100,26,42,507,575,03
Canadian,U.S. House,Frankie Robbins,DEM,90100,5,18,176,199,03
Canadian,State Senate,Lonnie Paxton,REP,90100,22,41,499,562,23
Canadian,State Senate,Larry Wasson,DEM,90100,9,19,182,210,23
Canadian,State House,Rhonda Baker,REP,90100,26,39,449,514,60
Canadian,State House,Dennis Purifoy,DEM,90100,5,21,230,256,60
Canadian,President,Donald Trump,REP,90102,2,8,121,131,
Canadian,President,Gary Johnson,LIB,90102,0,1,8,9,
Canadian,President,Hillary Clinton,DEM,90102,0,5,36,41,
Canadian,U.S. Senate,James Lankford,REP,90102,2,7,136,145,
Canadian,U.S. Senate,Robert Murphy,LIB,90102,0,1,3,4,
Canadian,U.S. Senate,Mike Workman,DEM,90102,0,5,24,29,
Canadian,U.S. Senate,Mark Beard,IND,90102,0,0,4,4,
Canadian,U.S. Senate,Sean Braddy,IND,90102,0,1,1,2,
Canadian,U.S. House,Frank Lucas,REP,90102,2,8,134,144,03
Canadian,U.S. House,Frankie Robbins,DEM,90102,0,6,34,40,03
Canadian,State Senate,Lonnie Paxton,REP,90102,2,10,131,143,23
Canadian,State Senate,Larry Wasson,DEM,90102,0,4,37,41,23
Canadian,President,Donald Trump,REP,90106,28,55,519,602,
Canadian,President,Gary Johnson,LIB,90106,0,8,54,62,
Canadian,President,Hillary Clinton,DEM,90106,23,35,214,272,
Canadian,U.S. Senate,James Lankford,REP,90106,33,65,567,665,
Canadian,U.S. Senate,Robert Murphy,LIB,90106,0,4,20,24,
Canadian,U.S. Senate,Mike Workman,DEM,90106,15,26,157,198,
Canadian,U.S. Senate,Mark Beard,IND,90106,0,2,16,18,
Canadian,U.S. Senate,Sean Braddy,IND,90106,1,1,24,26,
Canadian,U.S. House,Frank Lucas,REP,90106,31,64,581,676,03
Canadian,U.S. House,Frankie Robbins,DEM,90106,18,33,203,254,03
Canadian,State Senate,Lonnie Paxton,REP,90106,27,61,541,629,23
Canadian,State Senate,Larry Wasson,DEM,90106,23,36,235,294,23
Canadian,State House,Rhonda Baker,REP,90106,24,56,497,577,60
Canadian,State House,Dennis Purifoy,DEM,90106,25,41,281,347,60
Canadian,President,Donald Trump,REP,90107,4,24,248,276,
Canadian,President,Gary Johnson,LIB,90107,0,0,13,13,
Canadian,President,Hillary Clinton,DEM,90107,4,5,69,78,
Canadian,U.S. Senate,James Lankford,REP,90107,5,23,256,284,
Canadian,U.S. Senate,Robert Murphy,LIB,90107,0,3,9,12,
Canadian,U.S. Senate,Mike Workman,DEM,90107,3,3,57,63,
Canadian,U.S. Senate,Mark Beard,IND,90107,0,0,5,5,
Canadian,U.S. Senate,Sean Braddy,IND,90107,0,0,2,2,
Canadian,U.S. House,Frank Lucas,REP,90107,6,25,255,286,03
Canadian,U.S. House,Frankie Robbins,DEM,90107,2,4,71,77,03
Canadian,State Senate,Lonnie Paxton,REP,90107,4,23,231,258,23
Canadian,State Senate,Larry Wasson,DEM,90107,4,6,92,102,23
Canadian,State House,Rhonda Baker,REP,90107,5,20,208,233,60
Canadian,State House,Dennis Purifoy,DEM,90107,3,9,115,127,60
Canadian,President,Donald Trump,REP,90109,6,6,95,107,
Canadian,President,Gary Johnson,LIB,90109,0,0,4,4,
Canadian,President,Hillary Clinton,DEM,90109,2,3,25,30,
Canadian,U.S. Senate,James Lankford,REP,90109,6,7,101,114,
Canadian,U.S. Senate,Robert Murphy,LIB,90109,0,0,4,4,
Canadian,U.S. Senate,Mike Workman,DEM,90109,2,3,18,23,
Canadian,U.S. Senate,Mark Beard,IND,90109,0,0,0,0,
Canadian,U.S. Senate,Sean Braddy,IND,90109,0,0,1,1,
Canadian,U.S. House,Frank Lucas,REP,90109,6,7,101,114,03
Canadian,U.S. House,Frankie Robbins,DEM,90109,2,3,24,29,03
Canadian,State Senate,Lonnie Paxton,REP,90109,6,7,98,111,23
Canadian,State Senate,Larry Wasson,DEM,90109,2,3,26,31,23
Canadian,President,Donald Trump,REP,90114,35,47,448,530,
Canadian,President,Gary Johnson,LIB,90114,1,2,30,33,
Canadian,President,Hillary Clinton,DEM,90114,9,9,136,154,
Canadian,U.S. Senate,James Lankford,REP,90114,37,49,441,527,
Canadian,U.S. Senate,Robert Murphy,LIB,90114,1,0,21,22,
Canadian,U.S. Senate,Mike Workman,DEM,90114,8,9,116,133,
Canadian,U.S. Senate,Mark Beard,IND,90114,0,1,16,17,
Canadian,U.S. Senate,Sean Braddy,IND,90114,0,0,14,14,
Canadian,U.S. House,Frank Lucas,REP,90114,37,50,472,559,03
Canadian,U.S. House,Frankie Robbins,DEM,90114,9,9,133,151,03
Canadian,State Senate,Lonnie Paxton,REP,90114,35,48,451,534,23
Canadian,State Senate,Larry Wasson,DEM,90114,11,11,149,171,23
Canadian,State House,Rhonda Baker,REP,90114,37,42,395,474,60
Canadian,State House,Dennis Purifoy,DEM,90114,9,17,205,231,60
Canadian,President,Donald Trump,REP,90116,28,55,522,605,
Canadian,President,Gary Johnson,LIB,90116,5,6,63,74,
Canadian,President,Hillary Clinton,DEM,90116,11,53,311,375,
Canadian,U.S. Senate,James Lankford,REP,90116,27,66,564,657,
Canadian,U.S. Senate,Robert Murphy,LIB,90116,1,3,44,48,
Canadian,U.S. Senate,Mike Workman,DEM,90116,13,43,237,293,
Canadian,U.S. Senate,Mark Beard,IND,90116,2,1,25,28,
Canadian,U.S. Senate,Sean Braddy,IND,90116,1,2,25,28,
Canadian,U.S. House,Frank Lucas,REP,90116,27,65,592,684,03
Canadian,U.S. House,Frankie Robbins,DEM,90116,17,48,298,363,03
Canadian,State Senate,Lonnie Paxton,REP,90116,26,58,544,628,23
Canadian,State Senate,Larry Wasson,DEM,90116,18,53,338,409,23
Canadian,State House,Rhonda Baker,REP,90116,22,52,483,557,60
Canadian,State House,Dennis Purifoy,DEM,90116,21,61,401,483,60
Canadian,President,Donald Trump,REP,90124,27,57,716,800,
Canadian,President,Gary Johnson,LIB,90124,2,3,61,66,
Canadian,President,Hillary Clinton,DEM,90124,10,22,305,337,
Canadian,U.S. Senate,James Lankford,REP,90124,28,63,771,862,
Canadian,U.S. Senate,Robert Murphy,LIB,90124,0,2,28,30,
Canadian,U.S. Senate,Mike Workman,DEM,90124,9,14,225,248,
Canadian,U.S. Senate,Mark Beard,IND,90124,1,2,27,30,
Canadian,U.S. Senate,Sean Braddy,IND,90124,1,2,32,35,
Canadian,U.S. House,Frank Lucas,REP,90124,28,62,776,866,03
Canadian,U.S. House,Frankie Robbins,DEM,90124,11,20,304,335,03
Canadian,State Senate,Lonnie Paxton,REP,90124,30,61,733,824,23
Canadian,State Senate,Larry Wasson,DEM,90124,9,22,332,363,23
Canadian,State House,Rhonda Baker,REP,90124,26,52,644,722,60
Canadian,State House,Dennis Purifoy,DEM,90124,13,30,427,470,60
Canadian,President,Donald Trump,REP,90200,270,201,2107,2578,
Canadian,President,Gary Johnson,LIB,90200,34,13,196,243,
Canadian,President,Hillary Clinton,DEM,90200,96,71,716,883,
Canadian,U.S. Senate,James Lankford,REP,90200,315,210,2234,2759,
Canadian,U.S. Senate,Robert Murphy,LIB,90200,11,8,112,131,
Canadian,U.S. Senate,Mike Workman,DEM,90200,66,57,562,685,
Canadian,U.S. Senate,Mark Beard,IND,90200,2,4,49,55,
Canadian,U.S. Senate,Sean Braddy,IND,90200,7,7,66,80,
Canadian,U.S. House,Frank Lucas,REP,90200,304,211,2273,2788,03
Canadian,U.S. House,Frankie Robbins,DEM,90200,89,71,714,874,03
Canadian,President,Donald Trump,REP,90201,72,52,767,891,
Canadian,President,Gary Johnson,LIB,90201,8,6,59,73,
Canadian,President,Hillary Clinton,DEM,90201,23,19,113,155,
Canadian,U.S. Senate,James Lankford,REP,90201,83,53,795,931,
Canadian,U.S. Senate,Robert Murphy,LIB,90201,4,4,32,40,
Canadian,U.S. Senate,Mike Workman,DEM,90201,16,16,84,116,
Canadian,U.S. Senate,Mark Beard,IND,90201,1,0,14,15,
Canadian,U.S. Senate,Sean Braddy,IND,90201,1,5,13,19,
Canadian,U.S. House,Frank Lucas,REP,90201,85,53,820,958,03
Canadian,U.S. House,Frankie Robbins,DEM,90201,20,26,114,160,03
Canadian,State Senate,Lonnie Paxton,REP,90201,87,52,779,918,23
Canadian,State Senate,Larry Wasson,DEM,90201,18,26,138,182,23
Canadian,State House,Rhonda Baker,REP,90201,81,54,755,890,60
Canadian,State House,Dennis Purifoy,DEM,90201,25,24,168,217,60
Canadian,President,Donald Trump,REP,90202,35,26,338,399,
Canadian,President,Gary Johnson,LIB,90202,2,2,16,20,
Canadian,President,Hillary Clinton,DEM,90202,8,1,51,60,
Canadian,U.S. Senate,James Lankford,REP,90202,37,26,358,421,
Canadian,U.S. Senate,Robert Murphy,LIB,90202,3,1,5,9,
Canadian,U.S. Senate,Mike Workman,DEM,90202,4,2,36,42,
Canadian,U.S. Senate,Mark Beard,IND,90202,1,0,4,5,
Canadian,U.S. Senate,Sean Braddy,IND,90202,0,0,5,5,
Canadian,U.S. House,Frank Lucas,REP,90202,41,26,362,429,03
Canadian,U.S. House,Frankie Robbins,DEM,90202,3,2,44,49,03
Canadian,State Senate,Lonnie Paxton,REP,90202,38,25,350,413,23
Canadian,State Senate,Larry Wasson,DEM,90202,7,3,55,65,23
Canadian,President,Donald Trump,REP,90204,84,70,746,900,
Canadian,President,Gary Johnson,LIB,90204,11,9,79,99,
Canadian,President,Hillary Clinton,DEM,90204,33,20,234,287,
Canadian,U.S. Senate,James Lankford,REP,90204,95,72,786,953,
Canadian,U.S. Senate,Robert Murphy,LIB,90204,4,4,34,42,
Canadian,U.S. Senate,Mike Workman,DEM,90204,27,16,191,234,
Canadian,U.S. Senate,Mark Beard,IND,90204,0,2,18,20,
Canadian,U.S. Senate,Sean Braddy,IND,90204,3,4,31,38,
Canadian,U.S. House,Frank Lucas,REP,90204,95,73,802,970,03
Canadian,U.S. House,Frankie Robbins,DEM,90204,33,26,254,313,03
Canadian,State House,Rhonda Baker,REP,90204,89,69,749,907,60
Canadian,State House,Dennis Purifoy,DEM,90204,37,29,300,366,60
Canadian,President,Donald Trump,REP,90206,80,66,936,1082,
Canadian,President,Gary Johnson,LIB,90206,7,2,87,96,
Canadian,President,Hillary Clinton,DEM,90206,42,25,306,373,
Canadian,U.S. Senate,James Lankford,REP,90206,90,70,1007,1167,
Canadian,U.S. Senate,Robert Murphy,LIB,90206,6,0,40,46,
Canadian,U.S. Senate,Mike Workman,DEM,90206,30,19,239,288,
Canadian,U.S. Senate,Mark Beard,IND,90206,3,0,33,36,
Canadian,U.S. Senate,Sean Braddy,IND,90206,1,4,27,32,
Canadian,U.S. House,Frank Lucas,REP,90206,96,66,1031,1193,03
Canadian,U.S. House,Frankie Robbins,DEM,90206,38,27,305,370,03
Canadian,State House,Rhonda Baker,REP,90206,82,63,942,1087,60
Canadian,State House,Dennis Purifoy,DEM,90206,47,30,390,467,60
Canadian,President,Donald Trump,REP,90208,77,79,773,929,
Canadian,President,Gary Johnson,LIB,90208,8,4,111,123,
Canadian,President,Hillary Clinton,DEM,90208,51,28,264,343,
Canadian,U.S. Senate,James Lankford,REP,90208,81,76,858,1015,
Canadian,U.S. Senate,Robert Murphy,LIB,90208,4,1,48,53,
Canadian,U.S. Senate,Mike Workman,DEM,90208,45,25,181,251,
Canadian,U.S. Senate,Mark Beard,IND,90208,2,4,25,31,
Canadian,U.S. Senate,Sean Braddy,IND,90208,2,5,42,49,
Canadian,U.S. House,Frank Lucas,REP,90208,89,79,863,1031,03
Canadian,U.S. House,Frankie Robbins,DEM,90208,46,31,280,357,03
Canadian,State House,John Paul Jordan,REP,90208,70,64,723,857,43
Canadian,State House,Mike Bounds,DEM,90208,57,37,322,416,43
Canadian,State House,Sooner Davenport,IND,90208,7,9,101,117,43
Canadian,President,Donald Trump,REP,90209,2,0,26,28,
Canadian,President,Gary Johnson,LIB,90209,0,0,4,4,
Canadian,President,Hillary Clinton,DEM,90209,2,1,17,20,
Canadian,U.S. Senate,James Lankford,REP,90209,2,0,26,28,
Canadian,U.S. Senate,Robert Murphy,LIB,90209,0,0,2,2,
Canadian,U.S. Senate,Mike Workman,DEM,90209,2,1,14,17,
Canadian,U.S. Senate,Mark Beard,IND,90209,0,0,1,1,
Canadian,U.S. Senate,Sean Braddy,IND,90209,0,0,2,2,
Canadian,U.S. House,Frank Lucas,REP,90209,2,0,30,32,03
Canadian,U.S. House,Frankie Robbins,DEM,90209,2,1,16,19,03
Canadian,State House,Rhonda Baker,REP,90209,2,0,30,32,60
Canadian,State House,Dennis Purifoy,DEM,90209,2,1,15,18,60
Canadian,President,Donald Trump,REP,90210,62,40,354,456,
Canadian,President,Gary Johnson,LIB,90210,4,2,23,29,
Canadian,President,Hillary Clinton,DEM,90210,9,9,84,102,
Canadian,U.S. Senate,James Lankford,REP,90210,68,45,390,503,
Canadian,U.S. Senate,Robert Murphy,LIB,90210,0,0,10,10,
Canadian,U.S. Senate,Mike Workman,DEM,90210,8,7,57,72,
Canadian,U.S. Senate,Mark Beard,IND,90210,0,0,4,4,
Canadian,U.S. Senate,Sean Braddy,IND,90210,0,0,5,5,
Canadian,U.S. House,Frank Lucas,REP,90210,69,44,390,503,03
Canadian,U.S. House,Frankie Robbins,DEM,90210,7,8,69,84,03
Canadian,State Senate,Lonnie Paxton,REP,90210,64,41,376,481,23
Canadian,State Senate,Larry Wasson,DEM,90210,11,9,81,101,23
Canadian,State House,John Paul Jordan,REP,90210,47,37,320,404,43
Canadian,State House,Mike Bounds,DEM,90210,26,12,125,163,43
Canadian,State House,Sooner Davenport,IND,90210,2,1,17,20,43
Canadian,President,Donald Trump,REP,90211,60,47,533,640,
Canadian,President,Gary Johnson,LIB,90211,9,2,45,56,
Canadian,President,Hillary Clinton,DEM,90211,31,11,127,169,
Canadian,U.S. Senate,James Lankford,REP,90211,67,49,562,678,
Canadian,U.S. Senate,Robert Murphy,LIB,90211,3,0,18,21,
Canadian,U.S. Senate,Mike Workman,DEM,90211,20,12,96,128,
Canadian,U.S. Senate,Mark Beard,IND,90211,0,1,9,10,
Canadian,U.S. Senate,Sean Braddy,IND,90211,8,0,20,28,
Canadian,U.S. House,Frank Lucas,REP,90211,70,49,571,690,03
Canadian,U.S. House,Frankie Robbins,DEM,90211,28,13,128,169,03
Canadian,State House,Rhonda Baker,REP,90211,62,48,559,669,60
Canadian,State House,Dennis Purifoy,DEM,90211,36,14,142,192,60
Canadian,President,Donald Trump,REP,90214,81,55,783,919,
Canadian,President,Gary Johnson,LIB,90214,4,2,80,86,
Canadian,President,Hillary Clinton,DEM,90214,25,26,209,260,
Canadian,U.S. Senate,James Lankford,REP,90214,84,57,803,944,
Canadian,U.S. Senate,Robert Murphy,LIB,90214,1,0,33,34,
Canadian,U.S. Senate,Mike Workman,DEM,90214,19,22,181,222,
Canadian,U.S. Senate,Mark Beard,IND,90214,3,1,30,34,
Canadian,U.S. Senate,Sean Braddy,IND,90214,2,2,24,28,
Canadian,U.S. House,Frank Lucas,REP,90214,84,56,834,974,03
Canadian,U.S. House,Frankie Robbins,DEM,90214,23,25,227,275,03
Canadian,State House,John Paul Jordan,REP,90214,69,47,669,785,43
Canadian,State House,Mike Bounds,DEM,90214,30,31,313,374,43
Canadian,State House,Sooner Davenport,IND,90214,9,4,77,90,43
Canadian,President,Donald Trump,REP,90215,163,158,1027,1348,
Canadian,President,Gary Johnson,LIB,90215,15,10,119,144,
Canadian,President,Hillary Clinton,DEM,90215,72,41,289,402,
Canadian,U.S. Senate,James Lankford,REP,90215,171,169,1063,1403,
Canadian,U.S. Senate,Robert Murphy,LIB,90215,6,3,61,70,
Canadian,U.S. Senate,Mike Workman,DEM,90215,61,36,231,328,
Canadian,U.S. Senate,Mark Beard,IND,90215,2,1,25,28,
Canadian,U.S. Senate,Sean Braddy,IND,90215,7,3,56,66,
Canadian,U.S. House,Frank Lucas,REP,90215,177,170,1091,1438,03
Canadian,U.S. House,Frankie Robbins,DEM,90215,67,40,329,436,03
Canadian,State House,John Paul Jordan,REP,90215,152,154,960,1266,43
Canadian,State House,Mike Bounds,DEM,90215,85,46,353,484,43
Canadian,State House,Sooner Davenport,IND,90215,8,8,114,130,43
Canadian,President,Donald Trump,REP,90216,194,160,997,1351,
Canadian,President,Gary Johnson,LIB,90216,12,5,100,117,
Canadian,President,Hillary Clinton,DEM,90216,50,42,301,393,
Canadian,U.S. Senate,James Lankford,REP,90216,205,172,1080,1457,
Canadian,U.S. Senate,Robert Murphy,LIB,90216,10,2,42,54,
Canadian,U.S. Senate,Mike Workman,DEM,90216,31,27,219,277,
Canadian,U.S. Senate,Mark Beard,IND,90216,5,2,30,37,
Canadian,U.S. Senate,Sean Braddy,IND,90216,8,6,27,41,
Canadian,U.S. House,Frank Lucas,REP,90216,213,172,1118,1503,03
Canadian,U.S. House,Frankie Robbins,DEM,90216,45,38,266,349,03
Canadian,State House,John Paul Jordan,REP,90216,170,134,849,1153,43
Canadian,State House,Mike Bounds,DEM,90216,70,65,449,584,43
Canadian,State House,Sooner Davenport,IND,90216,17,11,79,107,43
Canadian,President,Donald Trump,REP,90217,152,102,1108,1362,
Canadian,President,Gary Johnson,LIB,90217,12,5,89,106,
Canadian,President,Hillary Clinton,DEM,90217,48,38,333,419,
Canadian,U.S. Senate,James Lankford,REP,90217,163,108,1140,1411,
Canadian,U.S. Senate,Robert Murphy,LIB,90217,4,3,62,69,
Canadian,U.S. Senate,Mike Workman,DEM,90217,36,30,253,319,
Canadian,U.S. Senate,Mark Beard,IND,90217,4,0,30,34,
Canadian,U.S. Senate,Sean Braddy,IND,90217,9,6,38,53,
Canadian,U.S. House,Frank Lucas,REP,90217,170,107,1172,1449,03
Canadian,U.S. House,Frankie Robbins,DEM,90217,44,40,339,423,03
Canadian,State House,John Paul Jordan,REP,90217,143,96,1013,1252,43
Canadian,State House,Mike Bounds,DEM,90217,52,41,357,450,43
Canadian,State House,Sooner Davenport,IND,90217,20,8,133,161,43
Canadian,President,Donald Trump,REP,90218,83,54,773,910,
Canadian,President,Gary Johnson,LIB,90218,3,5,75,83,
Canadian,President,Hillary Clinton,DEM,90218,19,23,178,220,
Canadian,U.S. Senate,James Lankford,REP,90218,89,51,791,931,
Canadian,U.S. Senate,Robert Murphy,LIB,90218,3,3,35,41,
Canadian,U.S. Senate,Mike Workman,DEM,90218,11,18,137,166,
Canadian,U.S. Senate,Mark Beard,IND,90218,1,3,24,28,
Canadian,U.S. Senate,Sean Braddy,IND,90218,2,6,28,36,
Canadian,U.S. House,Frank Lucas,REP,90218,89,52,795,936,03
Canadian,U.S. House,Frankie Robbins,DEM,90218,17,27,209,253,03
Canadian,State House,John Paul Jordan,REP,90218,69,46,677,792,43
Canadian,State House,Mike Bounds,DEM,90218,28,28,240,296,43
Canadian,State House,Sooner Davenport,IND,90218,9,6,88,103,43
Canadian,President,Donald Trump,REP,90220,172,149,1220,1541,
Canadian,President,Gary Johnson,LIB,90220,31,6,131,168,
Canadian,President,Hillary Clinton,DEM,90220,64,55,392,511,
Canadian,U.S. Senate,James Lankford,REP,90220,211,158,1308,1677,
Canadian,U.S. Senate,Robert Murphy,LIB,90220,9,1,56,66,
Canadian,U.S. Senate,Mike Workman,DEM,90220,49,43,295,387,
Canadian,U.S. Senate,Mark Beard,IND,90220,0,2,37,39,
Canadian,U.S. Senate,Sean Braddy,IND,90220,5,4,46,55,
Canadian,U.S. House,Frank Lucas,REP,90220,209,157,1334,1700,03
Canadian,U.S. House,Frankie Robbins,DEM,90220,61,47,387,495,03
Canadian,State House,John Paul Jordan,REP,90220,161,134,1126,1421,43
Canadian,State House,Mike Bounds,DEM,90220,91,60,483,634,43
Canadian,State House,Sooner Davenport,IND,90220,17,8,117,142,43
Canadian,President,Donald Trump,REP,90221,73,61,858,992,
Canadian,President,Gary Johnson,LIB,90221,8,7,99,114,
Canadian,President,Hillary Clinton,DEM,90221,22,39,249,310,
Canadian,U.S. Senate,James Lankford,REP,90221,74,66,898,1038,
Canadian,U.S. Senate,Robert Murphy,LIB,90221,3,3,49,55,
Canadian,U.S. Senate,Mike Workman,DEM,90221,24,34,195,253,
Canadian,U.S. Senate,Mark Beard,IND,90221,0,1,24,25,
Canadian,U.S. Senate,Sean Braddy,IND,90221,3,2,28,33,
Canadian,U.S. House,Frank Lucas,REP,90221,75,66,903,1044,03
Canadian,U.S. House,Frankie Robbins,DEM,90221,29,39,278,346,03
Canadian,State House,John Paul Jordan,REP,90221,67,54,793,914,43
Canadian,State House,Mike Bounds,DEM,90221,27,47,274,348,43
Canadian,State House,Sooner Davenport,IND,90221,8,4,114,126,43
Canadian,President,Donald Trump,REP,90223,144,102,1050,1296,
Canadian,President,Gary Johnson,LIB,90223,21,7,118,146,
Canadian,President,Hillary Clinton,DEM,90223,60,47,389,496,
Canadian,U.S. Senate,James Lankford,REP,90223,145,103,1109,1357,
Canadian,U.S. Senate,Robert Murphy,LIB,90223,8,4,70,82,
Canadian,U.S. Senate,Mike Workman,DEM,90223,55,43,302,400,
Canadian,U.S. Senate,Mark Beard,IND,90223,5,5,25,35,
Canadian,U.S. Senate,Sean Braddy,IND,90223,8,1,55,64,
Canadian,U.S. House,Frank Lucas,REP,90223,154,108,1143,1405,03
Canadian,U.S. House,Frankie Robbins,DEM,90223,65,49,401,515,03
Canadian,State House,John Paul Jordan,REP,90223,128,100,990,1218,43
Canadian,State House,Mike Bounds,DEM,90223,71,49,434,554,43
Canadian,State House,Sooner Davenport,IND,90223,20,7,121,148,43
Canadian,President,Donald Trump,REP,90224,87,77,686,850,
Canadian,President,Gary Johnson,LIB,90224,9,7,85,101,
Canadian,President,Hillary Clinton,DEM,90224,22,32,223,277,
Canadian,U.S. Senate,James Lankford,REP,90224,86,80,713,879,
Canadian,U.S. Senate,Robert Murphy,LIB,90224,5,4,35,44,
Canadian,U.S. Senate,Mike Workman,DEM,90224,19,26,180,225,
Canadian,U.S. Senate,Mark Beard,IND,90224,4,1,23,28,
Canadian,U.S. Senate,Sean Braddy,IND,90224,3,3,31,37,
Canadian,U.S. House,Frank Lucas,REP,90224,86,80,735,901,03
Canadian,U.S. House,Frankie Robbins,DEM,90224,29,32,241,302,03
Canadian,State House,John Paul Jordan,REP,90224,77,75,626,778,43
Canadian,State House,Mike Bounds,DEM,90224,31,35,262,328,43
Canadian,State House,Sooner Davenport,IND,90224,7,3,81,91,43
Canadian,President,Donald Trump,REP,90225,79,66,725,870,
Canadian,President,Gary Johnson,LIB,90225,12,4,94,110,
Canadian,President,Hillary Clinton,DEM,90225,40,27,301,368,
Canadian,U.S. Senate,James Lankford,REP,90225,86,67,804,957,
Canadian,U.S. Senate,Robert Murphy,LIB,90225,5,5,43,53,
Canadian,U.S. Senate,Mike Workman,DEM,90225,33,21,210,264,
Canadian,U.S. Senate,Mark Beard,IND,90225,3,3,20,26,
Canadian,U.S. Senate,Sean Braddy,IND,90225,1,1,43,45,
Canadian,U.S. House,Frank Lucas,REP,90225,90,72,830,992,03
Canadian,U.S. House,Frankie Robbins,DEM,90225,37,25,279,341,03
Canadian,State House,Leslie Kathryn Osborn,REP,90225,85,69,767,921,47
Canadian,State House,O.A. Cargill,DEM,90225,40,26,331,397,47
Canadian,President,Donald Trump,REP,90226,21,14,264,299,
Canadian,President,Gary Johnson,LIB,90226,0,0,18,18,
Canadian,President,Hillary Clinton,DEM,90226,4,1,37,42,
Canadian,U.S. Senate,James Lankford,REP,90226,19,14,267,300,
Canadian,U.S. Senate,Robert Murphy,LIB,90226,1,0,9,10,
Canadian,U.S. Senate,Mike Workman,DEM,90226,4,1,33,38,
Canadian,U.S. Senate,Mark Beard,IND,90226,0,0,8,8,
Canadian,U.S. Senate,Sean Braddy,IND,90226,1,0,2,3,
Canadian,U.S. House,Frank Lucas,REP,90226,17,14,269,300,03
Canadian,U.S. House,Frankie Robbins,DEM,90226,8,1,47,56,03
Canadian,State Senate,Lonnie Paxton,REP,90226,18,14,266,298,23
Canadian,State Senate,Larry Wasson,DEM,90226,6,1,46,53,23
Canadian,State House,Rhonda Baker,REP,90226,15,11,245,271,60
Canadian,State House,Dennis Purifoy,DEM,90226,10,4,70,84,60
Canadian,President,Donald Trump,REP,90227,208,158,1134,1500,
Canadian,President,Gary Johnson,LIB,90227,13,10,125,148,
Canadian,President,Hillary Clinton,DEM,90227,68,42,437,547,
Canadian,U.S. Senate,James Lankford,REP,90227,238,169,1208,1615,
Canadian,U.S. Senate,Robert Murphy,LIB,90227,4,3,70,77,
Canadian,U.S. Senate,Mike Workman,DEM,90227,47,33,335,415,
Canadian,U.S. Senate,Mark Beard,IND,90227,1,1,36,38,
Canadian,U.S. Senate,Sean Braddy,IND,90227,4,2,60,66,
Canadian,U.S. House,Frank Lucas,REP,90227,233,168,1266,1667,03
Canadian,U.S. House,Frankie Robbins,DEM,90227,59,37,422,518,03
Canadian,State House,Leslie Kathryn Osborn,REP,90227,222,167,1212,1601,47
Canadian,State House,O.A. Cargill,DEM,90227,70,37,465,572,47
Canadian,President,Donald Trump,REP,90228,43,32,395,470,
Canadian,President,Gary Johnson,LIB,90228,6,4,55,65,
Canadian,President,Hillary Clinton,DEM,90228,15,16,179,210,
Canadian,U.S. Senate,James Lankford,REP,90228,43,31,400,474,
Canadian,U.S. Senate,Robert Murphy,LIB,90228,4,0,44,48,
Canadian,U.S. Senate,Mike Workman,DEM,90228,14,15,138,167,
Canadian,U.S. Senate,Mark Beard,IND,90228,2,1,19,22,
Canadian,U.S. Senate,Sean Braddy,IND,90228,1,5,20,26,
Canadian,U.S. House,Frank Lucas,REP,90228,44,35,421,500,03
Canadian,U.S. House,Frankie Robbins,DEM,90228,19,17,191,227,03
Canadian,State House,John Paul Jordan,REP,90228,41,31,373,445,43
Canadian,State House,Mike Bounds,DEM,90228,17,17,183,217,43
Canadian,State House,Sooner Davenport,IND,90228,5,4,59,68,43
Canadian,President,Donald Trump,REP,90300,128,61,835,1024,
Canadian,President,Gary Johnson,LIB,90300,11,1,64,76,
Canadian,President,Hillary Clinton,DEM,90300,33,13,181,227,
Canadian,U.S. Senate,James Lankford,REP,90300,133,62,839,1034,
Canadian,U.S. Senate,Robert Murphy,LIB,90300,5,2,38,45,
Canadian,U.S. Senate,Mike Workman,DEM,90300,27,11,148,186,
Canadian,U.S. Senate,Mark Beard,IND,90300,2,0,20,22,
Canadian,U.S. Senate,Sean Braddy,IND,90300,3,0,30,33,
Canadian,U.S. House,Tom Cole,REP,90300,136,57,829,1022,04
Canadian,U.S. House,Sevier White,LIB,90300,7,4,56,67,04
Canadian,U.S. House,Christina Owen,DEM,90300,27,12,187,226,04
Canadian,State House,Leslie Kathryn Osborn,REP,90300,133,59,839,1031,47
Canadian,State House,O.A. Cargill,DEM,90300,33,14,226,273,47
Canadian,President,Donald Trump,REP,90301,159,110,1373,1642,
Canadian,President,Gary Johnson,LIB,90301,8,9,126,143,
Canadian,President,Hillary Clinton,DEM,90301,49,40,305,394,
Canadian,U.S. Senate,James Lankford,REP,90301,167,124,1414,1705,
Canadian,U.S. Senate,Robert Murphy,LIB,90301,5,5,58,68,
Canadian,U.S. Senate,Mike Workman,DEM,90301,37,26,250,313,
Canadian,U.S. Senate,Mark Beard,IND,90301,5,2,27,34,
Canadian,U.S. Senate,Sean Braddy,IND,90301,4,3,48,55,
Canadian,U.S. House,Tom Cole,REP,90301,159,114,1400,1673,04
Canadian,U.S. House,Sevier White,LIB,90301,9,11,98,118,04
Canadian,U.S. House,Christina Owen,DEM,90301,49,35,289,373,04
Canadian,State House,Leslie Kathryn Osborn,REP,90301,165,119,1390,1674,47
Canadian,State House,O.A. Cargill,DEM,90301,49,39,372,460,47
Canadian,President,Donald Trump,REP,90302,116,60,1035,1211,
Canadian,President,Gary Johnson,LIB,90302,12,6,75,93,
Canadian,President,Hillary Clinton,DEM,90302,44,19,234,297,
Canadian,U.S. Senate,James Lankford,REP,90302,125,62,1048,1235,
Canadian,U.S. Senate,Robert Murphy,LIB,90302,8,4,51,63,
Canadian,U.S. Senate,Mike Workman,DEM,90302,36,19,180,235,
Canadian,U.S. Senate,Mark Beard,IND,90302,1,0,24,25,
Canadian,U.S. Senate,Sean Braddy,IND,90302,3,0,38,41,
Canadian,U.S. House,Tom Cole,REP,90302,123,59,1022,1204,04
Canadian,U.S. House,Sevier White,LIB,90302,9,5,69,83,04
Canadian,U.S. House,Christina Owen,DEM,90302,40,20,240,300,04
Canadian,State House,Leslie Kathryn Osborn,REP,90302,120,60,1026,1206,47
Canadian,State House,O.A. Cargill,DEM,90302,51,25,295,371,47
Canadian,President,Donald Trump,REP,90303,218,159,1386,1763,
Canadian,President,Gary Johnson,LIB,90303,16,10,99,125,
Canadian,President,Hillary Clinton,DEM,90303,73,54,378,505,
Canadian,U.S. Senate,James Lankford,REP,90303,242,173,1451,1866,
Canadian,U.S. Senate,Robert Murphy,LIB,90303,5,7,51,63,
Canadian,U.S. Senate,Mike Workman,DEM,90303,57,41,289,387,
Canadian,U.S. Senate,Mark Beard,IND,90303,1,1,25,27,
Canadian,U.S. Senate,Sean Braddy,IND,90303,5,3,42,50,
Canadian,U.S. House,Frank Lucas,REP,90303,237,174,1476,1887,03
Canadian,U.S. House,Frankie Robbins,DEM,90303,71,51,366,488,03
Canadian,State House,Leslie Kathryn Osborn,REP,90303,236,174,1435,1845,47
Canadian,State House,O.A. Cargill,DEM,90303,72,49,398,519,47
Canadian,President,Donald Trump,REP,90304,84,59,879,1022,
Canadian,President,Gary Johnson,LIB,90304,5,6,79,90,
Canadian,President,Hillary Clinton,DEM,90304,28,20,196,244,
Canadian,U.S. Senate,James Lankford,REP,90304,86,60,887,1033,
Canadian,U.S. Senate,Robert Murphy,LIB,90304,1,6,37,44,
Canadian,U.S. Senate,Mike Workman,DEM,90304,23,16,162,201,
Canadian,U.S. Senate,Mark Beard,IND,90304,3,1,32,36,
Canadian,U.S. Senate,Sean Braddy,IND,90304,2,1,39,42,
Canadian,U.S. House,Tom Cole,REP,90304,90,58,877,1025,04
Canadian,U.S. House,Sevier White,LIB,90304,2,9,63,74,04
Canadian,U.S. House,Christina Owen,DEM,90304,23,17,209,249,04
Canadian,State House,Leslie Kathryn Osborn,REP,90304,88,62,882,1032,47
Canadian,State House,O.A. Cargill,DEM,90304,26,22,254,302,47
Canadian,President,Donald Trump,REP,90306,197,119,1387,1703,
Canadian,President,Gary Johnson,LIB,90306,10,6,121,137,
Canadian,President,Hillary Clinton,DEM,90306,51,51,323,425,
Canadian,U.S. Senate,James Lankford,REP,90306,212,120,1451,1783,
Canadian,U.S. Senate,Robert Murphy,LIB,90306,3,5,68,76,
Canadian,U.S. Senate,Mike Workman,DEM,90306,34,43,241,318,
Canadian,U.S. Senate,Mark Beard,IND,90306,3,2,36,41,
Canadian,U.S. Senate,Sean Braddy,IND,90306,4,6,35,45,
Canadian,U.S. House,Tom Cole,REP,90306,209,121,1440,1770,04
Canadian,U.S. House,Sevier White,LIB,90306,9,3,93,105,04
Canadian,U.S. House,Christina Owen,DEM,90306,39,52,293,384,04
Canadian,State House,Leslie Kathryn Osborn,REP,90306,204,127,1431,1762,47
Canadian,State House,O.A. Cargill,DEM,90306,47,47,375,469,47
Canadian,President,Donald Trump,REP,90308,32,22,354,408,
Canadian,President,Gary Johnson,LIB,90308,4,3,23,30,
Canadian,President,Hillary Clinton,DEM,90308,4,3,51,58,
Canadian,U.S. Senate,James Lankford,REP,90308,36,27,362,425,
Canadian,U.S. Senate,Robert Murphy,LIB,90308,2,0,9,11,
Canadian,U.S. Senate,Mike Workman,DEM,90308,2,3,37,42,
Canadian,U.S. Senate,Mark Beard,IND,90308,0,0,8,8,
Canadian,U.S. Senate,Sean Braddy,IND,90308,0,0,11,11,
Canadian,U.S. House,Frank Lucas,REP,90308,37,29,375,441,03
Canadian,U.S. House,Frankie Robbins,DEM,90308,2,1,53,56,03
Canadian,State Senate,Lonnie Paxton,REP,90308,37,27,360,424,23
Canadian,State Senate,Larry Wasson,DEM,90308,2,3,65,70,23
Canadian,State House,Leslie Kathryn Osborn,REP,90308,37,25,359,421,47
Canadian,State House,O.A. Cargill,DEM,90308,1,5,68,74,47
Canadian,President,Donald Trump,REP,90309,11,1,87,99,
Canadian,President,Gary Johnson,LIB,90309,0,0,4,4,
Canadian,President,Hillary Clinton,DEM,90309,2,4,9,15,
Canadian,U.S. Senate,James Lankford,REP,90309,11,1,92,104,
Canadian,U.S. Senate,Robert Murphy,LIB,90309,0,0,0,0,
Canadian,U.S. Senate,Mike Workman,DEM,90309,2,4,8,14,
Canadian,U.S. Senate,Mark Beard,IND,90309,0,0,0,0,
Canadian,U.S. Senate,Sean Braddy,IND,90309,0,0,1,1,
Canadian,U.S. House,Tom Cole,REP,90309,11,1,89,101,04
Canadian,U.S. House,Sevier White,LIB,90309,0,0,3,3,04
Canadian,U.S. House,Christina Owen,DEM,90309,2,4,10,16,04
Canadian,State Senate,Lonnie Paxton,REP,90309,11,1,87,99,23
Canadian,State Senate,Larry Wasson,DEM,90309,2,4,13,19,23
Canadian,State House,Leslie Kathryn Osborn,REP,90309,11,1,87,99,47
Canadian,State House,O.A. Cargill,DEM,90309,2,4,14,20,47
Canadian,President,Donald Trump,REP,90398,0,0,0,0,
Canadian,President,Gary Johnson,LIB,90398,0,0,0,0,
Canadian,President,Hillary Clinton,DEM,90398,0,0,0,0,
Canadian,U.S. Senate,James Lankford,REP,90398,0,0,0,0,
Canadian,U.S. Senate,Robert Murphy,LIB,90398,0,0,0,0,
Canadian,U.S. Senate,Mike Workman,DEM,90398,0,0,0,0,
Canadian,U.S. Senate,Mark Beard,IND,90398,0,0,0,0,
Canadian,U.S. Senate,Sean Braddy,IND,90398,0,0,0,0,
Canadian,U.S. House,Tom Cole,REP,90398,0,0,0,0,04
Canadian,U.S. House,Sevier White,LIB,90398,0,0,0,0,04
Canadian,U.S. House,Christina Owen,DEM,90398,0,0,0,0,04
Canadian,State Senate,Lonnie Paxton,REP,90398,0,0,0,0,23
Canadian,State Senate,Larry Wasson,DEM,90398,0,0,0,0,23
Canadian,State House,Leslie Kathryn Osborn,REP,90398,0,0,0,0,47
Canadian,State House,O.A. Cargill,DEM,90398,0,0,0,0,47
Canadian,President,Donald Trump,REP,90399,0,0,0,0,
Canadian,President,Gary Johnson,LIB,90399,0,0,0,0,
Canadian,President,Hillary Clinton,DEM,90399,0,0,0,0,
Canadian,U.S. Senate,James Lankford,REP,90399,0,0,0,0,
Canadian,U.S. Senate,Robert Murphy,LIB,90399,0,0,0,0,
Canadian,U.S. Senate,Mike Workman,DEM,90399,0,0,0,0,
Canadian,U.S. Senate,Mark Beard,IND,90399,0,0,0,0,
Canadian,U.S. Senate,Sean Braddy,IND,90399,0,0,0,0,
Canadian,U.S. House,Tom Cole,REP,90399,0,0,0,0,04
Canadian,U.S. House,Sevier White,LIB,90399,0,0,0,0,04
Canadian,U.S. House,Christina Owen,DEM,90399,0,0,0,0,04
Canadian,State Senate,Lonnie Paxton,REP,90399,0,0,0,0,23
Canadian,State Senate,Larry Wasson,DEM,90399,0,0,0,0,23
Canadian,State House,Leslie Kathryn Osborn,REP,90399,0,0,0,0,47
Canadian,State House,O.A. Cargill,DEM,90399,0,0,0,0,47
Canadian,President,Donald Trump,REP,90400,30,27,576,633,
Canadian,President,Gary Johnson,LIB,90400,6,0,35,41,
Canadian,President,Hillary Clinton,DEM,90400,5,4,87,96,
Canadian,U.S. Senate,James Lankford,REP,90400,35,29,576,640,
Canadian,U.S. Senate,Robert Murphy,LIB,90400,2,0,23,25,
Canadian,U.S. Senate,Mike Workman,DEM,90400,2,2,67,71,
Canadian,U.S. Senate,Mark Beard,IND,90400,1,0,16,17,
Canadian,U.S. Senate,Sean Braddy,IND,90400,1,0,14,15,
Canadian,U.S. House,Frank Lucas,REP,90400,37,29,593,659,03
Canadian,U.S. House,Frankie Robbins,DEM,90400,3,2,101,106,03
Canadian,State Senate,Lonnie Paxton,REP,90400,38,28,579,645,23
Canadian,State Senate,Larry Wasson,DEM,90400,2,2,110,114,23
Canadian,State House,Rhonda Baker,REP,90400,31,25,542,598,60
Canadian,State House,Dennis Purifoy,DEM,90400,9,5,144,158,60
Canadian,President,Donald Trump,REP,90403,19,11,254,284,
Canadian,President,Gary Johnson,LIB,90403,0,0,13,13,
Canadian,President,Hillary Clinton,DEM,90403,3,2,56,61,
Canadian,U.S. Senate,James Lankford,REP,90403,20,10,263,293,
Canadian,U.S. Senate,Robert Murphy,LIB,90403,0,0,7,7,
Canadian,U.S. Senate,Mike Workman,DEM,90403,0,1,38,39,
Canadian,U.S. Senate,Mark Beard,IND,90403,1,0,7,8,
Canadian,U.S. Senate,Sean Braddy,IND,90403,1,1,9,11,
Canadian,U.S. House,Frank Lucas,REP,90403,19,12,270,301,03
Canadian,U.S. House,Frankie Robbins,DEM,90403,3,1,53,57,03
Canadian,State Senate,Lonnie Paxton,REP,90403,19,12,255,286,23
Canadian,State Senate,Larry Wasson,DEM,90403,3,1,68,72,23
Canadian,State House,Rhonda Baker,REP,90403,16,12,231,259,60
Canadian,State House,Dennis Purifoy,DEM,90403,5,1,92,98,60
Canadian,President,Donald Trump,REP,90404,17,13,162,192,
Canadian,President,Gary Johnson,LIB,90404,2,1,12,15,
Canadian,President,Hillary Clinton,DEM,90404,0,2,28,30,
Canadian,U.S. Senate,James Lankford,REP,90404,18,15,161,194,
Canadian,U.S. Senate,Robert Murphy,LIB,90404,0,0,10,10,
Canadian,U.S. Senate,Mike Workman,DEM,90404,1,2,19,22,
Canadian,U.S. Senate,Mark Beard,IND,90404,0,0,3,3,
Canadian,U.S. Senate,Sean Braddy,IND,90404,0,0,6,6,
Canadian,U.S. House,Frank Lucas,REP,90404,18,15,165,198,03
Canadian,U.S. House,Frankie Robbins,DEM,90404,1,2,33,36,03
Canadian,State Senate,Lonnie Paxton,REP,90404,16,15,156,187,23
Canadian,State Senate,Larry Wasson,DEM,90404,3,2,41,46,23
Canadian,State House,Rhonda Baker,REP,90404,16,14,142,172,60
Canadian,State House,Dennis Purifoy,DEM,90404,3,3,54,60,60
Canadian,President,Donald Trump,REP,90406,9,7,138,154,
Canadian,President,Gary Johnson,LIB,90406,0,0,9,9,
Canadian,President,Hillary Clinton,DEM,90406,0,2,29,31,
Canadian,U.S. Senate,James Lankford,REP,90406,9,7,139,155,
Canadian,U.S. Senate,Robert Murphy,LIB,90406,0,0,6,6,
Canadian,U.S. Senate,Mike Workman,DEM,90406,0,2,22,24,
Canadian,U.S. Senate,Mark Beard,IND,90406,0,0,6,6,
Canadian,U.S. Senate,Sean Braddy,IND,90406,0,0,2,2,
Canadian,U.S. House,Frank Lucas,REP,90406,9,7,141,157,03
Canadian,U.S. House,Frankie Robbins,DEM,90406,0,2,31,33,03
Canadian,State Senate,Lonnie Paxton,REP,90406,9,6,134,149,23
Canadian,State Senate,Larry Wasson,DEM,90406,0,3,38,41,23
Canadian,President,Donald Trump,REP,90408,6,0,235,241,
Canadian,President,Gary Johnson,LIB,90408,1,1,19,21,
Canadian,President,Hillary Clinton,DEM,90408,4,2,59,65,
Canadian,U.S. Senate,James Lankford,REP,90408,6,0,238,244,
Canadian,U.S. Senate,Robert Murphy,LIB,90408,1,0,5,6,
Canadian,U.S. Senate,Mike Workman,DEM,90408,4,3,54,61,
Canadian,U.S. Senate,Mark Beard,IND,90408,0,0,10,10,
Canadian,U.S. Senate,Sean Braddy,IND,90408,0,0,7,7,
Canadian,U.S. House,Frank Lucas,REP,90408,6,1,249,256,03
Canadian,U.S. House,Frankie Robbins,DEM,90408,4,2,62,68,03
Canadian,State Senate,Lonnie Paxton,REP,90408,6,2,235,243,23
Canadian,State Senate,Larry Wasson,DEM,90408,4,1,73,78,23
Canadian,President,Donald Trump,REP,90409,4,0,29,33,
Canadian,President,Gary Johnson,LIB,90409,0,0,2,2,
Canadian,President,Hillary Clinton,DEM,90409,0,0,2,2,
Canadian,U.S. Senate,James Lankford,REP,90409,4,0,29,33,
Canadian,U.S. Senate,Robert Murphy,LIB,90409,0,0,0,0,
Canadian,U.S. Senate,Mike Workman,DEM,90409,0,0,3,3,
Canadian,U.S. Senate,Mark Beard,IND,90409,0,0,1,1,
Canadian,U.S. Senate,Sean Braddy,IND,90409,0,0,0,0,
Canadian,U.S. House,Frank Lucas,REP,90409,4,0,31,35,03
Canadian,U.S. House,Frankie Robbins,DEM,90409,0,0,2,2,03
Canadian,State Senate,Lonnie Paxton,REP,90409,4,0,31,35,23
Canadian,State Senate,Larry Wasson,DEM,90409,0,0,1,1,23
Canadian,President,Donald Trump,REP,90502,7,3,177,187,
Canadian,President,Gary Johnson,LIB,90502,0,0,7,7,
Canadian,President,Hillary Clinton,DEM,90502,3,1,24,28,
Canadian,U.S. Senate,James Lankford,REP,90502,9,4,181,194,
Canadian,U.S. Senate,Robert Murphy,LIB,90502,0,0,8,8,
Canadian,U.S. Senate,Mike Workman,DEM,90502,1,0,16,17,
Canadian,U.S. Senate,Mark Beard,IND,90502,0,0,1,1,
Canadian,U.S. Senate,Sean Braddy,IND,90502,0,0,3,3,
Canadian,U.S. House,Frank Lucas,REP,90502,9,4,187,200,03
Canadian,U.S. House,Frankie Robbins,DEM,90502,1,0,23,24,03
Canadian,State Senate,Lonnie Paxton,REP,90502,9,3,191,203,23
Canadian,State Senate,Larry Wasson,DEM,90502,1,1,18,20,23
Canadian,President,Donald Trump,REP,90503,28,12,268,308,
Canadian,President,Gary Johnson,LIB,90503,1,1,23,25,
Canadian,President,Hillary Clinton,DEM,90503,1,0,38,39,
Canadian,U.S. Senate,James Lankford,REP,90503,27,13,291,331,
Canadian,U.S. Senate,Robert Murphy,LIB,90503,2,0,9,11,
Canadian,U.S. Senate,Mike Workman,DEM,90503,1,1,22,24,
Canadian,U.S. Senate,Mark Beard,IND,90503,0,0,3,3,
Canadian,U.S. Senate,Sean Braddy,IND,90503,0,0,3,3,
Canadian,U.S. House,Frank Lucas,REP,90503,28,13,286,327,03
Canadian,U.S. House,Frankie Robbins,DEM,90503,2,1,36,39,03
Canadian,President,Donald Trump,REP,90504,125,60,1505,1690,
Canadian,President,Gary Johnson,LIB,90504,9,4,124,137,
Canadian,President,Hillary Clinton,DEM,90504,30,19,278,327,
Canadian,U.S. Senate,James Lankford,REP,90504,133,69,1609,1811,
Canadian,U.S. Senate,Robert Murphy,LIB,90504,2,1,43,46,
Canadian,U.S. Senate,Mike Workman,DEM,90504,21,15,198,234,
Canadian,U.S. Senate,Mark Beard,IND,90504,1,0,31,32,
Canadian,U.S. Senate,Sean Braddy,IND,90504,5,0,25,30,
Canadian,U.S. House,Frank Lucas,REP,90504,133,68,1613,1814,03
Canadian,U.S. House,Frankie Robbins,DEM,90504,27,17,251,295,03
Canadian,President,Donald Trump,REP,90506,280,146,1739,2165,
Canadian,President,Gary Johnson,LIB,90506,24,12,165,201,
Canadian,President,Hillary Clinton,DEM,90506,78,42,398,518,
Canadian,U.S. Senate,James Lankford,REP,90506,307,160,1863,2330,
Canadian,U.S. Senate,Robert Murphy,LIB,90506,8,6,100,114,
Canadian,U.S. Senate,Mike Workman,DEM,90506,57,33,276,366,
Canadian,U.S. Senate,Mark Beard,IND,90506,8,0,37,45,
Canadian,U.S. Senate,Sean Braddy,IND,90506,4,4,32,40,
Canadian,U.S. House,Frank Lucas,REP,90506,295,158,1880,2333,03
Canadian,U.S. House,Frankie Robbins,DEM,90506,79,42,376,497,03
Carter,President,Donald Trump,REP,100001,15,80,352,447,
Carter,President,Gary Johnson,LIB,100001,2,5,46,53,
Carter,President,Hillary Clinton,DEM,100001,10,59,215,284,
Carter,U.S. Senate,James Lankford,REP,100001,18,84,331,433,
Carter,U.S. Senate,Robert Murphy,LIB,100001,1,5,29,35,
Carter,U.S. Senate,Mike Workman,DEM,100001,8,52,195,255,
Carter,U.S. Senate,Mark Beard,IND,100001,0,1,28,29,
Carter,U.S. Senate,Sean Braddy,IND,100001,0,2,29,31,
Carter,U.S. House,Tom Cole,REP,100001,17,85,378,480,04
Carter,U.S. House,Sevier White,LIB,100001,1,7,40,48,04
Carter,U.S. House,Christina Owen,DEM,100001,9,52,194,255,04
Carter,President,Donald Trump,REP,100002,16,86,486,588,
Carter,President,Gary Johnson,LIB,100002,1,7,30,38,
Carter,President,Hillary Clinton,DEM,100002,10,38,203,251,
Carter,U.S. Senate,James Lankford,REP,100002,14,83,470,567,
Carter,U.S. Senate,Robert Murphy,LIB,100002,1,0,29,30,
Carter,U.S. Senate,Mike Workman,DEM,100002,8,44,187,239,
Carter,U.S. Senate,Mark Beard,IND,100002,1,0,18,19,
Carter,U.S. Senate,Sean Braddy,IND,100002,0,3,15,18,
Carter,U.S. House,Tom Cole,REP,100002,15,88,498,601,04
Carter,U.S. House,Sevier White,LIB,100002,2,3,32,37,04
Carter,U.S. House,Christina Owen,DEM,100002,7,38,191,236,04
Carter,President,Donald Trump,REP,100007,1,24,87,112,
Carter,President,Gary Johnson,LIB,100007,1,3,14,18,
Carter,President,Hillary Clinton,DEM,100007,15,78,355,448,
Carter,U.S. Senate,James Lankford,REP,100007,3,20,75,98,
Carter,U.S. Senate,Robert Murphy,LIB,100007,0,2,13,15,
Carter,U.S. Senate,Mike Workman,DEM,100007,15,76,340,431,
Carter,U.S. Senate,Mark Beard,IND,100007,0,2,10,12,
Carter,U.S. Senate,Sean Braddy,IND,100007,0,3,15,18,
Carter,U.S. House,Tom Cole,REP,100007,4,25,104,133,04
Carter,U.S. House,Sevier White,LIB,100007,0,1,9,10,04
Carter,U.S. House,Christina Owen,DEM,100007,14,77,340,431,04
Carter,President,Donald Trump,REP,100011,11,50,220,281,
Carter,President,Gary Johnson,LIB,100011,0,7,30,37,
Carter,President,Hillary Clinton,DEM,100011,13,40,103,156,
Carter,U.S. Senate,James Lankford,REP,100011,11,51,213,275,
Carter,U.S. Senate,Robert Murphy,LIB,100011,0,2,21,23,
Carter,U.S. Senate,Mike Workman,DEM,100011,12,36,94,142,
Carter,U.S. Senate,Mark Beard,IND,100011,1,2,10,13,
Carter,U.S. Senate,Sean Braddy,IND,100011,0,5,14,19,
Carter,U.S. House,Tom Cole,REP,100011,10,50,232,292,04
Carter,U.S. House,Sevier White,LIB,100011,1,5,27,33,04
Carter,U.S. House,Christina Owen,DEM,100011,13,41,94,148,04
Carter,President,Donald Trump,REP,100014,11,57,292,360,
Carter,President,Gary Johnson,LIB,100014,1,2,28,31,
Carter,President,Hillary Clinton,DEM,100014,8,22,98,128,
Carter,U.S. Senate,James Lankford,REP,100014,13,55,249,317,
Carter,U.S. Senate,Robert Murphy,LIB,100014,0,2,16,18,
Carter,U.S. Senate,Mike Workman,DEM,100014,7,20,113,140,
Carter,U.S. Senate,Mark Beard,IND,100014,0,0,20,20,
Carter,U.S. Senate,Sean Braddy,IND,100014,0,3,12,15,
Carter,U.S. House,Tom Cole,REP,100014,14,53,296,363,04
Carter,U.S. House,Sevier White,LIB,100014,1,5,14,20,04
Carter,U.S. House,Christina Owen,DEM,100014,5,22,105,132,04
Carter,President,Donald Trump,REP,100015,25,137,519,681,
Carter,President,Gary Johnson,LIB,100015,1,10,39,50,
Carter,President,Hillary Clinton,DEM,100015,13,56,177,246,
Carter,U.S. Senate,James Lankford,REP,100015,21,135,455,611,
Carter,U.S. Senate,Robert Murphy,LIB,100015,0,5,22,27,
Carter,U.S. Senate,Mike Workman,DEM,100015,17,52,204,273,
Carter,U.S. Senate,Mark Beard,IND,100015,0,5,16,21,
Carter,U.S. Senate,Sean Braddy,IND,100015,0,4,31,35,
Carter,U.S. House,Tom Cole,REP,100015,23,139,511,673,04
Carter,U.S. House,Sevier White,LIB,100015,0,11,24,35,04
Carter,U.S. House,Christina Owen,DEM,100015,15,52,191,258,04
Carter,President,Donald Trump,REP,100017,31,98,433,562,
Carter,President,Gary Johnson,LIB,100017,2,1,22,25,
Carter,President,Hillary Clinton,DEM,100017,8,30,172,210,
Carter,U.S. Senate,James Lankford,REP,100017,31,93,433,557,
Carter,U.S. Senate,Robert Murphy,LIB,100017,0,1,15,16,
Carter,U.S. Senate,Mike Workman,DEM,100017,8,32,146,186,
Carter,U.S. Senate,Mark Beard,IND,100017,0,1,8,9,
Carter,U.S. Senate,Sean Braddy,IND,100017,1,2,21,24,
Carter,U.S. House,Tom Cole,REP,100017,32,98,455,585,04
Carter,U.S. House,Sevier White,LIB,100017,1,0,21,22,04
Carter,U.S. House,Christina Owen,DEM,100017,8,30,151,189,04
Carter,President,Donald Trump,REP,100019,96,383,1070,1549,
Carter,President,Gary Johnson,LIB,100019,7,24,53,84,
Carter,President,Hillary Clinton,DEM,100019,30,101,254,385,
Carter,U.S. Senate,James Lankford,REP,100019,100,394,1078,1572,
Carter,U.S. Senate,Robert Murphy,LIB,100019,7,6,38,51,
Carter,U.S. Senate,Mike Workman,DEM,100019,24,96,212,332,
Carter,U.S. Senate,Mark Beard,IND,100019,0,4,17,21,
Carter,U.S. Senate,Sean Braddy,IND,100019,0,7,26,33,
Carter,U.S. House,Tom Cole,REP,100019,104,395,1113,1612,04
Carter,U.S. House,Sevier White,LIB,100019,5,14,46,65,04
Carter,U.S. House,Christina Owen,DEM,100019,21,97,220,338,04
Carter,President,Donald Trump,REP,100020,17,73,454,544,
Carter,President,Gary Johnson,LIB,100020,3,1,32,36,
Carter,President,Hillary Clinton,DEM,100020,15,43,201,259,
Carter,U.S. Senate,James Lankford,REP,100020,21,64,421,506,
Carter,U.S. Senate,Robert Murphy,LIB,100020,3,2,24,29,
Carter,U.S. Senate,Mike Workman,DEM,100020,8,43,204,255,
Carter,U.S. Senate,Mark Beard,IND,100020,0,1,16,17,
Carter,U.S. Senate,Sean Braddy,IND,100020,1,3,21,25,
Carter,U.S. House,Tom Cole,REP,100020,22,68,454,544,04
Carter,U.S. House,Sevier White,LIB,100020,3,4,26,33,04
Carter,U.S. House,Christina Owen,DEM,100020,8,41,204,253,04
Carter,President,Donald Trump,REP,100024,35,186,644,865,
Carter,President,Gary Johnson,LIB,100024,1,8,44,53,
Carter,President,Hillary Clinton,DEM,100024,19,36,174,229,
Carter,U.S. Senate,James Lankford,REP,100024,39,183,635,857,
Carter,U.S. Senate,Robert Murphy,LIB,100024,0,4,27,31,
Carter,U.S. Senate,Mike Workman,DEM,100024,16,35,150,201,
Carter,U.S. Senate,Mark Beard,IND,100024,0,5,20,25,
Carter,U.S. Senate,Sean Braddy,IND,100024,1,5,20,26,
Carter,U.S. House,Tom Cole,REP,100024,36,188,666,890,04
Carter,U.S. House,Sevier White,LIB,100024,2,8,40,50,04
Carter,U.S. House,Christina Owen,DEM,100024,18,34,152,204,04
Carter,President,Donald Trump,REP,100025,5,44,307,356,
Carter,President,Gary Johnson,LIB,100025,0,2,28,30,
Carter,President,Hillary Clinton,DEM,100025,1,14,42,57,
Carter,U.S. Senate,James Lankford,REP,100025,5,44,298,347,
Carter,U.S. Senate,Robert Murphy,LIB,100025,0,0,16,16,
Carter,U.S. Senate,Mike Workman,DEM,100025,0,11,50,61,
Carter,U.S. Senate,Mark Beard,IND,100025,0,1,3,4,
Carter,U.S. Senate,Sean Braddy,IND,100025,1,2,8,11,
Carter,U.S. House,Tom Cole,REP,100025,5,49,312,366,04
Carter,U.S. House,Sevier White,LIB,100025,0,1,17,18,04
Carter,U.S. House,Christina Owen,DEM,100025,1,10,44,55,04
Carter,State House,Tommy Hardin,REP,100025,4,40,290,334,49
Carter,State House,Michelle Bray,DEM,100025,1,17,80,98,49
Carter,President,Donald Trump,REP,100026,10,8,159,177,
Carter,President,Gary Johnson,LIB,100026,0,0,14,14,
Carter,President,Hillary Clinton,DEM,100026,7,6,60,73,
Carter,U.S. Senate,James Lankford,REP,100026,10,7,142,159,
Carter,U.S. Senate,Robert Murphy,LIB,100026,0,1,10,11,
Carter,U.S. Senate,Mike Workman,DEM,100026,6,6,63,75,
Carter,U.S. Senate,Mark Beard,IND,100026,0,0,4,4,
Carter,U.S. Senate,Sean Braddy,IND,100026,1,0,7,8,
Carter,U.S. House,Tom Cole,REP,100026,11,8,157,176,04
Carter,U.S. House,Sevier White,LIB,100026,0,1,12,13,04
Carter,U.S. House,Christina Owen,DEM,100026,6,5,61,72,04
Carter,President,Donald Trump,REP,100030,13,11,248,272,
Carter,President,Gary Johnson,LIB,100030,0,0,4,4,
Carter,President,Hillary Clinton,DEM,100030,0,1,27,28,
Carter,U.S. Senate,James Lankford,REP,100030,11,11,214,236,
Carter,U.S. Senate,Robert Murphy,LIB,100030,0,0,8,8,
Carter,U.S. Senate,Mike Workman,DEM,100030,0,1,41,42,
Carter,U.S. Senate,Mark Beard,IND,100030,1,0,4,5,
Carter,U.S. Senate,Sean Braddy,IND,100030,0,0,7,7,
Carter,U.S. House,Tom Cole,REP,100030,11,10,235,256,04
Carter,U.S. House,Sevier White,LIB,100030,1,0,6,7,04
Carter,U.S. House,Christina Owen,DEM,100030,0,2,35,37,04
Carter,State House,Tommy Hardin,REP,100030,12,11,232,255,49
Carter,State House,Michelle Bray,DEM,100030,0,1,42,43,49
Carter,President,Donald Trump,REP,100031,27,177,1043,1247,
Carter,President,Gary Johnson,LIB,100031,6,10,57,73,
Carter,President,Hillary Clinton,DEM,100031,9,47,159,215,
Carter,U.S. Senate,James Lankford,REP,100031,34,173,980,1187,
Carter,U.S. Senate,Robert Murphy,LIB,100031,1,7,33,41,
Carter,U.S. Senate,Mike Workman,DEM,100031,5,43,168,216,
Carter,U.S. Senate,Mark Beard,IND,100031,0,7,35,42,
Carter,U.S. Senate,Sean Braddy,IND,100031,2,2,36,40,
Carter,U.S. House,Tom Cole,REP,100031,31,186,1018,1235,04
Carter,U.S. House,Sevier White,LIB,100031,1,7,52,60,04
Carter,U.S. House,Christina Owen,DEM,100031,10,42,184,236,04
Carter,State House,Tommy Hardin,REP,100031,32,171,962,1165,49
Carter,State House,Michelle Bray,DEM,100031,10,63,284,357,49
Carter,President,Donald Trump,REP,100032,10,17,199,226,
Carter,President,Gary Johnson,LIB,100032,1,1,5,7,
Carter,President,Hillary Clinton,DEM,100032,0,10,70,80,
Carter,U.S. Senate,James Lankford,REP,100032,10,16,173,199,
Carter,U.S. Senate,Robert Murphy,LIB,100032,0,0,7,7,
Carter,U.S. Senate,Mike Workman,DEM,100032,0,10,81,91,
Carter,U.S. Senate,Mark Beard,IND,100032,0,1,2,3,
Carter,U.S. Senate,Sean Braddy,IND,100032,1,1,6,8,
Carter,U.S. House,Tom Cole,REP,100032,10,17,188,215,04
Carter,U.S. House,Sevier White,LIB,100032,0,0,8,8,04
Carter,U.S. House,Christina Owen,DEM,100032,1,11,74,86,04
Carter,President,Donald Trump,REP,100033,12,41,355,408,
Carter,President,Gary Johnson,LIB,100033,1,2,19,22,
Carter,President,Hillary Clinton,DEM,100033,4,7,52,63,
Carter,U.S. Senate,James Lankford,REP,100033,10,41,318,369,
Carter,U.S. Senate,Robert Murphy,LIB,100033,0,1,12,13,
Carter,U.S. Senate,Mike Workman,DEM,100033,5,6,60,71,
Carter,U.S. Senate,Mark Beard,IND,100033,1,1,19,21,
Carter,U.S. Senate,Sean Braddy,IND,100033,1,1,11,13,
Carter,U.S. House,Tom Cole,REP,100033,12,43,339,394,04
Carter,U.S. House,Sevier White,LIB,100033,1,1,15,17,04
Carter,U.S. House,Christina Owen,DEM,100033,5,6,70,81,04
Carter,President,Donald Trump,REP,100034,15,69,610,694,
Carter,President,Gary Johnson,LIB,100034,1,1,22,24,
Carter,President,Hillary Clinton,DEM,100034,4,24,96,124,
Carter,U.S. Senate,James Lankford,REP,100034,15,70,529,614,
Carter,U.S. Senate,Robert Murphy,LIB,100034,0,1,20,21,
Carter,U.S. Senate,Mike Workman,DEM,100034,4,18,129,151,
Carter,U.S. Senate,Mark Beard,IND,100034,0,2,24,26,
Carter,U.S. Senate,Sean Braddy,IND,100034,1,4,17,22,
Carter,U.S. House,Tom Cole,REP,100034,17,69,592,678,04
Carter,U.S. House,Sevier White,LIB,100034,0,2,25,27,04
Carter,U.S. House,Christina Owen,DEM,100034,3,23,113,139,04
Carter,State House,Tommy Hardin,REP,100034,16,65,550,631,49
Carter,State House,Michelle Bray,DEM,100034,4,29,171,204,49
Carter,President,Donald Trump,REP,100039,10,30,276,316,
Carter,President,Gary Johnson,LIB,100039,0,2,11,13,
Carter,President,Hillary Clinton,DEM,100039,5,5,31,41,
Carter,U.S. Senate,James Lankford,REP,100039,10,30,251,291,
Carter,U.S. Senate,Robert Murphy,LIB,100039,0,1,3,4,
Carter,U.S. Senate,Mike Workman,DEM,100039,5,4,40,49,
Carter,U.S. Senate,Mark Beard,IND,100039,0,1,9,10,
Carter,U.S. Senate,Sean Braddy,IND,100039,0,0,6,6,
Carter,U.S. House,Tom Cole,REP,100039,10,33,270,313,04
Carter,U.S. House,Sevier White,LIB,100039,0,0,7,7,04
Carter,U.S. House,Christina Owen,DEM,100039,5,3,35,43,04
Carter,President,Donald Trump,REP,100041,14,24,744,782,
Carter,President,Gary Johnson,LIB,100041,0,2,29,31,
Carter,President,Hillary Clinton,DEM,100041,4,3,103,110,
Carter,U.S. Senate,James Lankford,REP,100041,14,23,682,719,
Carter,U.S. Senate,Robert Murphy,LIB,100041,0,1,17,18,
Carter,U.S. Senate,Mike Workman,DEM,100041,3,4,127,134,
Carter,U.S. Senate,Mark Beard,IND,100041,1,1,23,25,
Carter,U.S. Senate,Sean Braddy,IND,100041,1,0,21,22,
Carter,U.S. House,Tom Cole,REP,100041,13,24,726,763,04
Carter,U.S. House,Sevier White,LIB,100041,1,0,30,31,04
Carter,U.S. House,Christina Owen,DEM,100041,5,5,116,126,04
Carter,President,Donald Trump,REP,100051,6,10,180,196,
Carter,President,Gary Johnson,LIB,100051,0,0,5,5,
Carter,President,Hillary Clinton,DEM,100051,2,6,97,105,
Carter,U.S. Senate,James Lankford,REP,100051,6,10,178,194,
Carter,U.S. Senate,Robert Murphy,LIB,100051,0,1,5,6,
Carter,U.S. Senate,Mike Workman,DEM,100051,2,5,78,85,
Carter,U.S. Senate,Mark Beard,IND,100051,0,0,7,7,
Carter,U.S. Senate,Sean Braddy,IND,100051,0,0,13,13,
Carter,U.S. House,Tom Cole,REP,100051,6,13,180,199,04
Carter,U.S. House,Sevier White,LIB,100051,0,0,6,6,04
Carter,U.S. House,Christina Owen,DEM,100051,2,3,96,101,04
Carter,President,Donald Trump,REP,100052,8,10,404,422,
Carter,President,Gary Johnson,LIB,100052,0,0,12,12,
Carter,President,Hillary Clinton,DEM,100052,2,0,54,56,
Carter,U.S. Senate,James Lankford,REP,100052,8,10,364,382,
Carter,U.S. Senate,Robert Murphy,LIB,100052,0,0,12,12,
Carter,U.S. Senate,Mike Workman,DEM,100052,2,0,71,73,
Carter,U.S. Senate,Mark Beard,IND,100052,0,0,10,10,
Carter,U.S. Senate,Sean Braddy,IND,100052,0,0,8,8,
Carter,U.S. House,Tom Cole,REP,100052,8,9,403,420,04
Carter,U.S. House,Sevier White,LIB,100052,0,0,11,11,04
Carter,U.S. House,Christina Owen,DEM,100052,2,1,55,58,04
Carter,President,Donald Trump,REP,100061,14,57,328,399,
Carter,President,Gary Johnson,LIB,100061,2,3,18,23,
Carter,President,Hillary Clinton,DEM,100061,2,9,47,58,
Carter,U.S. Senate,James Lankford,REP,100061,16,55,306,377,
Carter,U.S. Senate,Robert Murphy,LIB,100061,0,2,11,13,
Carter,U.S. Senate,Mike Workman,DEM,100061,2,9,50,61,
Carter,U.S. Senate,Mark Beard,IND,100061,0,1,8,9,
Carter,U.S. Senate,Sean Braddy,IND,100061,0,2,9,11,
Carter,U.S. House,Tom Cole,REP,100061,16,55,331,402,04
Carter,U.S. House,Sevier White,LIB,100061,0,3,11,14,04
Carter,U.S. House,Christina Owen,DEM,100061,2,11,47,60,04
Carter,State House,Tommy Hardin,REP,100061,16,53,301,370,49
Carter,State House,Michelle Bray,DEM,100061,2,14,83,99,49
Carter,President,Donald Trump,REP,100062,7,88,577,672,
Carter,President,Gary Johnson,LIB,100062,1,3,35,39,
Carter,President,Hillary Clinton,DEM,100062,5,24,132,161,
Carter,U.S. Senate,James Lankford,REP,100062,8,84,529,621,
Carter,U.S. Senate,Robert Murphy,LIB,100062,0,2,12,14,
Carter,U.S. Senate,Mike Workman,DEM,100062,4,24,153,181,
Carter,U.S. Senate,Mark Beard,IND,100062,0,1,18,19,
Carter,U.S. Senate,Sean Braddy,IND,100062,1,3,25,29,
Carter,U.S. House,Tom Cole,REP,100062,8,90,567,665,04
Carter,U.S. House,Sevier White,LIB,100062,0,0,23,23,04
Carter,U.S. House,Christina Owen,DEM,100062,4,24,152,180,04
Carter,State House,Tommy Hardin,REP,100062,6,83,532,621,49
Carter,State House,Michelle Bray,DEM,100062,5,31,205,241,49
Carter,President,Donald Trump,REP,100063,28,95,746,869,
Carter,President,Gary Johnson,LIB,100063,1,4,36,41,
Carter,President,Hillary Clinton,DEM,100063,5,21,117,143,
Carter,U.S. Senate,James Lankford,REP,100063,28,92,684,804,
Carter,U.S. Senate,Robert Murphy,LIB,100063,0,2,18,20,
Carter,U.S. Senate,Mike Workman,DEM,100063,3,21,151,175,
Carter,U.S. Senate,Mark Beard,IND,100063,1,1,23,25,
Carter,U.S. Senate,Sean Braddy,IND,100063,2,1,22,25,
Carter,U.S. House,Tom Cole,REP,100063,28,98,733,859,04
Carter,U.S. House,Sevier White,LIB,100063,0,1,27,28,04
Carter,U.S. House,Christina Owen,DEM,100063,6,18,140,164,04
Carter,State House,Tommy Hardin,REP,100063,28,98,688,814,49
Carter,State House,Michelle Bray,DEM,100063,6,19,211,236,49
Carter,President,Donald Trump,REP,100071,21,33,673,727,
Carter,President,Gary Johnson,LIB,100071,0,1,16,17,
Carter,President,Hillary Clinton,DEM,100071,1,1,90,92,
Carter,U.S. Senate,James Lankford,REP,100071,19,31,593,643,
Carter,U.S. Senate,Robert Murphy,LIB,100071,1,1,23,25,
Carter,U.S. Senate,Mike Workman,DEM,100071,2,2,107,111,
Carter,U.S. Senate,Mark Beard,IND,100071,0,0,24,24,
Carter,U.S. Senate,Sean Braddy,IND,100071,0,0,22,22,
Carter,U.S. House,Tom Cole,REP,100071,19,30,649,698,04
Carter,U.S. House,Sevier White,LIB,100071,2,2,20,24,04
Carter,U.S. House,Christina Owen,DEM,100071,1,2,102,105,04
Cherokee,President,Donald Trump,REP,110001,28,109,375,512,
Cherokee,President,Gary Johnson,LIB,110001,4,17,61,82,
Cherokee,President,Hillary Clinton,DEM,110001,24,102,336,462,
Cherokee,U.S. Senate,James Lankford,REP,110001,32,111,372,515,
Cherokee,U.S. Senate,Robert Murphy,LIB,110001,0,7,45,52,
Cherokee,U.S. Senate,Mike Workman,DEM,110001,17,96,280,393,
Cherokee,U.S. Senate,Mark Beard,IND,110001,1,5,30,36,
Cherokee,U.S. Senate,Sean Braddy,IND,110001,4,11,44,59,
Cherokee,U.S. House,Markwayne Mullin,REP,110001,28,108,389,525,02
Cherokee,U.S. House,Joshua Harris-Till,DEM,110001,23,105,319,447,02
Cherokee,U.S. House,John Mccarthy,IND,110001,3,15,70,88,02
Cherokee,State Senate,Dewayne Pemberton,REP,110001,18,88,311,417,9
Cherokee,State Senate,Jack Reavis,DEM,110001,36,142,460,638,9
Cherokee,State House,Bob Ed Culver,REP,110001,30,96,318,444,4
Cherokee,State House,Matt Meredith,DEM,110001,25,135,452,612,4
Cherokee,President,Donald Trump,REP,110002,48,362,545,955,
Cherokee,President,Gary Johnson,LIB,110002,3,30,67,100,
Cherokee,President,Hillary Clinton,DEM,110002,39,290,302,631,
Cherokee,U.S. Senate,James Lankford,REP,110002,51,396,539,986,
Cherokee,U.S. Senate,Robert Murphy,LIB,110002,0,16,32,48,
Cherokee,U.S. Senate,Mike Workman,DEM,110002,35,249,287,571,
Cherokee,U.S. Senate,Mark Beard,IND,110002,1,7,27,35,
Cherokee,U.S. Senate,Sean Braddy,IND,110002,3,10,18,31,
Cherokee,U.S. House,Markwayne Mullin,REP,110002,52,389,558,999,02
Cherokee,U.S. House,Joshua Harris-Till,DEM,110002,37,267,280,584,02
Cherokee,U.S. House,John Mccarthy,IND,110002,2,28,67,97,02
Cherokee,State Senate,Dewayne Pemberton,REP,110002,40,288,430,758,9
Cherokee,State Senate,Jack Reavis,DEM,110002,50,386,467,903,9
Cherokee,State House,Bob Ed Culver,REP,110002,44,303,434,781,4
Cherokee,State House,Matt Meredith,DEM,110002,47,377,467,891,4
Cherokee,President,Donald Trump,REP,110003,36,247,519,802,
Cherokee,President,Gary Johnson,LIB,110003,2,34,63,99,
Cherokee,President,Hillary Clinton,DEM,110003,31,242,257,530,
Cherokee,U.S. Senate,James Lankford,REP,110003,39,270,507,816,
Cherokee,U.S. Senate,Robert Murphy,LIB,110003,0,12,33,45,
Cherokee,U.S. Senate,Mike Workman,DEM,110003,25,226,251,502,
Cherokee,U.S. Senate,Mark Beard,IND,110003,1,10,14,25,
Cherokee,U.S. Senate,Sean Braddy,IND,110003,4,6,35,45,
Cherokee,U.S. House,Markwayne Mullin,REP,110003,37,273,532,842,02
Cherokee,U.S. House,Joshua Harris-Till,DEM,110003,28,222,249,499,02
Cherokee,U.S. House,John Mccarthy,IND,110003,4,28,57,89,02
Cherokee,State Senate,Dewayne Pemberton,REP,110003,32,199,421,652,9
Cherokee,State Senate,Jack Reavis,DEM,110003,37,325,411,773,9
Cherokee,State House,Bob Ed Culver,REP,110003,40,220,449,709,4
Cherokee,State House,Matt Meredith,DEM,110003,30,307,383,720,4
Cherokee,President,Donald Trump,REP,110004,24,237,430,691,
Cherokee,President,Gary Johnson,LIB,110004,7,23,93,123,
Cherokee,President,Hillary Clinton,DEM,110004,25,203,381,609,
Cherokee,U.S. Senate,James Lankford,REP,110004,32,252,435,719,
Cherokee,U.S. Senate,Robert Murphy,LIB,110004,1,26,48,75,
Cherokee,U.S. Senate,Mike Workman,DEM,110004,21,178,347,546,
Cherokee,U.S. Senate,Mark Beard,IND,110004,0,3,37,40,
Cherokee,U.S. Senate,Sean Braddy,IND,110004,1,13,36,50,
Cherokee,U.S. House,Markwayne Mullin,REP,110004,34,248,449,731,02
Cherokee,U.S. House,Joshua Harris-Till,DEM,110004,19,199,378,596,02
Cherokee,U.S. House,John Mccarthy,IND,110004,3,25,77,105,02
Cherokee,State Senate,Dewayne Pemberton,REP,110004,29,199,347,575,9
Cherokee,State Senate,Jack Reavis,DEM,110004,27,268,550,845,9
Cherokee,State House,Bob Ed Culver,REP,110004,33,225,383,641,4
Cherokee,State House,Matt Meredith,DEM,110004,24,247,521,792,4
Cherokee,President,Donald Trump,REP,110005,7,23,103,133,
Cherokee,President,Gary Johnson,LIB,110005,0,3,29,32,
Cherokee,President,Hillary Clinton,DEM,110005,11,29,88,128,
Cherokee,U.S. Senate,James Lankford,REP,110005,7,25,104,136,
Cherokee,U.S. Senate,Robert Murphy,LIB,110005,0,3,16,19,
Cherokee,U.S. Senate,Mike Workman,DEM,110005,10,26,85,121,
Cherokee,U.S. Senate,Mark Beard,IND,110005,1,1,6,8,
Cherokee,U.S. Senate,Sean Braddy,IND,110005,0,0,10,10,
Cherokee,U.S. House,Markwayne Mullin,REP,110005,6,25,104,135,02
Cherokee,U.S. House,Joshua Harris-Till,DEM,110005,11,26,93,130,02
Cherokee,U.S. House,John Mccarthy,IND,110005,1,5,20,26,02
Cherokee,State Senate,Dewayne Pemberton,REP,110005,4,23,75,102,9
Cherokee,State Senate,Jack Reavis,DEM,110005,14,32,142,188,9
Cherokee,State House,Bob Ed Culver,REP,110005,6,23,92,121,4
Cherokee,State House,Matt Meredith,DEM,110005,12,32,125,169,4
Cherokee,President,Donald Trump,REP,110006,17,78,217,312,
Cherokee,President,Gary Johnson,LIB,110006,0,6,13,19,
Cherokee,President,Hillary Clinton,DEM,110006,7,45,80,132,
Cherokee,U.S. Senate,James Lankford,REP,110006,16,84,223,323,
Cherokee,U.S. Senate,Robert Murphy,LIB,110006,1,2,5,8,
Cherokee,U.S. Senate,Mike Workman,DEM,110006,7,40,69,116,
Cherokee,U.S. Senate,Mark Beard,IND,110006,0,0,7,7,
Cherokee,U.S. Senate,Sean Braddy,IND,110006,0,0,7,7,
Cherokee,U.S. House,Markwayne Mullin,REP,110006,17,72,225,314,02
Cherokee,U.S. House,Joshua Harris-Till,DEM,110006,6,54,72,132,02
Cherokee,U.S. House,John Mccarthy,IND,110006,1,1,15,17,02
Cherokee,State Senate,Wayne Shaw,REP,110006,16,59,175,250,3
Cherokee,State Senate,Rhonda Cox,DEM,110006,7,67,131,205,3
Cherokee,State House,Bob Ed Culver,REP,110006,15,71,165,251,4
Cherokee,State House,Matt Meredith,DEM,110006,8,55,146,209,4
Cherokee,President,Donald Trump,REP,110007,6,16,42,64,
Cherokee,President,Gary Johnson,LIB,110007,1,0,5,6,
Cherokee,President,Hillary Clinton,DEM,110007,2,9,21,32,
Cherokee,U.S. Senate,James Lankford,REP,110007,7,17,49,73,
Cherokee,U.S. Senate,Robert Murphy,LIB,110007,0,0,2,2,
Cherokee,U.S. Senate,Mike Workman,DEM,110007,2,9,15,26,
Cherokee,U.S. Senate,Mark Beard,IND,110007,0,1,1,2,
Cherokee,U.S. Senate,Sean Braddy,IND,110007,0,0,1,1,
Cherokee,U.S. House,Markwayne Mullin,REP,110007,7,19,49,75,02
Cherokee,U.S. House,Joshua Harris-Till,DEM,110007,2,7,16,25,02
Cherokee,U.S. House,John Mccarthy,IND,110007,0,1,3,4,02
Cherokee,State Senate,Wayne Shaw,REP,110007,4,16,34,54,3
Cherokee,State Senate,Rhonda Cox,DEM,110007,5,11,33,49,3
Cherokee,State House,Bob Ed Culver,REP,110007,6,12,34,52,4
Cherokee,State House,Matt Meredith,DEM,110007,2,15,34,51,4
Cherokee,President,Donald Trump,REP,110008,4,38,163,205,
Cherokee,President,Gary Johnson,LIB,110008,1,5,15,21,
Cherokee,President,Hillary Clinton,DEM,110008,15,35,94,144,
Cherokee,U.S. Senate,James Lankford,REP,110008,6,40,146,192,
Cherokee,U.S. Senate,Robert Murphy,LIB,110008,0,2,11,13,
Cherokee,U.S. Senate,Mike Workman,DEM,110008,11,32,95,138,
Cherokee,U.S. Senate,Mark Beard,IND,110008,0,2,11,13,
Cherokee,U.S. Senate,Sean Braddy,IND,110008,1,4,12,17,
Cherokee,U.S. House,Markwayne Mullin,REP,110008,6,40,147,193,02
Cherokee,U.S. House,Joshua Harris-Till,DEM,110008,12,34,100,146,02
Cherokee,U.S. House,John Mccarthy,IND,110008,1,4,26,31,02
Cherokee,State Senate,Wayne Shaw,REP,110008,6,35,111,152,3
Cherokee,State Senate,Rhonda Cox,DEM,110008,12,43,156,211,3
Cherokee,State House,Rhonda Hopkins,REP,110008,3,29,97,129,86
Cherokee,State House,Shannon Grimes,LIB,110008,0,4,24,28,86
Cherokee,State House,Will Fourkiller,DEM,110008,15,46,150,211,86
Cherokee,President,Donald Trump,REP,110009,25,61,432,518,
Cherokee,President,Gary Johnson,LIB,110009,1,0,24,25,
Cherokee,President,Hillary Clinton,DEM,110009,12,28,158,198,
Cherokee,U.S. Senate,James Lankford,REP,110009,27,57,421,505,
Cherokee,U.S. Senate,Robert Murphy,LIB,110009,0,2,14,16,
Cherokee,U.S. Senate,Mike Workman,DEM,110009,10,27,158,195,
Cherokee,U.S. Senate,Mark Beard,IND,110009,0,1,8,9,
Cherokee,U.S. Senate,Sean Braddy,IND,110009,1,2,16,19,
Cherokee,U.S. House,Markwayne Mullin,REP,110009,26,59,440,525,02
Cherokee,U.S. House,Joshua Harris-Till,DEM,110009,11,29,153,193,02
Cherokee,U.S. House,John Mccarthy,IND,110009,1,1,25,27,02
Cherokee,State Senate,Wayne Shaw,REP,110009,26,55,381,462,3
Cherokee,State Senate,Rhonda Cox,DEM,110009,12,34,235,281,3
Cherokee,State House,Bob Ed Culver,REP,110009,26,52,358,436,4
Cherokee,State House,Matt Meredith,DEM,110009,12,37,250,299,4
Cherokee,President,Donald Trump,REP,110010,33,158,659,850,
Cherokee,President,Gary Johnson,LIB,110010,4,11,54,69,
Cherokee,President,Hillary Clinton,DEM,110010,9,90,267,366,
Cherokee,U.S. Senate,James Lankford,REP,110010,30,159,638,827,
Cherokee,U.S. Senate,Robert Murphy,LIB,110010,3,9,20,32,
Cherokee,U.S. Senate,Mike Workman,DEM,110010,12,82,288,382,
Cherokee,U.S. Senate,Mark Beard,IND,110010,0,3,15,18,
Cherokee,U.S. Senate,Sean Braddy,IND,110010,0,4,13,17,
Cherokee,U.S. House,Markwayne Mullin,REP,110010,30,163,656,849,02
Cherokee,U.S. House,Joshua Harris-Till,DEM,110010,13,87,274,374,02
Cherokee,U.S. House,John Mccarthy,IND,110010,2,8,46,56,02
Cherokee,State Senate,Dewayne Pemberton,REP,110010,28,122,487,637,9
Cherokee,State Senate,Jack Reavis,DEM,110010,16,133,480,629,9
Cherokee,State House,Bob Ed Culver,REP,110010,30,134,530,694,4
Cherokee,State House,Matt Meredith,DEM,110010,14,124,445,583,4
Cherokee,President,Donald Trump,REP,110011,6,44,204,254,
Cherokee,President,Gary Johnson,LIB,110011,2,2,20,24,
Cherokee,President,Hillary Clinton,DEM,110011,10,20,84,114,
Cherokee,U.S. Senate,James Lankford,REP,110011,7,45,204,256,
Cherokee,U.S. Senate,Robert Murphy,LIB,110011,1,0,7,8,
Cherokee,U.S. Senate,Mike Workman,DEM,110011,8,20,86,114,
Cherokee,U.S. Senate,Mark Beard,IND,110011,2,0,3,5,
Cherokee,U.S. Senate,Sean Braddy,IND,110011,0,0,7,7,
Cherokee,U.S. House,Markwayne Mullin,REP,110011,8,45,217,270,02
Cherokee,U.S. House,Joshua Harris-Till,DEM,110011,9,19,73,101,02
Cherokee,U.S. House,John Mccarthy,IND,110011,1,1,16,18,02
Cherokee,State House,Bob Ed Culver,REP,110011,9,37,180,226,4
Cherokee,State House,Matt Meredith,DEM,110011,9,28,127,164,4
Cherokee,President,Donald Trump,REP,110012,25,121,452,598,
Cherokee,President,Gary Johnson,LIB,110012,2,21,45,68,
Cherokee,President,Hillary Clinton,DEM,110012,8,64,175,247,
Cherokee,U.S. Senate,James Lankford,REP,110012,26,127,429,582,
Cherokee,U.S. Senate,Robert Murphy,LIB,110012,0,7,29,36,
Cherokee,U.S. Senate,Mike Workman,DEM,110012,8,64,184,256,
Cherokee,U.S. Senate,Mark Beard,IND,110012,0,3,15,18,
Cherokee,U.S. Senate,Sean Braddy,IND,110012,0,3,14,17,
Cherokee,U.S. House,Markwayne Mullin,REP,110012,25,127,445,597,02
Cherokee,U.S. House,Joshua Harris-Till,DEM,110012,7,67,188,262,02
Cherokee,U.S. House,John Mccarthy,IND,110012,1,13,38,52,02
Cherokee,State Senate,Wayne Shaw,REP,110012,16,100,348,464,3
Cherokee,State Senate,Rhonda Cox,DEM,110012,16,103,319,438,3
Cherokee,State House,Rhonda Hopkins,REP,110012,14,73,257,344,86
Cherokee,State House,Shannon Grimes,LIB,110012,1,14,55,70,86
Cherokee,State House,Will Fourkiller,DEM,110012,18,116,357,491,86
Cherokee,President,Donald Trump,REP,110013,18,71,275,364,
Cherokee,President,Gary Johnson,LIB,110013,2,5,28,35,
Cherokee,President,Hillary Clinton,DEM,110013,16,41,134,191,
Cherokee,U.S. Senate,James Lankford,REP,110013,16,73,244,333,
Cherokee,U.S. Senate,Robert Murphy,LIB,110013,1,2,11,14,
Cherokee,U.S. Senate,Mike Workman,DEM,110013,14,42,167,223,
Cherokee,U.S. Senate,Mark Beard,IND,110013,1,0,8,9,
Cherokee,U.S. Senate,Sean Braddy,IND,110013,1,0,6,7,
Cherokee,U.S. House,Markwayne Mullin,REP,110013,17,70,256,343,02
Cherokee,U.S. House,Joshua Harris-Till,DEM,110013,14,40,150,204,02
Cherokee,U.S. House,John Mccarthy,IND,110013,2,6,34,42,02
Cherokee,State Senate,Wayne Shaw,REP,110013,16,54,201,271,3
Cherokee,State Senate,Rhonda Cox,DEM,110013,18,62,235,315,3
Cherokee,State House,Bob Ed Culver,REP,110013,20,55,195,270,4
Cherokee,State House,Matt Meredith,DEM,110013,14,62,241,317,4
Cherokee,President,Donald Trump,REP,110014,46,33,433,512,
Cherokee,President,Gary Johnson,LIB,110014,1,3,37,41,
Cherokee,President,Hillary Clinton,DEM,110014,14,26,220,260,
Cherokee,U.S. Senate,James Lankford,REP,110014,44,30,414,488,
Cherokee,U.S. Senate,Robert Murphy,LIB,110014,0,1,19,20,
Cherokee,U.S. Senate,Mike Workman,DEM,110014,12,29,222,263,
Cherokee,U.S. Senate,Mark Beard,IND,110014,0,1,16,17,
Cherokee,U.S. Senate,Sean Braddy,IND,110014,3,0,13,16,
Cherokee,U.S. House,Markwayne Mullin,REP,110014,45,28,440,513,02
Cherokee,U.S. House,Joshua Harris-Till,DEM,110014,13,31,213,257,02
Cherokee,U.S. House,John Mccarthy,IND,110014,1,3,34,38,02
Cherokee,State House,George Faught,REP,110014,47,35,427,509,14
Cherokee,State House,Lee Ann Langston,DEM,110014,14,27,259,300,14
Cherokee,President,Donald Trump,REP,110015,33,62,645,740,
Cherokee,President,Gary Johnson,LIB,110015,1,2,28,31,
Cherokee,President,Hillary Clinton,DEM,110015,13,33,171,217,
Cherokee,U.S. Senate,James Lankford,REP,110015,33,68,610,711,
Cherokee,U.S. Senate,Robert Murphy,LIB,110015,0,0,23,23,
Cherokee,U.S. Senate,Mike Workman,DEM,110015,12,31,178,221,
Cherokee,U.S. Senate,Mark Beard,IND,110015,0,1,7,8,
Cherokee,U.S. Senate,Sean Braddy,IND,110015,3,1,22,26,
Cherokee,U.S. House,Markwayne Mullin,REP,110015,32,66,629,727,02
Cherokee,U.S. House,Joshua Harris-Till,DEM,110015,14,30,167,211,02
Cherokee,U.S. House,John Mccarthy,IND,110015,2,5,47,54,02
Cherokee,State House,George Faught,REP,110015,34,60,614,708,14
Cherokee,State House,Lee Ann Langston,DEM,110015,14,38,225,277,14
Cherokee,President,Donald Trump,REP,110016,5,18,199,222,
Cherokee,President,Gary Johnson,LIB,110016,0,3,16,19,
Cherokee,President,Hillary Clinton,DEM,110016,2,12,82,96,
Cherokee,U.S. Senate,James Lankford,REP,110016,5,22,182,209,
Cherokee,U.S. Senate,Robert Murphy,LIB,110016,0,1,10,11,
Cherokee,U.S. Senate,Mike Workman,DEM,110016,2,6,88,96,
Cherokee,U.S. Senate,Mark Beard,IND,110016,0,2,6,8,
Cherokee,U.S. Senate,Sean Braddy,IND,110016,0,1,2,3,
Cherokee,U.S. House,Markwayne Mullin,REP,110016,5,22,186,213,02
Cherokee,U.S. House,Joshua Harris-Till,DEM,110016,2,7,91,100,02
Cherokee,U.S. House,John Mccarthy,IND,110016,0,3,14,17,02
Cherokee,State Senate,Wayne Shaw,REP,110016,4,12,131,147,3
Cherokee,State Senate,Rhonda Cox,DEM,110016,3,21,160,184,3
Cherokee,State House,Rhonda Hopkins,REP,110016,4,13,97,114,86
Cherokee,State House,Shannon Grimes,LIB,110016,0,8,55,63,86
Cherokee,State House,Will Fourkiller,DEM,110016,3,11,140,154,86
Cherokee,President,Donald Trump,REP,110017,3,28,170,201,
Cherokee,President,Gary Johnson,LIB,110017,1,1,23,25,
Cherokee,President,Hillary Clinton,DEM,110017,3,17,69,89,
Cherokee,U.S. Senate,James Lankford,REP,110017,4,29,162,195,
Cherokee,U.S. Senate,Robert Murphy,LIB,110017,1,1,8,10,
Cherokee,U.S. Senate,Mike Workman,DEM,110017,2,17,79,98,
Cherokee,U.S. Senate,Mark Beard,IND,110017,0,1,6,7,
Cherokee,U.S. Senate,Sean Braddy,IND,110017,0,0,7,7,
Cherokee,U.S. House,Markwayne Mullin,REP,110017,4,28,175,207,02
Cherokee,U.S. House,Joshua Harris-Till,DEM,110017,3,18,68,89,02
Cherokee,U.S. House,John Mccarthy,IND,110017,0,3,21,24,02
Cherokee,State Senate,Dewayne Pemberton,REP,110017,2,21,129,152,9
Cherokee,State Senate,Jack Reavis,DEM,110017,5,27,133,165,9
Cherokee,State House,Bob Ed Culver,REP,110017,2,17,125,144,4
Cherokee,State House,Matt Meredith,DEM,110017,5,29,135,169,4
Cherokee,President,Donald Trump,REP,110018,6,36,142,184,
Cherokee,President,Gary Johnson,LIB,110018,0,0,11,11,
Cherokee,President,Hillary Clinton,DEM,110018,3,3,55,61,
Cherokee,U.S. Senate,James Lankford,REP,110018,6,36,133,175,
Cherokee,U.S. Senate,Robert Murphy,LIB,110018,0,0,11,11,
Cherokee,U.S. Senate,Mike Workman,DEM,110018,3,3,54,60,
Cherokee,U.S. Senate,Mark Beard,IND,110018,0,0,6,6,
Cherokee,U.S. Senate,Sean Braddy,IND,110018,0,0,3,3,
Cherokee,U.S. House,Markwayne Mullin,REP,110018,7,38,126,171,02
Cherokee,U.S. House,Joshua Harris-Till,DEM,110018,2,1,55,58,02
Cherokee,U.S. House,John Mccarthy,IND,110018,0,0,25,25,02
Cherokee,State Senate,Wayne Shaw,REP,110018,6,28,109,143,3
Cherokee,State Senate,Rhonda Cox,DEM,110018,3,11,99,113,3
Cherokee,State House,Rhonda Hopkins,REP,110018,4,27,76,107,86
Cherokee,State House,Shannon Grimes,LIB,110018,0,3,20,23,86
Cherokee,State House,Will Fourkiller,DEM,110018,5,9,111,125,86
Cherokee,President,Donald Trump,REP,110019,14,75,328,417,
Cherokee,President,Gary Johnson,LIB,110019,0,1,31,32,
Cherokee,President,Hillary Clinton,DEM,110019,7,41,141,189,
Cherokee,U.S. Senate,James Lankford,REP,110019,15,71,320,406,
Cherokee,U.S. Senate,Robert Murphy,LIB,110019,0,2,17,19,
Cherokee,U.S. Senate,Mike Workman,DEM,110019,5,40,154,199,
Cherokee,U.S. Senate,Mark Beard,IND,110019,1,2,7,10,
Cherokee,U.S. Senate,Sean Braddy,IND,110019,0,1,8,9,
Cherokee,U.S. House,Markwayne Mullin,REP,110019,15,75,318,408,02
Cherokee,U.S. House,Joshua Harris-Till,DEM,110019,6,39,145,190,02
Cherokee,U.S. House,John Mccarthy,IND,110019,0,4,43,47,02
Cherokee,State House,Bob Ed Culver,REP,110019,15,63,240,318,4
Cherokee,State House,Matt Meredith,DEM,110019,6,55,264,325,4
Cherokee,President,Donald Trump,REP,110020,25,127,359,511,
Cherokee,President,Gary Johnson,LIB,110020,3,15,53,71,
Cherokee,President,Hillary Clinton,DEM,110020,8,133,198,339,
Cherokee,U.S. Senate,James Lankford,REP,110020,24,130,356,510,
Cherokee,U.S. Senate,Robert Murphy,LIB,110020,3,5,31,39,
Cherokee,U.S. Senate,Mike Workman,DEM,110020,7,124,178,309,
Cherokee,U.S. Senate,Mark Beard,IND,110020,2,5,19,26,
Cherokee,U.S. Senate,Sean Braddy,IND,110020,0,5,16,21,
Cherokee,U.S. House,Markwayne Mullin,REP,110020,26,141,387,554,02
Cherokee,U.S. House,Joshua Harris-Till,DEM,110020,7,121,169,297,02
Cherokee,U.S. House,John Mccarthy,IND,110020,3,8,45,56,02
Cherokee,State Senate,Dewayne Pemberton,REP,110020,25,95,296,416,9
Cherokee,State Senate,Jack Reavis,DEM,110020,11,171,298,480,9
Cherokee,State House,Bob Ed Culver,REP,110020,26,101,289,416,4
Cherokee,State House,Matt Meredith,DEM,110020,10,168,309,487,4
Cherokee,President,Donald Trump,REP,110021,9,19,212,240,
Cherokee,President,Gary Johnson,LIB,110021,0,0,23,23,
Cherokee,President,Hillary Clinton,DEM,110021,3,9,68,80,
Cherokee,U.S. Senate,James Lankford,REP,110021,8,22,214,244,
Cherokee,U.S. Senate,Robert Murphy,LIB,110021,0,1,6,7,
Cherokee,U.S. Senate,Mike Workman,DEM,110021,4,5,73,82,
Cherokee,U.S. Senate,Mark Beard,IND,110021,0,0,3,3,
Cherokee,U.S. Senate,Sean Braddy,IND,110021,0,0,10,10,
Cherokee,U.S. House,Markwayne Mullin,REP,110021,9,22,226,257,02
Cherokee,U.S. House,Joshua Harris-Till,DEM,110021,3,5,60,68,02
Cherokee,U.S. House,John Mccarthy,IND,110021,0,1,23,24,02
Cherokee,State Senate,Wayne Shaw,REP,110021,9,16,163,188,3
Cherokee,State Senate,Rhonda Cox,DEM,110021,2,12,143,157,3
Cherokee,State House,Bob Ed Culver,REP,110021,7,13,169,189,4
Cherokee,State House,Matt Meredith,DEM,110021,4,13,135,152,4
Cherokee,President,Donald Trump,REP,110022,1,20,142,163,
Cherokee,President,Gary Johnson,LIB,110022,0,1,12,13,
Cherokee,President,Hillary Clinton,DEM,110022,2,10,52,64,
Cherokee,U.S. Senate,James Lankford,REP,110022,1,16,131,148,
Cherokee,U.S. Senate,Robert Murphy,LIB,110022,0,2,4,6,
Cherokee,U.S. Senate,Mike Workman,DEM,110022,2,9,58,69,
Cherokee,U.S. Senate,Mark Beard,IND,110022,0,0,5,5,
Cherokee,U.S. Senate,Sean Braddy,IND,110022,0,1,5,6,
Cherokee,U.S. House,Markwayne Mullin,REP,110022,1,20,140,161,02
Cherokee,U.S. House,Joshua Harris-Till,DEM,110022,2,9,50,61,02
Cherokee,U.S. House,John Mccarthy,IND,110022,0,2,13,15,02
Cherokee,State Senate,Wayne Shaw,REP,110022,1,15,104,120,3
Cherokee,State Senate,Rhonda Cox,DEM,110022,2,16,98,116,3
Cherokee,State House,Bob Ed Culver,REP,110022,1,16,96,113,4
Cherokee,State House,Matt Meredith,DEM,110022,2,15,108,125,4
Cherokee,President,Donald Trump,REP,110023,9,27,136,172,
Cherokee,President,Gary Johnson,LIB,110023,1,8,11,20,
Cherokee,President,Hillary Clinton,DEM,110023,1,22,39,62,
Cherokee,U.S. Senate,James Lankford,REP,110023,7,33,137,177,
Cherokee,U.S. Senate,Robert Murphy,LIB,110023,1,4,5,10,
Cherokee,U.S. Senate,Mike Workman,DEM,110023,2,20,38,60,
Cherokee,U.S. Senate,Mark Beard,IND,110023,0,0,2,2,
Cherokee,U.S. Senate,Sean Braddy,IND,110023,0,0,0,0,
Cherokee,U.S. House,Markwayne Mullin,REP,110023,9,34,139,182,02
Cherokee,U.S. House,Joshua Harris-Till,DEM,110023,0,19,38,57,02
Cherokee,U.S. House,John Mccarthy,IND,110023,1,4,9,14,02
Cherokee,State Senate,Wayne Shaw,REP,110023,6,26,91,123,3
Cherokee,State Senate,Rhonda Cox,DEM,110023,4,30,92,126,3
Cherokee,State House,Bob Ed Culver,REP,110023,10,24,107,141,4
Cherokee,State House,Matt Meredith,DEM,110023,0,33,75,108,4
Cherokee,President,Donald Trump,REP,110025,17,87,270,374,
Cherokee,President,Gary Johnson,LIB,110025,1,16,34,51,
Cherokee,President,Hillary Clinton,DEM,110025,5,61,149,215,
Cherokee,U.S. Senate,James Lankford,REP,110025,16,93,263,372,
Cherokee,U.S. Senate,Robert Murphy,LIB,110025,1,1,18,20,
Cherokee,U.S. Senate,Mike Workman,DEM,110025,6,65,156,227,
Cherokee,U.S. Senate,Mark Beard,IND,110025,0,2,12,14,
Cherokee,U.S. Senate,Sean Braddy,IND,110025,1,3,4,8,
Cherokee,U.S. House,Markwayne Mullin,REP,110025,16,90,290,396,02
Cherokee,U.S. House,Joshua Harris-Till,DEM,110025,8,68,142,218,02
Cherokee,U.S. House,John Mccarthy,IND,110025,0,6,23,29,02
Cherokee,State House,Bob Ed Culver,REP,110025,12,82,177,271,4
Cherokee,State House,Matt Meredith,DEM,110025,12,82,276,370,4
Choctaw,President,Donald Trump,REP,120101,9,21,471,501,
Choctaw,President,Gary Johnson,LIB,120101,2,0,14,16,
Choctaw,President,Hillary Clinton,DEM,120101,5,6,108,119,
Choctaw,U.S. Senate,James Lankford,REP,120101,8,20,427,455,
Choctaw,U.S. Senate,Robert Murphy,LIB,120101,0,0,14,14,
Choctaw,U.S. Senate,Mike Workman,DEM,120101,7,7,130,144,
Choctaw,U.S. Senate,Mark Beard,IND,120101,0,0,9,9,
Choctaw,U.S. Senate,Sean Braddy,IND,120101,0,0,13,13,
Choctaw,U.S. House,Markwayne Mullin,REP,120101,7,20,420,447,02
Choctaw,U.S. House,Joshua Harris-Till,DEM,120101,7,6,128,141,02
Choctaw,U.S. House,John Mccarthy,IND,120101,1,0,43,44,02
Choctaw,State Senate,Joseph Silk,REP,120101,7,17,397,421,5
Choctaw,State Senate,Stacey Allen Ebert,DEM,120101,8,9,193,210,5
Choctaw,State House,Justin Humphrey,REP,120101,9,18,331,358,19
Choctaw,State House,James Albert Campbell,DEM,120101,6,8,226,240,19
Choctaw,State House,Morgan Hopson,IND,120101,0,1,35,36,19
Choctaw,President,Donald Trump,REP,120104,17,81,417,515,
Choctaw,President,Gary Johnson,LIB,120104,0,4,11,15,
Choctaw,President,Hillary Clinton,DEM,120104,0,9,67,76,
Choctaw,U.S. Senate,James Lankford,REP,120104,13,64,339,416,
Choctaw,U.S. Senate,Robert Murphy,LIB,120104,1,3,12,16,
Choctaw,U.S. Senate,Mike Workman,DEM,120104,1,16,104,121,
Choctaw,U.S. Senate,Mark Beard,IND,120104,2,5,11,18,
Choctaw,U.S. Senate,Sean Braddy,IND,120104,0,4,7,11,
Choctaw,U.S. House,Markwayne Mullin,REP,120104,15,68,360,443,02
Choctaw,U.S. House,Joshua Harris-Till,DEM,120104,0,14,85,99,02
Choctaw,U.S. House,John Mccarthy,IND,120104,2,11,33,46,02
Choctaw,State Senate,Joseph Silk,REP,120104,16,62,293,371,5
Choctaw,State Senate,Stacey Allen Ebert,DEM,120104,1,30,192,223,5
Choctaw,State House,Justin Humphrey,REP,120104,14,50,233,297,19
Choctaw,State House,James Albert Campbell,DEM,120104,1,33,202,236,19
Choctaw,State House,Morgan Hopson,IND,120104,2,9,46,57,19
Choctaw,President,Donald Trump,REP,120105,0,15,59,74,
Choctaw,President,Gary Johnson,LIB,120105,0,0,9,9,
Choctaw,President,Hillary Clinton,DEM,120105,0,18,102,120,
Choctaw,U.S. Senate,James Lankford,REP,120105,0,13,54,67,
Choctaw,U.S. Senate,Robert Murphy,LIB,120105,0,0,7,7,
Choctaw,U.S. Senate,Mike Workman,DEM,120105,0,19,98,117,
Choctaw,U.S. Senate,Mark Beard,IND,120105,0,0,4,4,
Choctaw,U.S. Senate,Sean Braddy,IND,120105,0,0,1,1,
Choctaw,U.S. House,Markwayne Mullin,REP,120105,0,13,57,70,02
Choctaw,U.S. House,Joshua Harris-Till,DEM,120105,0,19,94,113,02
Choctaw,U.S. House,John Mccarthy,IND,120105,0,0,13,13,02
Choctaw,State Senate,Joseph Silk,REP,120105,0,11,45,56,5
Choctaw,State Senate,Stacey Allen Ebert,DEM,120105,0,22,121,143,5
Choctaw,State House,Justin Humphrey,REP,120105,0,5,34,39,19
Choctaw,State House,James Albert Campbell,DEM,120105,0,25,122,147,19
Choctaw,State House,Morgan Hopson,IND,120105,0,3,12,15,19
Choctaw,President,Donald Trump,REP,120106,9,49,181,239,
Choctaw,President,Gary Johnson,LIB,120106,0,5,12,17,
Choctaw,President,Hillary Clinton,DEM,120106,3,9,35,47,
Choctaw,U.S. Senate,James Lankford,REP,120106,8,44,168,220,
Choctaw,U.S. Senate,Robert Murphy,LIB,120106,0,1,6,7,
Choctaw,U.S. Senate,Mike Workman,DEM,120106,4,12,41,57,
Choctaw,U.S. Senate,Mark Beard,IND,120106,0,2,5,7,
Choctaw,U.S. Senate,Sean Braddy,IND,120106,0,3,5,8,
Choctaw,U.S. House,Markwayne Mullin,REP,120106,8,41,166,215,02
Choctaw,U.S. House,Joshua Harris-Till,DEM,120106,4,15,35,54,02
Choctaw,U.S. House,John Mccarthy,IND,120106,0,6,24,30,02
Choctaw,State Senate,Joseph Silk,REP,120106,8,40,158,206,5
Choctaw,State Senate,Stacey Allen Ebert,DEM,120106,4,23,69,96,5
Choctaw,State House,Justin Humphrey,REP,120106,4,34,113,151,19
Choctaw,State House,James Albert Campbell,DEM,120106,8,27,97,132,19
Choctaw,State House,Morgan Hopson,IND,120106,0,1,16,17,19
Choctaw,President,Donald Trump,REP,120207,1,8,69,78,
Choctaw,President,Gary Johnson,LIB,120207,0,0,1,1,
Choctaw,President,Hillary Clinton,DEM,120207,2,1,23,26,
Choctaw,U.S. Senate,James Lankford,REP,120207,1,8,63,72,
Choctaw,U.S. Senate,Robert Murphy,LIB,120207,0,0,0,0,
Choctaw,U.S. Senate,Mike Workman,DEM,120207,2,1,22,25,
Choctaw,U.S. Senate,Mark Beard,IND,120207,0,1,5,6,
Choctaw,U.S. Senate,Sean Braddy,IND,120207,0,0,2,2,
Choctaw,U.S. House,Markwayne Mullin,REP,120207,1,7,67,75,02
Choctaw,U.S. House,Joshua Harris-Till,DEM,120207,2,2,18,22,02
Choctaw,U.S. House,John Mccarthy,IND,120207,0,1,7,8,02
Choctaw,State Senate,Joseph Silk,REP,120207,1,8,54,63,5
Choctaw,State Senate,Stacey Allen Ebert,DEM,120207,2,2,37,41,5
Choctaw,State House,Justin Humphrey,REP,120207,1,7,42,50,19
Choctaw,State House,James Albert Campbell,DEM,120207,2,2,43,47,19
Choctaw,State House,Morgan Hopson,IND,120207,0,1,7,8,19
Choctaw,President,Donald Trump,REP,120208,7,99,205,311,
Choctaw,President,Gary Johnson,LIB,120208,0,2,14,16,
Choctaw,President,Hillary Clinton,DEM,120208,2,20,56,78,
Choctaw,U.S. Senate,James Lankford,REP,120208,7,95,176,278,
Choctaw,U.S. Senate,Robert Murphy,LIB,120208,0,0,10,10,
Choctaw,U.S. Senate,Mike Workman,DEM,120208,2,25,74,101,
Choctaw,U.S. Senate,Mark Beard,IND,120208,0,0,6,6,
Choctaw,U.S. Senate,Sean Braddy,IND,120208,0,1,4,5,
Choctaw,U.S. House,Markwayne Mullin,REP,120208,7,93,179,279,02
Choctaw,U.S. House,Joshua Harris-Till,DEM,120208,2,23,69,94,02
Choctaw,U.S. House,John Mccarthy,IND,120208,0,4,20,24,02
Choctaw,State Senate,Joseph Silk,REP,120208,6,72,159,237,5
Choctaw,State Senate,Stacey Allen Ebert,DEM,120208,3,50,111,164,5
Choctaw,State House,Justin Humphrey,REP,120208,5,56,109,170,19
Choctaw,State House,James Albert Campbell,DEM,120208,3,59,149,211,19
Choctaw,State House,Morgan Hopson,IND,120208,1,5,16,22,19
Choctaw,President,Donald Trump,REP,120209,0,18,74,92,
Choctaw,President,Gary Johnson,LIB,120209,0,2,4,6,
Choctaw,President,Hillary Clinton,DEM,120209,0,4,53,57,
Choctaw,U.S. Senate,James Lankford,REP,120209,1,18,66,85,
Choctaw,U.S. Senate,Robert Murphy,LIB,120209,0,1,3,4,
Choctaw,U.S. Senate,Mike Workman,DEM,120209,0,4,50,54,
Choctaw,U.S. Senate,Mark Beard,IND,120209,0,1,3,4,
Choctaw,U.S. Senate,Sean Braddy,IND,120209,0,0,2,2,
Choctaw,U.S. House,Markwayne Mullin,REP,120209,1,17,65,83,02
Choctaw,U.S. House,Joshua Harris-Till,DEM,120209,0,5,52,57,02
Choctaw,U.S. House,John Mccarthy,IND,120209,0,2,6,8,02
Choctaw,State Senate,Joseph Silk,REP,120209,1,13,60,74,5
Choctaw,State Senate,Stacey Allen Ebert,DEM,120209,0,10,66,76,5
Choctaw,State House,Justin Humphrey,REP,120209,0,13,31,44,19
Choctaw,State House,James Albert Campbell,DEM,120209,1,11,82,94,19
Choctaw,State House,Morgan Hopson,IND,120209,0,0,14,14,19
Choctaw,President,Donald Trump,REP,120210,15,106,285,406,
Choctaw,President,Gary Johnson,LIB,120210,0,1,3,4,
Choctaw,President,Hillary Clinton,DEM,120210,4,16,28,48,
Choctaw,U.S. Senate,James Lankford,REP,120210,15,100,253,368,
Choctaw,U.S. Senate,Robert Murphy,LIB,120210,0,3,9,12,
Choctaw,U.S. Senate,Mike Workman,DEM,120210,3,19,38,60,
Choctaw,U.S. Senate,Mark Beard,IND,120210,0,0,1,1,
Choctaw,U.S. Senate,Sean Braddy,IND,120210,0,0,5,5,
Choctaw,U.S. House,Markwayne Mullin,REP,120210,15,102,252,369,02
Choctaw,U.S. House,Joshua Harris-Till,DEM,120210,3,19,39,61,02
Choctaw,U.S. House,John Mccarthy,IND,120210,0,2,13,15,02
Choctaw,State Senate,Joseph Silk,REP,120210,11,83,215,309,5
Choctaw,State Senate,Stacey Allen Ebert,DEM,120210,7,40,91,138,5
Choctaw,State House,Justin Humphrey,REP,120210,10,68,170,248,19
Choctaw,State House,James Albert Campbell,DEM,120210,5,44,124,173,19
Choctaw,State House,Morgan Hopson,IND,120210,3,12,14,29,19
Choctaw,President,Donald Trump,REP,120211,0,13,43,56,
Choctaw,President,Gary Johnson,LIB,120211,0,0,1,1,
Choctaw,President,Hillary Clinton,DEM,120211,0,0,29,29,
Choctaw,U.S. Senate,James Lankford,REP,120211,0,10,35,45,
Choctaw,U.S. Senate,Robert Murphy,LIB,120211,0,0,2,2,
Choctaw,U.S. Senate,Mike Workman,DEM,120211,0,2,27,29,
Choctaw,U.S. Senate,Mark Beard,IND,120211,0,0,3,3,
Choctaw,U.S. Senate,Sean Braddy,IND,120211,0,1,2,3,
Choctaw,U.S. House,Markwayne Mullin,REP,120211,0,11,42,53,02
Choctaw,U.S. House,Joshua Harris-Till,DEM,120211,0,0,26,26,02
Choctaw,U.S. House,John Mccarthy,IND,120211,0,1,2,3,02
Choctaw,State Senate,Joseph Silk,REP,120211,0,9,26,35,5
Choctaw,State Senate,Stacey Allen Ebert,DEM,120211,0,4,47,51,5
Choctaw,State House,Justin Humphrey,REP,120211,0,8,25,33,19
Choctaw,State House,James Albert Campbell,DEM,120211,0,4,47,51,19
Choctaw,State House,Morgan Hopson,IND,120211,0,1,1,2,19
Choctaw,President,Donald Trump,REP,120214,6,52,120,178,
Choctaw,President,Gary Johnson,LIB,120214,0,4,10,14,
Choctaw,President,Hillary Clinton,DEM,120214,3,16,80,99,
Choctaw,U.S. Senate,James Lankford,REP,120214,6,44,105,155,
Choctaw,U.S. Senate,Robert Murphy,LIB,120214,0,2,3,5,
Choctaw,U.S. Senate,Mike Workman,DEM,120214,2,22,87,111,
Choctaw,U.S. Senate,Mark Beard,IND,120214,0,2,10,12,
Choctaw,U.S. Senate,Sean Braddy,IND,120214,1,3,4,8,
Choctaw,U.S. House,Markwayne Mullin,REP,120214,6,47,113,166,02
Choctaw,U.S. House,Joshua Harris-Till,DEM,120214,3,20,81,104,02
Choctaw,U.S. House,John Mccarthy,IND,120214,0,5,16,21,02
Choctaw,State Senate,Joseph Silk,REP,120214,6,50,113,169,5
Choctaw,State Senate,Stacey Allen Ebert,DEM,120214,3,23,97,123,5
Choctaw,State House,Justin Humphrey,REP,120214,5,33,65,103,19
Choctaw,State House,James Albert Campbell,DEM,120214,3,33,129,165,19
Choctaw,State House,Morgan Hopson,IND,120214,1,6,13,20,19
Choctaw,President,Donald Trump,REP,120215,4,60,84,148,
Choctaw,President,Gary Johnson,LIB,120215,0,2,4,6,
Choctaw,President,Hillary Clinton,DEM,120215,6,17,38,61,
Choctaw,U.S. Senate,James Lankford,REP,120215,4,55,70,129,
Choctaw,U.S. Senate,Robert Murphy,LIB,120215,0,1,4,5,
Choctaw,U.S. Senate,Mike Workman,DEM,120215,6,17,45,68,
Choctaw,U.S. Senate,Mark Beard,IND,120215,0,3,3,6,
Choctaw,U.S. Senate,Sean Braddy,IND,120215,0,2,3,5,
Choctaw,U.S. House,Markwayne Mullin,REP,120215,4,58,72,134,02
Choctaw,U.S. House,Joshua Harris-Till,DEM,120215,6,17,46,69,02
Choctaw,U.S. House,John Mccarthy,IND,120215,0,3,7,10,02
Choctaw,State Senate,Joseph Silk,REP,120215,3,50,72,125,5
Choctaw,State Senate,Stacey Allen Ebert,DEM,120215,7,27,53,87,5
Choctaw,State House,Justin Humphrey,REP,120215,4,45,52,101,19
Choctaw,State House,James Albert Campbell,DEM,120215,5,29,64,98,19
Choctaw,State House,Morgan Hopson,IND,120215,1,4,10,15,19
Choctaw,President,Donald Trump,REP,120316,18,123,264,405,
Choctaw,President,Gary Johnson,LIB,120316,0,1,14,15,
Choctaw,President,Hillary Clinton,DEM,120316,7,46,101,154,
Choctaw,U.S. Senate,James Lankford,REP,120316,19,119,233,371,
Choctaw,U.S. Senate,Robert Murphy,LIB,120316,1,2,10,13,
Choctaw,U.S. Senate,Mike Workman,DEM,120316,4,43,114,161,
Choctaw,U.S. Senate,Mark Beard,IND,120316,0,2,9,11,
Choctaw,U.S. Senate,Sean Braddy,IND,120316,1,3,7,11,
Choctaw,U.S. House,Markwayne Mullin,REP,120316,18,118,226,362,02
Choctaw,U.S. House,Joshua Harris-Till,DEM,120316,6,44,107,157,02
Choctaw,U.S. House,John Mccarthy,IND,120316,0,8,38,46,02
Choctaw,State Senate,Joseph Silk,REP,120316,18,111,222,351,5
Choctaw,State Senate,Stacey Allen Ebert,DEM,120316,5,58,153,216,5
Choctaw,State House,Justin Humphrey,REP,120316,13,80,158,251,19
Choctaw,State House,James Albert Campbell,DEM,120316,9,77,178,264,19
Choctaw,State House,Morgan Hopson,IND,120316,1,10,35,46,19
Choctaw,President,Donald Trump,REP,120318,7,63,229,299,
Choctaw,President,Gary Johnson,LIB,120318,0,0,9,9,
Choctaw,President,Hillary Clinton,DEM,120318,0,11,34,45,
Choctaw,U.S. Senate,James Lankford,REP,120318,7,58,205,270,
Choctaw,U.S. Senate,Robert Murphy,LIB,120318,0,0,8,8,
Choctaw,U.S. Senate,Mike Workman,DEM,120318,0,13,38,51,
Choctaw,U.S. Senate,Mark Beard,IND,120318,0,1,1,2,
Choctaw,U.S. Senate,Sean Braddy,IND,120318,0,1,5,6,
Choctaw,U.S. House,Markwayne Mullin,REP,120318,6,56,210,272,02
Choctaw,U.S. House,Joshua Harris-Till,DEM,120318,0,14,35,49,02
Choctaw,U.S. House,John Mccarthy,IND,120318,0,4,14,18,02
Choctaw,State Senate,Joseph Silk,REP,120318,6,49,189,244,5
Choctaw,State Senate,Stacey Allen Ebert,DEM,120318,1,25,77,103,5
Choctaw,State House,Justin Humphrey,REP,120318,4,33,130,167,19
Choctaw,State House,James Albert Campbell,DEM,120318,3,35,104,142,19
Choctaw,State House,Morgan Hopson,IND,120318,0,6,28,34,19
Choctaw,President,Donald Trump,REP,120319,19,34,225,278,
Choctaw,President,Gary Johnson,LIB,120319,5,0,6,11,
Choctaw,President,Hillary Clinton,DEM,120319,2,4,27,33,
Choctaw,U.S. Senate,James Lankford,REP,120319,22,31,189,242,
Choctaw,U.S. Senate,Robert Murphy,LIB,120319,1,0,6,7,
Choctaw,U.S. Senate,Mike Workman,DEM,120319,2,5,47,54,
Choctaw,U.S. Senate,Mark Beard,IND,120319,0,1,4,5,
Choctaw,U.S. Senate,Sean Braddy,IND,120319,1,0,6,7,
Choctaw,U.S. House,Markwayne Mullin,REP,120319,23,31,201,255,02
Choctaw,U.S. House,Joshua Harris-Till,DEM,120319,2,5,42,49,02
Choctaw,U.S. House,John Mccarthy,IND,120319,1,2,13,16,02
Choctaw,State Senate,Joseph Silk,REP,120319,13,30,157,200,5
Choctaw,State Senate,Stacey Allen Ebert,DEM,120319,12,8,96,116,5
Choctaw,State House,Justin Humphrey,REP,120319,14,18,132,164,19
Choctaw,State House,James Albert Campbell,DEM,120319,8,19,104,131,19
Choctaw,State House,Morgan Hopson,IND,120319,3,1,20,24,19
Choctaw,President,Donald Trump,REP,120320,0,17,129,146,
Choctaw,President,Gary Johnson,LIB,120320,0,0,4,4,
Choctaw,President,Hillary Clinton,DEM,120320,0,0,18,18,
Choctaw,U.S. Senate,James Lankford,REP,120320,0,16,103,119,
Choctaw,U.S. Senate,Robert Murphy,LIB,120320,0,0,3,3,
Choctaw,U.S. Senate,Mike Workman,DEM,120320,0,1,27,28,
Choctaw,U.S. Senate,Mark Beard,IND,120320,0,0,4,4,
Choctaw,U.S. Senate,Sean Braddy,IND,120320,0,0,7,7,
Choctaw,U.S. House,Markwayne Mullin,REP,120320,0,16,100,116,02
Choctaw,U.S. House,Joshua Harris-Till,DEM,120320,0,1,34,35,02
Choctaw,U.S. House,John Mccarthy,IND,120320,0,0,10,10,02
Choctaw,State Senate,Joseph Silk,REP,120320,0,14,80,94,5
Choctaw,State Senate,Stacey Allen Ebert,DEM,120320,0,3,67,70,5
Choctaw,State House,Justin Humphrey,REP,120320,0,14,66,80,19
Choctaw,State House,James Albert Campbell,DEM,120320,0,3,67,70,19
Choctaw,State House,Morgan Hopson,IND,120320,0,0,11,11,19
Choctaw,President,Donald Trump,REP,120321,15,46,247,308,
Choctaw,President,Gary Johnson,LIB,120321,2,0,2,4,
Choctaw,President,Hillary Clinton,DEM,120321,1,5,43,49,
Choctaw,U.S. Senate,James Lankford,REP,120321,15,43,206,264,
Choctaw,U.S. Senate,Robert Murphy,LIB,120321,0,0,6,6,
Choctaw,U.S. Senate,Mike Workman,DEM,120321,0,6,63,69,
Choctaw,U.S. Senate,Mark Beard,IND,120321,2,0,6,8,
Choctaw,U.S. Senate,Sean Braddy,IND,120321,1,0,7,8,
Choctaw,U.S. House,Markwayne Mullin,REP,120321,16,42,210,268,02
Choctaw,U.S. House,Joshua Harris-Till,DEM,120321,0,7,51,58,02
Choctaw,U.S. House,John Mccarthy,IND,120321,2,0,20,22,02
Choctaw,State Senate,Joseph Silk,REP,120321,17,38,185,240,5
Choctaw,State Senate,Stacey Allen Ebert,DEM,120321,1,12,103,116,5
Choctaw,State House,Justin Humphrey,REP,120321,14,33,157,204,19
Choctaw,State House,James Albert Campbell,DEM,120321,1,13,105,119,19
Choctaw,State House,Morgan Hopson,IND,120321,3,4,26,33,19
Choctaw,President,Donald Trump,REP,120322,4,14,154,172,
Choctaw,President,Gary Johnson,LIB,120322,0,0,5,5,
Choctaw,President,Hillary Clinton,DEM,120322,0,1,7,8,
Choctaw,U.S. Senate,James Lankford,REP,120322,4,13,121,138,
Choctaw,U.S. Senate,Robert Murphy,LIB,120322,0,0,5,5,
Choctaw,U.S. Senate,Mike Workman,DEM,120322,0,2,27,29,
Choctaw,U.S. Senate,Mark Beard,IND,120322,0,0,6,6,
Choctaw,U.S. Senate,Sean Braddy,IND,120322,0,0,4,4,
Choctaw,U.S. House,Markwayne Mullin,REP,120322,4,10,135,149,02
Choctaw,U.S. House,Joshua Harris-Till,DEM,120322,0,1,19,20,02
Choctaw,U.S. House,John Mccarthy,IND,120322,0,4,10,14,02
Choctaw,State Senate,Joseph Silk,REP,120322,3,14,106,123,5
Choctaw,State Senate,Stacey Allen Ebert,DEM,120322,1,1,59,61,5
Choctaw,State House,Justin Humphrey,REP,120322,2,8,95,105,19
Choctaw,State House,James Albert Campbell,DEM,120322,2,4,57,63,19
Choctaw,State House,Morgan Hopson,IND,120322,0,3,10,13,19
Cimarron,President,Donald Trump,REP,130002,18,24,106,148,
Cimarron,President,Gary Johnson,LIB,130002,0,2,10,12,
Cimarron,President,Hillary Clinton,DEM,130002,1,3,6,10,
Cimarron,U.S. Senate,James Lankford,REP,130002,16,25,103,144,
Cimarron,U.S. Senate,Robert Murphy,LIB,130002,1,1,1,3,
Cimarron,U.S. Senate,Mike Workman,DEM,130002,1,3,11,15,
Cimarron,U.S. Senate,Mark Beard,IND,130002,0,1,4,5,
Cimarron,U.S. Senate,Sean Braddy,IND,130002,0,0,1,1,
Cimarron,U.S. House,Frank Lucas,REP,130002,17,28,112,157,03
Cimarron,U.S. House,Frankie Robbins,DEM,130002,1,2,8,11,03
Cimarron,State House,Casey Murdock,REP,130002,17,26,116,159,61
Cimarron,State House,Ashlee Renee Ortiz,DEM,130002,1,4,7,12,61
Cimarron,President,Donald Trump,REP,130003,8,45,102,155,
Cimarron,President,Gary Johnson,LIB,130003,1,1,3,5,
Cimarron,President,Hillary Clinton,DEM,130003,2,1,7,10,
Cimarron,U.S. Senate,James Lankford,REP,130003,7,41,99,147,
Cimarron,U.S. Senate,Robert Murphy,LIB,130003,1,1,2,4,
Cimarron,U.S. Senate,Mike Workman,DEM,130003,2,3,5,10,
Cimarron,U.S. Senate,Mark Beard,IND,130003,1,0,9,10,
Cimarron,U.S. Senate,Sean Braddy,IND,130003,0,2,1,3,
Cimarron,U.S. House,Frank Lucas,REP,130003,8,45,98,151,03
Cimarron,U.S. House,Frankie Robbins,DEM,130003,3,2,14,19,03
Cimarron,State House,Casey Murdock,REP,130003,8,36,98,142,61
Cimarron,State House,Ashlee Renee Ortiz,DEM,130003,4,11,14,29,61
Cimarron,President,Donald Trump,REP,130004,6,44,136,186,
Cimarron,President,Gary Johnson,LIB,130004,2,2,6,10,
Cimarron,President,Hillary Clinton,DEM,130004,3,2,10,15,
Cimarron,U.S. Senate,James Lankford,REP,130004,10,42,126,178,
Cimarron,U.S. Senate,Robert Murphy,LIB,130004,0,0,5,5,
Cimarron,U.S. Senate,Mike Workman,DEM,130004,0,3,12,15,
Cimarron,U.S. Senate,Mark Beard,IND,130004,1,2,6,9,
Cimarron,U.S. Senate,Sean Braddy,IND,130004,0,2,2,4,
Cimarron,U.S. House,Frank Lucas,REP,130004,11,48,138,197,03
Cimarron,U.S. House,Frankie Robbins,DEM,130004,0,2,12,14,03
Cimarron,State House,Casey Murdock,REP,130004,11,41,135,187,61
Cimarron,State House,Ashlee Renee Ortiz,DEM,130004,0,8,16,24,61
Cimarron,President,Donald Trump,REP,130005,4,36,114,154,
Cimarron,President,Gary Johnson,LIB,130005,0,3,4,7,
Cimarron,President,Hillary Clinton,DEM,130005,0,7,11,18,
Cimarron,U.S. Senate,James Lankford,REP,130005,4,34,96,134,
Cimarron,U.S. Senate,Robert Murphy,LIB,130005,0,2,5,7,
Cimarron,U.S. Senate,Mike Workman,DEM,130005,0,6,11,17,
Cimarron,U.S. Senate,Mark Beard,IND,130005,0,1,3,4,
Cimarron,U.S. Senate,Sean Braddy,IND,130005,0,2,4,6,
Cimarron,U.S. House,Frank Lucas,REP,130005,4,40,111,155,03
Cimarron,U.S. House,Frankie Robbins,DEM,130005,0,6,10,16,03
Cimarron,State House,Casey Murdock,REP,130005,4,36,108,148,61
Cimarron,State House,Ashlee Renee Ortiz,DEM,130005,0,10,19,29,61
Cimarron,President,Donald Trump,REP,130006,23,72,168,263,
Cimarron,President,Gary Johnson,LIB,130006,0,2,5,7,
Cimarron,President,Hillary Clinton,DEM,130006,2,1,8,11,
Cimarron,U.S. Senate,James Lankford,REP,130006,20,65,160,245,
Cimarron,U.S. Senate,Robert Murphy,LIB,130006,0,1,3,4,
Cimarron,U.S. Senate,Mike Workman,DEM,130006,1,2,8,11,
Cimarron,U.S. Senate,Mark Beard,IND,130006,4,2,4,10,
Cimarron,U.S. Senate,Sean Braddy,IND,130006,0,1,5,6,
Cimarron,U.S. House,Frank Lucas,REP,130006,20,68,169,257,03
Cimarron,U.S. House,Frankie Robbins,DEM,130006,5,2,11,18,03
Cimarron,State House,Casey Murdock,REP,130006,19,66,166,251,61
Cimarron,State House,Ashlee Renee Ortiz,DEM,130006,6,7,13,26,61
Cimarron,President,Donald Trump,REP,130007,6,13,38,57,
Cimarron,President,Gary Johnson,LIB,130007,1,1,2,4,
Cimarron,President,Hillary Clinton,DEM,130007,0,2,5,7,
Cimarron,U.S. Senate,James Lankford,REP,130007,5,13,37,55,
Cimarron,U.S. Senate,Robert Murphy,LIB,130007,1,0,0,1,
Cimarron,U.S. Senate,Mike Workman,DEM,130007,0,2,7,9,
Cimarron,U.S. Senate,Mark Beard,IND,130007,1,0,0,1,
Cimarron,U.S. Senate,Sean Braddy,IND,130007,0,0,0,0,
Cimarron,U.S. House,Frank Lucas,REP,130007,7,15,39,61,03
Cimarron,U.S. House,Frankie Robbins,DEM,130007,0,1,5,6,03
Cimarron,State House,Casey Murdock,REP,130007,7,15,41,63,61
Cimarron,State House,Ashlee Renee Ortiz,DEM,130007,0,1,4,5,61
Cleveland,President,Donald Trump,REP,140002,19,18,188,225,
Cleveland,President,Gary Johnson,LIB,140002,2,7,63,72,
Cleveland,President,Hillary Clinton,DEM,140002,22,35,297,354,
Cleveland,U.S. Senate,James Lankford,REP,140002,18,17,199,234,
Cleveland,U.S. Senate,Robert Murphy,LIB,140002,1,1,25,27,
Cleveland,U.S. Senate,Mike Workman,DEM,140002,16,30,211,257,
Cleveland,U.S. Senate,Mark Beard,IND,140002,0,0,15,15,
Cleveland,U.S. Senate,Sean Braddy,IND,140002,8,13,102,123,
Cleveland,U.S. House,Tom Cole,REP,140002,18,17,207,242,04
Cleveland,U.S. House,Sevier White,LIB,140002,3,5,49,57,04
Cleveland,U.S. House,Christina Owen,DEM,140002,22,39,294,355,04
Cleveland,President,Donald Trump,REP,140003,22,27,320,369,
Cleveland,President,Gary Johnson,LIB,140003,5,2,66,73,
Cleveland,President,Hillary Clinton,DEM,140003,33,59,343,435,
Cleveland,U.S. Senate,James Lankford,REP,140003,27,37,376,440,
Cleveland,U.S. Senate,Robert Murphy,LIB,140003,2,1,30,33,
Cleveland,U.S. Senate,Mike Workman,DEM,140003,28,42,241,311,
Cleveland,U.S. Senate,Mark Beard,IND,140003,0,1,17,18,
Cleveland,U.S. Senate,Sean Braddy,IND,140003,3,8,64,75,
Cleveland,U.S. House,Tom Cole,REP,140003,27,37,391,455,04
Cleveland,U.S. House,Sevier White,LIB,140003,2,2,43,47,04
Cleveland,U.S. House,Christina Owen,DEM,140003,29,49,295,373,04
Cleveland,State Senate,Rob Standridge,REP,140003,22,37,356,415,15
Cleveland,State Senate,Shawn Sheehan,IND,140003,32,44,332,408,15
Cleveland,State House,Marc Etters,REP,140003,18,29,337,384,45
Cleveland,State House,Claudia Griffith,DEM,140003,41,60,387,488,45
Cleveland,President,Donald Trump,REP,140004,218,228,958,1404,
Cleveland,President,Gary Johnson,LIB,140004,14,12,58,84,
Cleveland,President,Hillary Clinton,DEM,140004,72,105,335,512,
Cleveland,U.S. Senate,James Lankford,REP,140004,244,255,1051,1550,
Cleveland,U.S. Senate,Robert Murphy,LIB,140004,9,4,30,43,
Cleveland,U.S. Senate,Mike Workman,DEM,140004,49,82,224,355,
Cleveland,U.S. Senate,Mark Beard,IND,140004,1,5,15,21,
Cleveland,U.S. Senate,Sean Braddy,IND,140004,10,6,33,49,
Cleveland,U.S. House,Tom Cole,REP,140004,238,252,1035,1525,04
Cleveland,U.S. House,Sevier White,LIB,140004,14,16,50,80,04
Cleveland,U.S. House,Christina Owen,DEM,140004,60,84,270,414,04
Cleveland,State House,Chris Kannady,REP,140004,243,253,1044,1540,91
Cleveland,State House,Trey Puckett,DEM,140004,60,94,294,448,91
Cleveland,President,Donald Trump,REP,140005,235,274,1041,1550,
Cleveland,President,Gary Johnson,LIB,140005,22,32,98,152,
Cleveland,President,Hillary Clinton,DEM,140005,89,120,383,592,
Cleveland,U.S. Senate,James Lankford,REP,140005,260,310,1091,1661,
Cleveland,U.S. Senate,Robert Murphy,LIB,140005,8,15,52,75,
Cleveland,U.S. Senate,Mike Workman,DEM,140005,72,88,294,454,
Cleveland,U.S. Senate,Mark Beard,IND,140005,2,3,39,44,
Cleveland,U.S. Senate,Sean Braddy,IND,140005,4,14,46,64,
Cleveland,U.S. House,Tom Cole,REP,140005,253,314,1095,1662,04
Cleveland,U.S. House,Sevier White,LIB,140005,17,16,83,116,04
Cleveland,U.S. House,Christina Owen,DEM,140005,78,99,343,520,04
Cleveland,State House,Kevin West,REP,140005,240,285,1011,1536,54
Cleveland,State House,Mary Newcome-Hatch,DEM,140005,82,102,330,514,54
Cleveland,State House,Elizabeth Larios,IND,140005,17,33,161,211,54
Cleveland,President,Donald Trump,REP,140006,16,12,194,222,
Cleveland,President,Gary Johnson,LIB,140006,7,8,68,83,
Cleveland,President,Hillary Clinton,DEM,140006,76,80,535,691,
Cleveland,U.S. Senate,James Lankford,REP,140006,21,14,240,275,
Cleveland,U.S. Senate,Robert Murphy,LIB,140006,3,1,33,37,
Cleveland,U.S. Senate,Mike Workman,DEM,140006,55,59,373,487,
Cleveland,U.S. Senate,Mark Beard,IND,140006,2,3,10,15,
Cleveland,U.S. Senate,Sean Braddy,IND,140006,15,23,145,183,
Cleveland,U.S. House,Tom Cole,REP,140006,22,22,253,297,04
Cleveland,U.S. House,Sevier White,LIB,140006,3,4,40,47,04
Cleveland,U.S. House,Christina Owen,DEM,140006,71,73,503,647,04
Cleveland,President,Donald Trump,REP,140007,129,109,901,1139,
Cleveland,President,Gary Johnson,LIB,140007,9,14,95,118,
Cleveland,President,Hillary Clinton,DEM,140007,32,51,223,306,
Cleveland,U.S. Senate,James Lankford,REP,140007,139,118,987,1244,
Cleveland,U.S. Senate,Robert Murphy,LIB,140007,6,6,38,50,
Cleveland,U.S. Senate,Mike Workman,DEM,140007,22,46,154,222,
Cleveland,U.S. Senate,Mark Beard,IND,140007,2,3,20,25,
Cleveland,U.S. Senate,Sean Braddy,IND,140007,3,3,19,25,
Cleveland,U.S. House,Tom Cole,REP,140007,133,116,974,1223,04
Cleveland,U.S. House,Sevier White,LIB,140007,9,9,43,61,04
Cleveland,U.S. House,Christina Owen,DEM,140007,30,50,195,275,04
Cleveland,President,Donald Trump,REP,140008,15,20,156,191,
Cleveland,President,Gary Johnson,LIB,140008,3,4,86,93,
Cleveland,President,Hillary Clinton,DEM,140008,70,71,507,648,
Cleveland,U.S. Senate,James Lankford,REP,140008,24,23,193,240,
Cleveland,U.S. Senate,Robert Murphy,LIB,140008,1,2,43,46,
Cleveland,U.S. Senate,Mike Workman,DEM,140008,47,54,345,446,
Cleveland,U.S. Senate,Mark Beard,IND,140008,2,2,15,19,
Cleveland,U.S. Senate,Sean Braddy,IND,140008,16,12,152,180,
Cleveland,U.S. House,Tom Cole,REP,140008,30,20,223,273,04
Cleveland,U.S. House,Sevier White,LIB,140008,1,5,48,54,04
Cleveland,U.S. House,Christina Owen,DEM,140008,56,67,477,600,04
Cleveland,President,Donald Trump,REP,140009,119,217,938,1274,
Cleveland,President,Gary Johnson,LIB,140009,11,20,108,139,
Cleveland,President,Hillary Clinton,DEM,140009,61,84,316,461,
Cleveland,U.S. Senate,James Lankford,REP,140009,139,239,987,1365,
Cleveland,U.S. Senate,Robert Murphy,LIB,140009,4,4,55,63,
Cleveland,U.S. Senate,Mike Workman,DEM,140009,45,67,245,357,
Cleveland,U.S. Senate,Mark Beard,IND,140009,0,5,29,34,
Cleveland,U.S. Senate,Sean Braddy,IND,140009,6,5,50,61,
Cleveland,U.S. House,Tom Cole,REP,140009,139,234,994,1367,04
Cleveland,U.S. House,Sevier White,LIB,140009,7,9,73,89,04
Cleveland,U.S. House,Christina Owen,DEM,140009,46,76,294,416,04
Cleveland,State House,Chris Kannady,REP,140009,139,238,1016,1393,91
Cleveland,State House,Trey Puckett,DEM,140009,54,77,329,460,91
Cleveland,President,Donald Trump,REP,140010,71,72,470,613,
Cleveland,President,Gary Johnson,LIB,140010,4,7,59,70,
Cleveland,President,Hillary Clinton,DEM,140010,30,43,224,297,
Cleveland,U.S. Senate,James Lankford,REP,140010,77,79,498,654,
Cleveland,U.S. Senate,Robert Murphy,LIB,140010,2,5,30,37,
Cleveland,U.S. Senate,Mike Workman,DEM,140010,20,32,173,225,
Cleveland,U.S. Senate,Mark Beard,IND,140010,3,3,24,30,
Cleveland,U.S. Senate,Sean Braddy,IND,140010,3,3,27,33,
Cleveland,U.S. House,Tom Cole,REP,140010,79,78,497,654,04
Cleveland,U.S. House,Sevier White,LIB,140010,4,5,36,45,04
Cleveland,U.S. House,Christina Owen,DEM,140010,23,39,215,277,04
Cleveland,State House,Kevin West,REP,140010,74,75,446,595,54
Cleveland,State House,Mary Newcome-Hatch,DEM,140010,21,34,195,250,54
Cleveland,State House,Elizabeth Larios,IND,140010,7,12,103,122,54
Cleveland,President,Donald Trump,REP,140011,33,30,257,320,
Cleveland,President,Gary Johnson,LIB,140011,4,10,73,87,
Cleveland,President,Hillary Clinton,DEM,140011,55,70,492,617,
Cleveland,U.S. Senate,James Lankford,REP,140011,36,42,282,360,
Cleveland,U.S. Senate,Robert Murphy,LIB,140011,2,2,40,44,
Cleveland,U.S. Senate,Mike Workman,DEM,140011,42,47,366,455,
Cleveland,U.S. Senate,Mark Beard,IND,140011,3,4,13,20,
Cleveland,U.S. Senate,Sean Braddy,IND,140011,9,18,126,153,
Cleveland,U.S. House,Tom Cole,REP,140011,35,41,315,391,04
Cleveland,U.S. House,Sevier White,LIB,140011,5,5,55,65,04
Cleveland,U.S. House,Christina Owen,DEM,140011,53,68,455,576,04
Cleveland,President,Donald Trump,REP,140012,80,111,639,830,
Cleveland,President,Gary Johnson,LIB,140012,17,14,87,118,
Cleveland,President,Hillary Clinton,DEM,140012,77,107,443,627,
Cleveland,U.S. Senate,James Lankford,REP,140012,99,127,710,936,
Cleveland,U.S. Senate,Robert Murphy,LIB,140012,1,3,41,45,
Cleveland,U.S. Senate,Mike Workman,DEM,140012,65,88,327,480,
Cleveland,U.S. Senate,Mark Beard,IND,140012,1,5,12,18,
Cleveland,U.S. Senate,Sean Braddy,IND,140012,12,9,81,102,
Cleveland,U.S. House,Tom Cole,REP,140012,100,128,732,960,04
Cleveland,U.S. House,Sevier White,LIB,140012,5,10,57,72,04
Cleveland,U.S. House,Christina Owen,DEM,140012,72,94,378,544,04
Cleveland,State Senate,Rob Standridge,REP,140012,97,115,662,874,15
Cleveland,State Senate,Shawn Sheehan,IND,140012,68,97,444,609,15
Cleveland,State House,Marc Etters,REP,140012,91,111,651,853,45
Cleveland,State House,Claudia Griffith,DEM,140012,85,119,500,704,45
Cleveland,President,Donald Trump,REP,140013,6,9,167,182,
Cleveland,President,Gary Johnson,LIB,140013,7,2,62,71,
Cleveland,President,Hillary Clinton,DEM,140013,28,50,368,446,
Cleveland,U.S. Senate,James Lankford,REP,140013,11,11,211,233,
Cleveland,U.S. Senate,Robert Murphy,LIB,140013,4,3,37,44,
Cleveland,U.S. Senate,Mike Workman,DEM,140013,20,35,273,328,
Cleveland,U.S. Senate,Mark Beard,IND,140013,0,4,19,23,
Cleveland,U.S. Senate,Sean Braddy,IND,140013,4,5,64,73,
Cleveland,U.S. House,Tom Cole,REP,140013,13,13,208,234,04
Cleveland,U.S. House,Sevier White,LIB,140013,4,5,50,59,04
Cleveland,U.S. House,Christina Owen,DEM,140013,23,41,338,402,04
Cleveland,State Senate,Rob Standridge,REP,140013,11,13,221,245,15
Cleveland,State Senate,Shawn Sheehan,IND,140013,27,37,320,384,15
Cleveland,President,Donald Trump,REP,140014,28,34,255,317,
Cleveland,President,Gary Johnson,LIB,140014,8,7,123,138,
Cleveland,President,Hillary Clinton,DEM,140014,51,72,577,700,
Cleveland,U.S. Senate,James Lankford,REP,140014,30,39,303,372,
Cleveland,U.S. Senate,Robert Murphy,LIB,140014,7,4,62,73,
Cleveland,U.S. Senate,Mike Workman,DEM,140014,38,57,404,499,
Cleveland,U.S. Senate,Mark Beard,IND,140014,1,0,37,38,
Cleveland,U.S. Senate,Sean Braddy,IND,140014,10,13,146,169,
Cleveland,U.S. House,Tom Cole,REP,140014,32,40,317,389,04
Cleveland,U.S. House,Sevier White,LIB,140014,4,8,83,95,04
Cleveland,U.S. House,Christina Owen,DEM,140014,50,64,549,663,04
Cleveland,President,Donald Trump,REP,140015,22,46,276,344,
Cleveland,President,Gary Johnson,LIB,140015,11,9,105,125,
Cleveland,President,Hillary Clinton,DEM,140015,76,84,557,717,
Cleveland,U.S. Senate,James Lankford,REP,140015,31,47,329,407,
Cleveland,U.S. Senate,Robert Murphy,LIB,140015,2,6,42,50,
Cleveland,U.S. Senate,Mike Workman,DEM,140015,55,62,390,507,
Cleveland,U.S. Senate,Mark Beard,IND,140015,1,3,25,29,
Cleveland,U.S. Senate,Sean Braddy,IND,140015,16,20,154,190,
Cleveland,U.S. House,Tom Cole,REP,140015,37,52,351,440,04
Cleveland,U.S. House,Sevier White,LIB,140015,1,10,53,64,04
Cleveland,U.S. House,Christina Owen,DEM,140015,68,76,536,680,04
Cleveland,President,Donald Trump,REP,140016,91,94,611,796,
Cleveland,President,Gary Johnson,LIB,140016,13,9,98,120,
Cleveland,President,Hillary Clinton,DEM,140016,48,37,294,379,
Cleveland,U.S. Senate,James Lankford,REP,140016,103,103,660,866,
Cleveland,U.S. Senate,Robert Murphy,LIB,140016,1,2,41,44,
Cleveland,U.S. Senate,Mike Workman,DEM,140016,39,30,225,294,
Cleveland,U.S. Senate,Mark Beard,IND,140016,5,1,22,28,
Cleveland,U.S. Senate,Sean Braddy,IND,140016,7,7,57,71,
Cleveland,U.S. House,Tom Cole,REP,140016,105,106,669,880,04
Cleveland,U.S. House,Sevier White,LIB,140016,9,1,55,65,04
Cleveland,U.S. House,Christina Owen,DEM,140016,40,35,282,357,04
Cleveland,State House,Kevin West,REP,140016,93,97,613,803,54
Cleveland,State House,Mary Newcome-Hatch,DEM,140016,49,37,270,356,54
Cleveland,State House,Elizabeth Larios,IND,140016,10,8,109,127,54
Cleveland,President,Donald Trump,REP,140017,29,25,248,302,
Cleveland,President,Gary Johnson,LIB,140017,1,2,20,23,
Cleveland,President,Hillary Clinton,DEM,140017,6,9,65,80,
Cleveland,U.S. Senate,James Lankford,REP,140017,29,25,268,322,
Cleveland,U.S. Senate,Robert Murphy,LIB,140017,1,1,11,13,
Cleveland,U.S. Senate,Mike Workman,DEM,140017,6,8,45,59,
Cleveland,U.S. Senate,Mark Beard,IND,140017,0,1,9,10,
Cleveland,U.S. Senate,Sean Braddy,IND,140017,0,1,5,6,
Cleveland,U.S. House,Tom Cole,REP,140017,30,23,275,328,04
Cleveland,U.S. House,Sevier White,LIB,140017,0,3,15,18,04
Cleveland,U.S. House,Christina Owen,DEM,140017,6,10,50,66,04
Cleveland,State House,Josh Cockroft,REP,140017,26,26,267,319,27
Cleveland,State House,John Karlin,DEM,140017,8,9,65,82,27
Cleveland,President,Donald Trump,REP,140018,19,26,318,363,
Cleveland,President,Gary Johnson,LIB,140018,6,9,118,133,
Cleveland,President,Hillary Clinton,DEM,140018,51,84,521,656,
Cleveland,U.S. Senate,James Lankford,REP,140018,26,30,366,422,
Cleveland,U.S. Senate,Robert Murphy,LIB,140018,3,4,51,58,
Cleveland,U.S. Senate,Mike Workman,DEM,140018,40,56,352,448,
Cleveland,U.S. Senate,Mark Beard,IND,140018,0,4,22,26,
Cleveland,U.S. Senate,Sean Braddy,IND,140018,10,26,171,207,
Cleveland,U.S. House,Tom Cole,REP,140018,32,29,378,439,04
Cleveland,U.S. House,Sevier White,LIB,140018,1,6,74,81,04
Cleveland,U.S. House,Christina Owen,DEM,140018,47,85,509,641,04
Cleveland,President,Donald Trump,REP,140019,68,83,584,735,
Cleveland,President,Gary Johnson,LIB,140019,13,13,118,144,
Cleveland,President,Hillary Clinton,DEM,140019,118,147,732,997,
Cleveland,U.S. Senate,James Lankford,REP,140019,85,97,663,845,
Cleveland,U.S. Senate,Robert Murphy,LIB,140019,5,6,54,65,
Cleveland,U.S. Senate,Mike Workman,DEM,140019,91,93,501,685,
Cleveland,U.S. Senate,Mark Beard,IND,140019,2,2,29,33,
Cleveland,U.S. Senate,Sean Braddy,IND,140019,22,46,190,258,
Cleveland,U.S. House,Tom Cole,REP,140019,87,98,703,888,04
Cleveland,U.S. House,Sevier White,LIB,140019,7,8,86,101,04
Cleveland,U.S. House,Christina Owen,DEM,140019,107,136,650,893,04
Cleveland,President,Donald Trump,REP,140020,236,342,922,1500,
Cleveland,President,Gary Johnson,LIB,140020,4,15,81,100,
Cleveland,President,Hillary Clinton,DEM,140020,94,148,354,596,
Cleveland,U.S. Senate,James Lankford,REP,140020,252,370,1019,1641,
Cleveland,U.S. Senate,Robert Murphy,LIB,140020,5,8,40,53,
Cleveland,U.S. Senate,Mike Workman,DEM,140020,74,113,254,441,
Cleveland,U.S. Senate,Mark Beard,IND,140020,3,9,24,36,
Cleveland,U.S. Senate,Sean Braddy,IND,140020,4,6,33,43,
Cleveland,U.S. House,Tom Cole,REP,140020,259,358,1040,1657,04
Cleveland,U.S. House,Sevier White,LIB,140020,4,15,50,69,04
Cleveland,U.S. House,Christina Owen,DEM,140020,73,128,279,480,04
Cleveland,State House,Chris Kannady,REP,140020,256,366,1030,1652,91
Cleveland,State House,Trey Puckett,DEM,140020,80,135,322,537,91
Cleveland,President,Donald Trump,REP,140021,52,66,480,598,
Cleveland,President,Gary Johnson,LIB,140021,9,7,62,78,
Cleveland,President,Hillary Clinton,DEM,140021,28,19,207,254,
Cleveland,U.S. Senate,James Lankford,REP,140021,60,67,504,631,
Cleveland,U.S. Senate,Robert Murphy,LIB,140021,3,2,26,31,
Cleveland,U.S. Senate,Mike Workman,DEM,140021,24,16,148,188,
Cleveland,U.S. Senate,Mark Beard,IND,140021,1,4,29,34,
Cleveland,U.S. Senate,Sean Braddy,IND,140021,2,2,38,42,
Cleveland,U.S. House,Tom Cole,REP,140021,62,66,516,644,04
Cleveland,U.S. House,Sevier White,LIB,140021,4,6,47,57,04
Cleveland,U.S. House,Christina Owen,DEM,140021,24,19,183,226,04
Cleveland,President,Donald Trump,REP,140022,189,198,990,1377,
Cleveland,President,Gary Johnson,LIB,140022,19,13,121,153,
Cleveland,President,Hillary Clinton,DEM,140022,85,71,419,575,
Cleveland,U.S. Senate,James Lankford,REP,140022,200,200,1037,1437,
Cleveland,U.S. Senate,Robert Murphy,LIB,140022,3,7,60,70,
Cleveland,U.S. Senate,Mike Workman,DEM,140022,74,59,324,457,
Cleveland,U.S. Senate,Mark Beard,IND,140022,7,6,47,60,
Cleveland,U.S. Senate,Sean Braddy,IND,140022,12,9,59,80,
Cleveland,U.S. House,Tom Cole,REP,140022,186,202,1054,1442,04
Cleveland,U.S. House,Sevier White,LIB,140022,12,13,90,115,04
Cleveland,U.S. House,Christina Owen,DEM,140022,97,67,380,544,04
Cleveland,President,Donald Trump,REP,140024,271,286,1115,1672,
Cleveland,President,Gary Johnson,LIB,140024,25,23,128,176,
Cleveland,President,Hillary Clinton,DEM,140024,123,154,453,730,
Cleveland,U.S. Senate,James Lankford,REP,140024,293,299,1168,1760,
Cleveland,U.S. Senate,Robert Murphy,LIB,140024,9,10,78,97,
Cleveland,U.S. Senate,Mike Workman,DEM,140024,104,133,349,586,
Cleveland,U.S. Senate,Mark Beard,IND,140024,11,7,36,54,
Cleveland,U.S. Senate,Sean Braddy,IND,140024,5,12,59,76,
Cleveland,U.S. House,Tom Cole,REP,140024,293,299,1159,1751,04
Cleveland,U.S. House,Sevier White,LIB,140024,15,15,112,142,04
Cleveland,U.S. House,Christina Owen,DEM,140024,114,150,418,682,04
Cleveland,President,Donald Trump,REP,140025,41,32,496,569,
Cleveland,President,Gary Johnson,LIB,140025,5,4,48,57,
Cleveland,President,Hillary Clinton,DEM,140025,19,12,195,226,
Cleveland,U.S. Senate,James Lankford,REP,140025,42,35,494,571,
Cleveland,U.S. Senate,Robert Murphy,LIB,140025,3,2,32,37,
Cleveland,U.S. Senate,Mike Workman,DEM,140025,17,9,151,177,
Cleveland,U.S. Senate,Mark Beard,IND,140025,1,1,19,21,
Cleveland,U.S. Senate,Sean Braddy,IND,140025,1,1,37,39,
Cleveland,U.S. House,Tom Cole,REP,140025,41,34,479,554,04
Cleveland,U.S. House,Sevier White,LIB,140025,4,3,69,76,04
Cleveland,U.S. House,Christina Owen,DEM,140025,20,11,185,216,04
Cleveland,State Senate,Rob Standridge,REP,140025,45,32,486,563,15
Cleveland,State Senate,Shawn Sheehan,IND,140025,14,14,216,244,15
Cleveland,State House,Marc Etters,REP,140025,40,32,490,562,45
Cleveland,State House,Claudia Griffith,DEM,140025,24,16,234,274,45
Cleveland,President,Donald Trump,REP,140026,88,119,596,803,
Cleveland,President,Gary Johnson,LIB,140026,16,14,100,130,
Cleveland,President,Hillary Clinton,DEM,140026,88,138,527,753,
Cleveland,U.S. Senate,James Lankford,REP,140026,110,127,652,889,
Cleveland,U.S. Senate,Robert Murphy,LIB,140026,2,11,48,61,
Cleveland,U.S. Senate,Mike Workman,DEM,140026,67,112,364,543,
Cleveland,U.S. Senate,Mark Beard,IND,140026,2,5,29,36,
Cleveland,U.S. Senate,Sean Braddy,IND,140026,9,19,128,156,
Cleveland,U.S. House,Tom Cole,REP,140026,116,126,661,903,04
Cleveland,U.S. House,Sevier White,LIB,140026,5,17,78,100,04
Cleveland,U.S. House,Christina Owen,DEM,140026,69,127,482,678,04
Cleveland,State Senate,Rob Standridge,REP,140026,112,132,629,873,15
Cleveland,State Senate,Shawn Sheehan,IND,140026,57,107,524,688,15
Cleveland,State House,Marc Etters,REP,140026,91,114,591,796,45
Cleveland,State House,Claudia Griffith,DEM,140026,96,158,618,872,45
Cleveland,President,Donald Trump,REP,140027,257,175,707,1139,
Cleveland,President,Gary Johnson,LIB,140027,26,19,90,135,
Cleveland,President,Hillary Clinton,DEM,140027,219,147,484,850,
Cleveland,U.S. Senate,James Lankford,REP,140027,318,199,839,1356,
Cleveland,U.S. Senate,Robert Murphy,LIB,140027,8,7,44,59,
Cleveland,U.S. Senate,Mike Workman,DEM,140027,161,108,309,578,
Cleveland,U.S. Senate,Mark Beard,IND,140027,7,2,23,32,
Cleveland,U.S. Senate,Sean Braddy,IND,140027,19,26,84,129,
Cleveland,U.S. House,Tom Cole,REP,140027,342,205,841,1388,04
Cleveland,U.S. House,Sevier White,LIB,140027,10,12,54,76,04
Cleveland,U.S. House,Christina Owen,DEM,140027,161,125,403,689,04
Cleveland,State Senate,Rob Standridge,REP,140027,289,188,798,1275,15
Cleveland,State Senate,Shawn Sheehan,IND,140027,192,134,429,755,15
Cleveland,State House,Scott Martin,REP,140027,320,198,847,1365,46
Cleveland,State House,Jacob Rosecrants,DEM,140027,186,144,437,767,46
Cleveland,President,Donald Trump,REP,140028,38,68,565,671,
Cleveland,President,Gary Johnson,LIB,140028,14,10,173,197,
Cleveland,President,Hillary Clinton,DEM,140028,87,135,788,1010,
Cleveland,U.S. Senate,James Lankford,REP,140028,46,77,623,746,
Cleveland,U.S. Senate,Robert Murphy,LIB,140028,4,11,90,105,
Cleveland,U.S. Senate,Mike Workman,DEM,140028,82,99,614,795,
Cleveland,U.S. Senate,Mark Beard,IND,140028,2,4,42,48,
Cleveland,U.S. Senate,Sean Braddy,IND,140028,7,25,152,184,
Cleveland,U.S. House,Tom Cole,REP,140028,51,83,657,791,04
Cleveland,U.S. House,Sevier White,LIB,140028,10,15,114,139,04
Cleveland,U.S. House,Christina Owen,DEM,140028,80,117,747,944,04
Cleveland,State House,Marc Etters,REP,140028,36,77,613,726,45
Cleveland,State House,Claudia Griffith,DEM,140028,101,137,884,1122,45
Cleveland,President,Donald Trump,REP,140029,61,90,1025,1176,
Cleveland,President,Gary Johnson,LIB,140029,6,3,84,93,
Cleveland,President,Hillary Clinton,DEM,140029,19,16,239,274,
Cleveland,U.S. Senate,James Lankford,REP,140029,60,89,1039,1188,
Cleveland,U.S. Senate,Robert Murphy,LIB,140029,3,1,34,38,
Cleveland,U.S. Senate,Mike Workman,DEM,140029,18,17,191,226,
Cleveland,U.S. Senate,Mark Beard,IND,140029,0,1,34,35,
Cleveland,U.S. Senate,Sean Braddy,IND,140029,4,0,36,40,
Cleveland,U.S. House,Tom Cole,REP,140029,59,86,1019,1164,04
Cleveland,U.S. House,Sevier White,LIB,140029,7,5,63,75,04
Cleveland,U.S. House,Christina Owen,DEM,140029,20,18,253,291,04
Cleveland,State House,Bobby Cleveland,REP,140029,52,74,805,931,20
Cleveland,State House,Matt Failing,DEM,140029,33,35,527,595,20
Cleveland,President,Donald Trump,REP,140030,41,42,406,489,
Cleveland,President,Gary Johnson,LIB,140030,8,5,65,78,
Cleveland,President,Hillary Clinton,DEM,140030,43,40,254,337,
Cleveland,U.S. Senate,James Lankford,REP,140030,50,47,442,539,
Cleveland,U.S. Senate,Robert Murphy,LIB,140030,0,3,28,31,
Cleveland,U.S. Senate,Mike Workman,DEM,140030,34,28,201,263,
Cleveland,U.S. Senate,Mark Beard,IND,140030,0,2,17,19,
Cleveland,U.S. Senate,Sean Braddy,IND,140030,11,7,38,56,
Cleveland,U.S. House,Tom Cole,REP,140030,51,43,452,546,04
Cleveland,U.S. House,Sevier White,LIB,140030,1,8,41,50,04
Cleveland,U.S. House,Christina Owen,DEM,140030,43,36,232,311,04
Cleveland,State House,Marc Etters,REP,140030,40,39,412,491,45
Cleveland,State House,Claudia Griffith,DEM,140030,54,47,306,407,45
Cleveland,President,Donald Trump,REP,140032,27,48,514,589,
Cleveland,President,Gary Johnson,LIB,140032,9,8,139,156,
Cleveland,President,Hillary Clinton,DEM,140032,84,112,819,1015,
Cleveland,U.S. Senate,James Lankford,REP,140032,37,54,569,660,
Cleveland,U.S. Senate,Robert Murphy,LIB,140032,7,7,89,103,
Cleveland,U.S. Senate,Mike Workman,DEM,140032,62,75,593,730,
Cleveland,U.S. Senate,Mark Beard,IND,140032,2,4,37,43,
Cleveland,U.S. Senate,Sean Braddy,IND,140032,13,29,181,223,
Cleveland,U.S. House,Tom Cole,REP,140032,35,60,599,694,04
Cleveland,U.S. House,Sevier White,LIB,140032,3,7,88,98,04
Cleveland,U.S. House,Christina Owen,DEM,140032,82,103,778,963,04
Cleveland,State House,Marc Etters,REP,140032,25,45,536,606,45
Cleveland,State House,Claudia Griffith,DEM,140032,93,123,907,1123,45
Cleveland,President,Donald Trump,REP,140034,57,50,1178,1285,
Cleveland,President,Gary Johnson,LIB,140034,6,1,76,83,
Cleveland,President,Hillary Clinton,DEM,140034,30,12,294,336,
Cleveland,U.S. Senate,James Lankford,REP,140034,60,48,1193,1301,
Cleveland,U.S. Senate,Robert Murphy,LIB,140034,0,1,42,43,
Cleveland,U.S. Senate,Mike Workman,DEM,140034,26,9,255,290,
Cleveland,U.S. Senate,Mark Beard,IND,140034,2,2,21,25,
Cleveland,U.S. Senate,Sean Braddy,IND,140034,5,3,42,50,
Cleveland,U.S. House,Tom Cole,REP,140034,61,47,1208,1316,04
Cleveland,U.S. House,Sevier White,LIB,140034,0,3,60,63,04
Cleveland,U.S. House,Christina Owen,DEM,140034,33,13,282,328,04
Cleveland,State House,Bobby Cleveland,REP,140034,54,49,1106,1209,20
Cleveland,State House,Matt Failing,DEM,140034,39,14,438,491,20
Cleveland,President,Donald Trump,REP,140035,57,39,424,520,
Cleveland,President,Gary Johnson,LIB,140035,7,5,59,71,
Cleveland,President,Hillary Clinton,DEM,140035,62,42,324,428,
Cleveland,U.S. Senate,James Lankford,REP,140035,62,47,486,595,
Cleveland,U.S. Senate,Robert Murphy,LIB,140035,1,0,30,31,
Cleveland,U.S. Senate,Mike Workman,DEM,140035,51,32,237,320,
Cleveland,U.S. Senate,Mark Beard,IND,140035,2,2,10,14,
Cleveland,U.S. Senate,Sean Braddy,IND,140035,6,6,43,55,
Cleveland,U.S. House,Tom Cole,REP,140035,63,48,507,618,04
Cleveland,U.S. House,Sevier White,LIB,140035,3,3,40,46,04
Cleveland,U.S. House,Christina Owen,DEM,140035,55,35,259,349,04
Cleveland,State Senate,Rob Standridge,REP,140035,71,47,442,560,15
Cleveland,State Senate,Shawn Sheehan,IND,140035,44,36,325,405,15
Cleveland,State House,Scott Martin,REP,140035,73,49,517,639,46
Cleveland,State House,Jacob Rosecrants,DEM,140035,49,35,284,368,46
Cleveland,President,Donald Trump,REP,140036,96,72,702,870,
Cleveland,President,Gary Johnson,LIB,140036,4,3,46,53,
Cleveland,President,Hillary Clinton,DEM,140036,34,20,168,222,
Cleveland,U.S. Senate,James Lankford,REP,140036,93,80,717,890,
Cleveland,U.S. Senate,Robert Murphy,LIB,140036,4,1,28,33,
Cleveland,U.S. Senate,Mike Workman,DEM,140036,28,12,127,167,
Cleveland,U.S. Senate,Mark Beard,IND,140036,1,1,19,21,
Cleveland,U.S. Senate,Sean Braddy,IND,140036,8,4,25,37,
Cleveland,U.S. House,Tom Cole,REP,140036,94,78,693,865,04
Cleveland,U.S. House,Sevier White,LIB,140036,2,2,55,59,04
Cleveland,U.S. House,Christina Owen,DEM,140036,37,18,165,220,04
Cleveland,State Senate,Rob Standridge,REP,140036,93,74,665,832,15
Cleveland,State Senate,Shawn Sheehan,IND,140036,26,20,224,270,15
Cleveland,State House,Josh Cockroft,REP,140036,93,76,702,871,27
Cleveland,State House,John Karlin,DEM,140036,39,21,199,259,27
Cleveland,President,Donald Trump,REP,140037,71,77,654,802,
Cleveland,President,Gary Johnson,LIB,140037,8,11,90,109,
Cleveland,President,Hillary Clinton,DEM,140037,26,45,284,355,
Cleveland,U.S. Senate,James Lankford,REP,140037,69,77,681,827,
Cleveland,U.S. Senate,Robert Murphy,LIB,140037,8,6,47,61,
Cleveland,U.S. Senate,Mike Workman,DEM,140037,18,45,228,291,
Cleveland,U.S. Senate,Mark Beard,IND,140037,2,1,23,26,
Cleveland,U.S. Senate,Sean Braddy,IND,140037,3,5,50,58,
Cleveland,U.S. House,Tom Cole,REP,140037,73,78,685,836,04
Cleveland,U.S. House,Sevier White,LIB,140037,7,9,69,85,04
Cleveland,U.S. House,Christina Owen,DEM,140037,20,47,273,340,04
Cleveland,State Senate,Rob Standridge,REP,140037,65,72,658,795,15
Cleveland,State Senate,Shawn Sheehan,IND,140037,27,50,317,394,15
Cleveland,State House,Kevin West,REP,140037,63,70,617,750,54
Cleveland,State House,Mary Newcome-Hatch,DEM,140037,26,46,241,313,54
Cleveland,State House,Elizabeth Larios,IND,140037,10,17,157,184,54
Cleveland,President,Donald Trump,REP,140038,26,34,722,782,
Cleveland,President,Gary Johnson,LIB,140038,2,0,71,73,
Cleveland,President,Hillary Clinton,DEM,140038,23,14,229,266,
Cleveland,U.S. Senate,James Lankford,REP,140038,25,31,715,771,
Cleveland,U.S. Senate,Robert Murphy,LIB,140038,0,0,36,36,
Cleveland,U.S. Senate,Mike Workman,DEM,140038,20,11,178,209,
Cleveland,U.S. Senate,Mark Beard,IND,140038,0,4,26,30,
Cleveland,U.S. Senate,Sean Braddy,IND,140038,9,2,59,70,
Cleveland,U.S. House,Tom Cole,REP,140038,26,29,709,764,04
Cleveland,U.S. House,Sevier White,LIB,140038,2,4,69,75,04
Cleveland,U.S. House,Christina Owen,DEM,140038,26,15,237,278,04
Cleveland,State Senate,Rob Standridge,REP,140038,30,31,700,761,15
Cleveland,State Senate,Shawn Sheehan,IND,140038,18,17,266,301,15
Cleveland,State House,Bobby Cleveland,REP,140038,23,31,676,730,20
Cleveland,State House,Matt Failing,DEM,140038,29,17,325,371,20
Cleveland,President,Donald Trump,REP,140039,63,73,457,593,
Cleveland,President,Gary Johnson,LIB,140039,10,14,92,116,
Cleveland,President,Hillary Clinton,DEM,140039,69,63,433,565,
Cleveland,U.S. Senate,James Lankford,REP,140039,75,82,513,670,
Cleveland,U.S. Senate,Robert Murphy,LIB,140039,9,5,38,52,
Cleveland,U.S. Senate,Mike Workman,DEM,140039,48,43,349,440,
Cleveland,U.S. Senate,Mark Beard,IND,140039,3,7,20,30,
Cleveland,U.S. Senate,Sean Braddy,IND,140039,7,13,71,91,
Cleveland,U.S. House,Tom Cole,REP,140039,78,82,537,697,04
Cleveland,U.S. House,Sevier White,LIB,140039,13,6,49,68,04
Cleveland,U.S. House,Christina Owen,DEM,140039,49,60,405,514,04
Cleveland,State Senate,Rob Standridge,REP,140039,67,78,470,615,15
Cleveland,State Senate,Shawn Sheehan,IND,140039,60,57,452,569,15
Cleveland,State House,Scott Martin,REP,140039,71,84,524,679,46
Cleveland,State House,Jacob Rosecrants,DEM,140039,68,62,447,577,46
Cleveland,President,Donald Trump,REP,140040,92,127,675,894,
Cleveland,President,Gary Johnson,LIB,140040,5,7,88,100,
Cleveland,President,Hillary Clinton,DEM,140040,56,74,404,534,
Cleveland,U.S. Senate,James Lankford,REP,140040,111,137,741,989,
Cleveland,U.S. Senate,Robert Murphy,LIB,140040,3,6,46,55,
Cleveland,U.S. Senate,Mike Workman,DEM,140040,33,56,298,387,
Cleveland,U.S. Senate,Mark Beard,IND,140040,1,2,23,26,
Cleveland,U.S. Senate,Sean Braddy,IND,140040,8,8,47,63,
Cleveland,U.S. House,Tom Cole,REP,140040,108,135,751,994,04
Cleveland,U.S. House,Sevier White,LIB,140040,4,7,63,74,04
Cleveland,U.S. House,Christina Owen,DEM,140040,45,65,339,449,04
Cleveland,State House,Chris Kannady,REP,140040,109,141,757,1007,91
Cleveland,State House,Trey Puckett,DEM,140040,44,65,383,492,91
Cleveland,President,Donald Trump,REP,140041,23,33,326,382,
Cleveland,President,Gary Johnson,LIB,140041,3,3,53,59,
Cleveland,President,Hillary Clinton,DEM,140041,9,19,190,218,
Cleveland,U.S. Senate,James Lankford,REP,140041,24,33,352,409,
Cleveland,U.S. Senate,Robert Murphy,LIB,140041,3,3,19,25,
Cleveland,U.S. Senate,Mike Workman,DEM,140041,7,17,144,168,
Cleveland,U.S. Senate,Mark Beard,IND,140041,0,1,20,21,
Cleveland,U.S. Senate,Sean Braddy,IND,140041,0,1,28,29,
Cleveland,U.S. House,Tom Cole,REP,140041,26,33,350,409,04
Cleveland,U.S. House,Sevier White,LIB,140041,2,3,29,34,04
Cleveland,U.S. House,Christina Owen,DEM,140041,6,19,182,207,04
Cleveland,State House,Chris Kannady,REP,140041,24,38,343,405,91
Cleveland,State House,Trey Puckett,DEM,140041,10,17,208,235,91
Cleveland,President,Donald Trump,REP,140042,38,26,209,273,
Cleveland,President,Gary Johnson,LIB,140042,7,4,48,59,
Cleveland,President,Hillary Clinton,DEM,140042,66,53,388,507,
Cleveland,U.S. Senate,James Lankford,REP,140042,53,30,262,345,
Cleveland,U.S. Senate,Robert Murphy,LIB,140042,2,3,19,24,
Cleveland,U.S. Senate,Mike Workman,DEM,140042,47,39,287,373,
Cleveland,U.S. Senate,Mark Beard,IND,140042,3,1,17,21,
Cleveland,U.S. Senate,Sean Braddy,IND,140042,9,10,70,89,
Cleveland,U.S. House,Tom Cole,REP,140042,63,34,300,397,04
Cleveland,U.S. House,Sevier White,LIB,140042,0,5,18,23,04
Cleveland,U.S. House,Christina Owen,DEM,140042,52,44,340,436,04
Cleveland,President,Donald Trump,REP,140043,98,172,926,1196,
Cleveland,President,Gary Johnson,LIB,140043,10,17,112,139,
Cleveland,President,Hillary Clinton,DEM,140043,42,105,410,557,
Cleveland,U.S. Senate,James Lankford,REP,140043,111,183,1017,1311,
Cleveland,U.S. Senate,Robert Murphy,LIB,140043,4,11,54,69,
Cleveland,U.S. Senate,Mike Workman,DEM,140043,29,75,301,405,
Cleveland,U.S. Senate,Mark Beard,IND,140043,0,9,31,40,
Cleveland,U.S. Senate,Sean Braddy,IND,140043,7,16,50,73,
Cleveland,U.S. House,Tom Cole,REP,140043,108,177,1013,1298,04
Cleveland,U.S. House,Sevier White,LIB,140043,5,16,82,103,04
Cleveland,U.S. House,Christina Owen,DEM,140043,39,101,356,496,04
Cleveland,President,Donald Trump,REP,140044,110,148,944,1202,
Cleveland,President,Gary Johnson,LIB,140044,17,14,136,167,
Cleveland,President,Hillary Clinton,DEM,140044,74,74,378,526,
Cleveland,U.S. Senate,James Lankford,REP,140044,127,156,1006,1289,
Cleveland,U.S. Senate,Robert Murphy,LIB,140044,5,9,52,66,
Cleveland,U.S. Senate,Mike Workman,DEM,140044,55,65,297,417,
Cleveland,U.S. Senate,Mark Beard,IND,140044,3,4,41,48,
Cleveland,U.S. Senate,Sean Braddy,IND,140044,8,6,62,76,
Cleveland,U.S. House,Tom Cole,REP,140044,130,148,1006,1284,04
Cleveland,U.S. House,Sevier White,LIB,140044,3,13,86,102,04
Cleveland,U.S. House,Christina Owen,DEM,140044,65,76,361,502,04
Cleveland,President,Donald Trump,REP,140045,23,16,339,378,
Cleveland,President,Gary Johnson,LIB,140045,4,0,26,30,
Cleveland,President,Hillary Clinton,DEM,140045,11,9,157,177,
Cleveland,U.S. Senate,James Lankford,REP,140045,25,18,337,380,
Cleveland,U.S. Senate,Robert Murphy,LIB,140045,0,0,18,18,
Cleveland,U.S. Senate,Mike Workman,DEM,140045,8,7,122,137,
Cleveland,U.S. Senate,Mark Beard,IND,140045,0,0,12,12,
Cleveland,U.S. Senate,Sean Braddy,IND,140045,4,1,31,36,
Cleveland,U.S. House,Tom Cole,REP,140045,25,14,335,374,04
Cleveland,U.S. House,Sevier White,LIB,140045,2,3,28,33,04
Cleveland,U.S. House,Christina Owen,DEM,140045,10,9,158,177,04
Cleveland,State Senate,Rob Standridge,REP,140045,22,17,333,372,15
Cleveland,State Senate,Shawn Sheehan,IND,140045,9,8,150,167,15
Cleveland,State House,Bobby Cleveland,REP,140045,22,15,306,343,20
Cleveland,State House,Matt Failing,DEM,140045,12,11,208,231,20
Cleveland,President,Donald Trump,REP,140047,54,62,743,859,
Cleveland,President,Gary Johnson,LIB,140047,9,5,114,128,
Cleveland,President,Hillary Clinton,DEM,140047,34,34,345,413,
Cleveland,U.S. Senate,James Lankford,REP,140047,58,61,759,878,
Cleveland,U.S. Senate,Robert Murphy,LIB,140047,6,5,48,59,
Cleveland,U.S. Senate,Mike Workman,DEM,140047,26,31,289,346,
Cleveland,U.S. Senate,Mark Beard,IND,140047,1,3,32,36,
Cleveland,U.S. Senate,Sean Braddy,IND,140047,5,1,71,77,
Cleveland,U.S. House,Tom Cole,REP,140047,56,63,764,883,04
Cleveland,U.S. House,Sevier White,LIB,140047,4,6,85,95,04
Cleveland,U.S. House,Christina Owen,DEM,140047,36,32,343,411,04
Cleveland,State House,Kevin West,REP,140047,45,56,652,753,54
Cleveland,State House,Mary Newcome-Hatch,DEM,140047,29,32,287,348,54
Cleveland,State House,Elizabeth Larios,IND,140047,19,12,251,282,54
Cleveland,President,Donald Trump,REP,140048,46,62,553,661,
Cleveland,President,Gary Johnson,LIB,140048,3,5,98,106,
Cleveland,President,Hillary Clinton,DEM,140048,25,42,232,299,
Cleveland,U.S. Senate,James Lankford,REP,140048,50,66,569,685,
Cleveland,U.S. Senate,Robert Murphy,LIB,140048,0,5,54,59,
Cleveland,U.S. Senate,Mike Workman,DEM,140048,22,29,185,236,
Cleveland,U.S. Senate,Mark Beard,IND,140048,2,4,28,34,
Cleveland,U.S. Senate,Sean Braddy,IND,140048,1,5,42,48,
Cleveland,U.S. House,Tom Cole,REP,140048,49,69,584,702,04
Cleveland,U.S. House,Sevier White,LIB,140048,2,6,70,78,04
Cleveland,U.S. House,Christina Owen,DEM,140048,24,34,225,283,04
Cleveland,President,Donald Trump,REP,140049,23,18,488,529,
Cleveland,President,Gary Johnson,LIB,140049,2,0,49,51,
Cleveland,President,Hillary Clinton,DEM,140049,13,14,182,209,
Cleveland,U.S. Senate,James Lankford,REP,140049,19,14,507,540,
Cleveland,U.S. Senate,Robert Murphy,LIB,140049,1,0,24,25,
Cleveland,U.S. Senate,Mike Workman,DEM,140049,11,17,148,176,
Cleveland,U.S. Senate,Mark Beard,IND,140049,0,3,12,15,
Cleveland,U.S. Senate,Sean Braddy,IND,140049,5,0,27,32,
Cleveland,U.S. House,Tom Cole,REP,140049,21,15,516,552,04
Cleveland,U.S. House,Sevier White,LIB,140049,1,1,33,35,04
Cleveland,U.S. House,Christina Owen,DEM,140049,14,18,168,200,04
Cleveland,State Senate,Rob Standridge,REP,140049,15,16,476,507,15
Cleveland,State Senate,Shawn Sheehan,IND,140049,17,16,187,220,15
Cleveland,State House,Josh Cockroft,REP,140049,17,17,503,537,27
Cleveland,State House,John Karlin,DEM,140049,18,15,205,238,27
Cleveland,President,Donald Trump,REP,140050,95,153,878,1126,
Cleveland,President,Gary Johnson,LIB,140050,7,11,108,126,
Cleveland,President,Hillary Clinton,DEM,140050,54,79,472,605,
Cleveland,U.S. Senate,James Lankford,REP,140050,101,167,957,1225,
Cleveland,U.S. Senate,Robert Murphy,LIB,140050,1,5,43,49,
Cleveland,U.S. Senate,Mike Workman,DEM,140050,46,63,360,469,
Cleveland,U.S. Senate,Mark Beard,IND,140050,3,3,38,44,
Cleveland,U.S. Senate,Sean Braddy,IND,140050,2,7,56,65,
Cleveland,U.S. House,Tom Cole,REP,140050,105,162,955,1222,04
Cleveland,U.S. House,Sevier White,LIB,140050,2,6,69,77,04
Cleveland,U.S. House,Christina Owen,DEM,140050,47,76,427,550,04
Cleveland,State House,Chris Kannady,REP,140050,102,161,935,1198,91
Cleveland,State House,Trey Puckett,DEM,140050,47,81,492,620,91
Cleveland,President,Donald Trump,REP,140051,31,28,259,318,
Cleveland,President,Gary Johnson,LIB,140051,2,7,55,64,
Cleveland,President,Hillary Clinton,DEM,140051,30,46,342,418,
Cleveland,U.S. Senate,James Lankford,REP,140051,42,36,268,346,
Cleveland,U.S. Senate,Robert Murphy,LIB,140051,1,4,31,36,
Cleveland,U.S. Senate,Mike Workman,DEM,140051,18,30,270,318,
Cleveland,U.S. Senate,Mark Beard,IND,140051,0,1,19,20,
Cleveland,U.S. Senate,Sean Braddy,IND,140051,7,8,69,84,
Cleveland,U.S. House,Tom Cole,REP,140051,42,42,314,398,04
Cleveland,U.S. House,Sevier White,LIB,140051,1,2,34,37,04
Cleveland,U.S. House,Christina Owen,DEM,140051,24,36,306,366,04
Cleveland,President,Donald Trump,REP,140053,163,151,872,1186,
Cleveland,President,Gary Johnson,LIB,140053,17,10,128,155,
Cleveland,President,Hillary Clinton,DEM,140053,181,167,785,1133,
Cleveland,U.S. Senate,James Lankford,REP,140053,200,161,991,1352,
Cleveland,U.S. Senate,Robert Murphy,LIB,140053,9,9,62,80,
Cleveland,U.S. Senate,Mike Workman,DEM,140053,133,139,554,826,
Cleveland,U.S. Senate,Mark Beard,IND,140053,1,6,33,40,
Cleveland,U.S. Senate,Sean Braddy,IND,140053,18,13,144,175,
Cleveland,U.S. House,Tom Cole,REP,140053,208,163,1054,1425,04
Cleveland,U.S. House,Sevier White,LIB,140053,7,13,78,98,04
Cleveland,U.S. House,Christina Owen,DEM,140053,147,151,644,942,04
Cleveland,State Senate,Rob Standridge,REP,140053,189,175,954,1318,15
Cleveland,State Senate,Shawn Sheehan,IND,140053,146,122,706,974,15
Cleveland,State House,Scott Martin,REP,140053,202,177,1038,1417,46
Cleveland,State House,Jacob Rosecrants,DEM,140053,156,148,720,1024,46
Cleveland,President,Donald Trump,REP,140054,29,49,508,586,
Cleveland,President,Gary Johnson,LIB,140054,1,5,88,94,
Cleveland,President,Hillary Clinton,DEM,140054,16,21,246,283,
Cleveland,U.S. Senate,James Lankford,REP,140054,32,47,528,607,
Cleveland,U.S. Senate,Robert Murphy,LIB,140054,2,3,48,53,
Cleveland,U.S. Senate,Mike Workman,DEM,140054,12,18,191,221,
Cleveland,U.S. Senate,Mark Beard,IND,140054,0,2,28,30,
Cleveland,U.S. Senate,Sean Braddy,IND,140054,0,4,46,50,
Cleveland,U.S. House,Tom Cole,REP,140054,31,48,529,608,04
Cleveland,U.S. House,Sevier White,LIB,140054,1,4,64,69,04
Cleveland,U.S. House,Christina Owen,DEM,140054,14,23,240,277,04
Cleveland,State House,Kevin West,REP,140054,27,47,468,542,54
Cleveland,State House,Mary Newcome-Hatch,DEM,140054,13,16,215,244,54
Cleveland,State House,Elizabeth Larios,IND,140054,6,9,146,161,54
Cleveland,President,Donald Trump,REP,140055,190,328,1117,1635,
Cleveland,President,Gary Johnson,LIB,140055,35,39,215,289,
Cleveland,President,Hillary Clinton,DEM,140055,201,316,896,1413,
Cleveland,U.S. Senate,James Lankford,REP,140055,238,370,1293,1901,
Cleveland,U.S. Senate,Robert Murphy,LIB,140055,13,14,99,126,
Cleveland,U.S. Senate,Mike Workman,DEM,140055,154,230,631,1015,
Cleveland,U.S. Senate,Mark Beard,IND,140055,6,13,43,62,
Cleveland,U.S. Senate,Sean Braddy,IND,140055,21,65,174,260,
Cleveland,U.S. House,Tom Cole,REP,140055,243,383,1302,1928,04
Cleveland,U.S. House,Sevier White,LIB,140055,17,20,140,177,04
Cleveland,U.S. House,Christina Owen,DEM,140055,173,288,796,1257,04
Cleveland,State Senate,Rob Standridge,REP,140055,224,359,1164,1747,15
Cleveland,State Senate,Shawn Sheehan,IND,140055,171,288,969,1428,15
Cleveland,State House,Marc Etters,REP,140055,202,334,1211,1747,45
Cleveland,State House,Claudia Griffith,DEM,140055,223,351,997,1571,45
Cleveland,President,Donald Trump,REP,140056,79,83,457,619,
Cleveland,President,Gary Johnson,LIB,140056,20,10,86,116,
Cleveland,President,Hillary Clinton,DEM,140056,163,123,500,786,
Cleveland,U.S. Senate,James Lankford,REP,140056,107,99,520,726,
Cleveland,U.S. Senate,Robert Murphy,LIB,140056,8,4,42,54,
Cleveland,U.S. Senate,Mike Workman,DEM,140056,136,97,365,598,
Cleveland,U.S. Senate,Mark Beard,IND,140056,2,2,27,31,
Cleveland,U.S. Senate,Sean Braddy,IND,140056,12,17,92,121,
Cleveland,U.S. House,Tom Cole,REP,140056,112,102,529,743,04
Cleveland,U.S. House,Sevier White,LIB,140056,15,7,59,81,04
Cleveland,U.S. House,Christina Owen,DEM,140056,139,109,455,703,04
Cleveland,President,Donald Trump,REP,140057,92,94,1097,1283,
Cleveland,President,Gary Johnson,LIB,140057,7,6,119,132,
Cleveland,President,Hillary Clinton,DEM,140057,45,42,462,549,
Cleveland,U.S. Senate,James Lankford,REP,140057,97,95,1149,1341,
Cleveland,U.S. Senate,Robert Murphy,LIB,140057,3,2,48,53,
Cleveland,U.S. Senate,Mike Workman,DEM,140057,35,31,344,410,
Cleveland,U.S. Senate,Mark Beard,IND,140057,3,4,38,45,
Cleveland,U.S. Senate,Sean Braddy,IND,140057,7,10,92,109,
Cleveland,U.S. House,Tom Cole,REP,140057,97,95,1154,1346,04
Cleveland,U.S. House,Sevier White,LIB,140057,6,7,88,101,04
Cleveland,U.S. House,Christina Owen,DEM,140057,40,39,425,504,04
Cleveland,State House,Scott Martin,REP,140057,84,87,1086,1257,46
Cleveland,State House,Jacob Rosecrants,DEM,140057,54,54,556,664,46
Cleveland,President,Donald Trump,REP,140058,90,83,744,917,
Cleveland,President,Gary Johnson,LIB,140058,9,7,112,128,
Cleveland,President,Hillary Clinton,DEM,140058,38,35,286,359,
Cleveland,U.S. Senate,James Lankford,REP,140058,95,88,790,973,
Cleveland,U.S. Senate,Robert Murphy,LIB,140058,0,2,44,46,
Cleveland,U.S. Senate,Mike Workman,DEM,140058,38,29,225,292,
Cleveland,U.S. Senate,Mark Beard,IND,140058,2,1,37,40,
Cleveland,U.S. Senate,Sean Braddy,IND,140058,2,4,41,47,
Cleveland,U.S. House,Tom Cole,REP,140058,101,84,797,982,04
Cleveland,U.S. House,Sevier White,LIB,140058,2,6,67,75,04
Cleveland,U.S. House,Christina Owen,DEM,140058,34,34,276,344,04
Cleveland,State House,Kevin West,REP,140058,82,75,672,829,54
Cleveland,State House,Mary Newcome-Hatch,DEM,140058,39,31,262,332,54
Cleveland,State House,Elizabeth Larios,IND,140058,17,17,192,226,54
Cleveland,President,Donald Trump,REP,140059,17,15,189,221,
Cleveland,President,Gary Johnson,LIB,140059,3,2,24,29,
Cleveland,President,Hillary Clinton,DEM,140059,22,24,172,218,
Cleveland,U.S. Senate,James Lankford,REP,140059,19,16,207,242,
Cleveland,U.S. Senate,Robert Murphy,LIB,140059,0,3,17,20,
Cleveland,U.S. Senate,Mike Workman,DEM,140059,17,17,121,155,
Cleveland,U.S. Senate,Mark Beard,IND,140059,1,0,7,8,
Cleveland,U.S. Senate,Sean Braddy,IND,140059,5,4,33,42,
Cleveland,U.S. House,Tom Cole,REP,140059,20,16,211,247,04
Cleveland,U.S. House,Sevier White,LIB,140059,2,2,17,21,04
Cleveland,U.S. House,Christina Owen,DEM,140059,19,22,158,199,04
Cleveland,State House,Scott Martin,REP,140059,19,17,212,248,46
Cleveland,State House,Jacob Rosecrants,DEM,140059,21,23,171,215,46
Cleveland,President,Donald Trump,REP,140060,193,227,1095,1515,
Cleveland,President,Gary Johnson,LIB,140060,10,12,126,148,
Cleveland,President,Hillary Clinton,DEM,140060,72,99,418,589,
Cleveland,U.S. Senate,James Lankford,REP,140060,202,236,1159,1597,
Cleveland,U.S. Senate,Robert Murphy,LIB,140060,10,4,51,65,
Cleveland,U.S. Senate,Mike Workman,DEM,140060,59,78,332,469,
Cleveland,U.S. Senate,Mark Beard,IND,140060,2,8,36,46,
Cleveland,U.S. Senate,Sean Braddy,IND,140060,6,16,60,82,
Cleveland,U.S. House,Tom Cole,REP,140060,200,241,1166,1607,04
Cleveland,U.S. House,Sevier White,LIB,140060,13,15,89,117,04
Cleveland,U.S. House,Christina Owen,DEM,140060,64,85,387,536,04
Cleveland,State House,Kevin West,REP,140060,188,225,1044,1457,54
Cleveland,State House,Mary Newcome-Hatch,DEM,140060,63,80,340,483,54
Cleveland,State House,Elizabeth Larios,IND,140060,24,31,229,284,54
Cleveland,President,Donald Trump,REP,140061,302,208,782,1292,
Cleveland,President,Gary Johnson,LIB,140061,19,8,75,102,
Cleveland,President,Hillary Clinton,DEM,140061,91,91,269,451,
Cleveland,U.S. Senate,James Lankford,REP,140061,319,222,843,1384,
Cleveland,U.S. Senate,Robert Murphy,LIB,140061,5,4,34,43,
Cleveland,U.S. Senate,Mike Workman,DEM,140061,72,75,193,340,
Cleveland,U.S. Senate,Mark Beard,IND,140061,7,7,23,37,
Cleveland,U.S. Senate,Sean Braddy,IND,140061,12,4,32,48,
Cleveland,U.S. House,Tom Cole,REP,140061,322,219,824,1365,04
Cleveland,U.S. House,Sevier White,LIB,140061,10,13,61,84,04
Cleveland,U.S. House,Christina Owen,DEM,140061,81,81,232,394,04
Cleveland,State House,Chris Kannady,REP,140061,315,210,829,1354,91
Cleveland,State House,Trey Puckett,DEM,140061,88,96,276,460,91
Cleveland,President,Donald Trump,REP,140063,59,52,367,478,
Cleveland,President,Gary Johnson,LIB,140063,5,3,44,52,
Cleveland,President,Hillary Clinton,DEM,140063,23,23,128,174,
Cleveland,U.S. Senate,James Lankford,REP,140063,70,57,400,527,
Cleveland,U.S. Senate,Robert Murphy,LIB,140063,1,1,17,19,
Cleveland,U.S. Senate,Mike Workman,DEM,140063,13,14,90,117,
Cleveland,U.S. Senate,Mark Beard,IND,140063,0,1,10,11,
Cleveland,U.S. Senate,Sean Braddy,IND,140063,3,3,18,24,
Cleveland,U.S. House,Tom Cole,REP,140063,65,57,395,517,04
Cleveland,U.S. House,Sevier White,LIB,140063,0,2,27,29,04
Cleveland,U.S. House,Christina Owen,DEM,140063,21,17,110,148,04
Cleveland,State Senate,Rob Standridge,REP,140063,63,55,382,500,15
Cleveland,State Senate,Shawn Sheehan,IND,140063,13,17,132,162,15
Cleveland,State House,Josh Cockroft,REP,140063,65,58,387,510,27
Cleveland,State House,John Karlin,DEM,140063,17,17,139,173,27
Cleveland,President,Donald Trump,REP,140064,147,83,923,1153,
Cleveland,President,Gary Johnson,LIB,140064,3,3,58,64,
Cleveland,President,Hillary Clinton,DEM,140064,38,19,206,263,
Cleveland,U.S. Senate,James Lankford,REP,140064,145,88,936,1169,
Cleveland,U.S. Senate,Robert Murphy,LIB,140064,1,0,41,42,
Cleveland,U.S. Senate,Mike Workman,DEM,140064,34,17,154,205,
Cleveland,U.S. Senate,Mark Beard,IND,140064,3,0,22,25,
Cleveland,U.S. Senate,Sean Braddy,IND,140064,3,1,31,35,
Cleveland,U.S. House,Tom Cole,REP,140064,142,83,924,1149,04
Cleveland,U.S. House,Sevier White,LIB,140064,7,3,66,76,04
Cleveland,U.S. House,Christina Owen,DEM,140064,39,20,194,253,04
Cleveland,State Senate,Rob Standridge,REP,140064,130,79,872,1081,15
Cleveland,State Senate,Shawn Sheehan,IND,140064,45,21,256,322,15
Cleveland,State House,Josh Cockroft,REP,140064,137,82,922,1141,27
Cleveland,State House,John Karlin,DEM,140064,49,22,247,318,27
Cleveland,President,Donald Trump,REP,140065,32,14,558,604,
Cleveland,President,Gary Johnson,LIB,140065,4,1,44,49,
Cleveland,President,Hillary Clinton,DEM,140065,8,10,175,193,
Cleveland,U.S. Senate,James Lankford,REP,140065,33,13,546,592,
Cleveland,U.S. Senate,Robert Murphy,LIB,140065,2,2,31,35,
Cleveland,U.S. Senate,Mike Workman,DEM,140065,6,6,146,158,
Cleveland,U.S. Senate,Mark Beard,IND,140065,2,0,24,26,
Cleveland,U.S. Senate,Sean Braddy,IND,140065,1,4,26,31,
Cleveland,U.S. House,Tom Cole,REP,140065,34,14,544,592,04
Cleveland,U.S. House,Sevier White,LIB,140065,2,2,36,40,04
Cleveland,U.S. House,Christina Owen,DEM,140065,8,9,192,209,04
Cleveland,State Senate,Rob Standridge,REP,140065,31,11,519,561,15
Cleveland,State Senate,Shawn Sheehan,IND,140065,10,13,216,239,15
Cleveland,State House,Josh Cockroft,REP,140065,34,13,539,586,27
Cleveland,State House,John Karlin,DEM,140065,9,12,229,250,27
Cleveland,President,Donald Trump,REP,140067,38,47,457,542,
Cleveland,President,Gary Johnson,LIB,140067,7,10,91,108,
Cleveland,President,Hillary Clinton,DEM,140067,42,59,358,459,
Cleveland,U.S. Senate,James Lankford,REP,140067,46,53,521,620,
Cleveland,U.S. Senate,Robert Murphy,LIB,140067,2,7,34,43,
Cleveland,U.S. Senate,Mike Workman,DEM,140067,33,42,266,341,
Cleveland,U.S. Senate,Mark Beard,IND,140067,0,2,22,24,
Cleveland,U.S. Senate,Sean Braddy,IND,140067,4,11,76,91,
Cleveland,U.S. House,Tom Cole,REP,140067,46,62,531,639,04
Cleveland,U.S. House,Sevier White,LIB,140067,3,4,50,57,04
Cleveland,U.S. House,Christina Owen,DEM,140067,34,49,335,418,04
Cleveland,State House,Scott Martin,REP,140067,44,57,555,656,46
Cleveland,State House,Jacob Rosecrants,DEM,140067,39,57,352,448,46
Cleveland,President,Donald Trump,REP,140068,30,31,544,605,
Cleveland,President,Gary Johnson,LIB,140068,3,6,90,99,
Cleveland,President,Hillary Clinton,DEM,140068,35,61,460,556,
Cleveland,U.S. Senate,James Lankford,REP,140068,40,39,590,669,
Cleveland,U.S. Senate,Robert Murphy,LIB,140068,1,2,44,47,
Cleveland,U.S. Senate,Mike Workman,DEM,140068,24,45,353,422,
Cleveland,U.S. Senate,Mark Beard,IND,140068,0,2,24,26,
Cleveland,U.S. Senate,Sean Braddy,IND,140068,4,9,84,97,
Cleveland,U.S. House,Tom Cole,REP,140068,38,42,609,689,04
Cleveland,U.S. House,Sevier White,LIB,140068,3,5,68,76,04
Cleveland,U.S. House,Christina Owen,DEM,140068,30,50,418,498,04
Cleveland,State House,Scott Martin,REP,140068,39,41,631,711,46
Cleveland,State House,Jacob Rosecrants,DEM,140068,30,53,456,539,46
Cleveland,President,Donald Trump,REP,140069,116,156,961,1233,
Cleveland,President,Gary Johnson,LIB,140069,4,10,113,127,
Cleveland,President,Hillary Clinton,DEM,140069,39,96,472,607,
Cleveland,U.S. Senate,James Lankford,REP,140069,119,166,1027,1312,
Cleveland,U.S. Senate,Robert Murphy,LIB,140069,3,6,58,67,
Cleveland,U.S. Senate,Mike Workman,DEM,140069,33,80,359,472,
Cleveland,U.S. Senate,Mark Beard,IND,140069,2,4,41,47,
Cleveland,U.S. Senate,Sean Braddy,IND,140069,2,9,49,60,
Cleveland,U.S. House,Tom Cole,REP,140069,115,165,1014,1294,04
Cleveland,U.S. House,Sevier White,LIB,140069,6,7,87,100,04
Cleveland,U.S. House,Christina Owen,DEM,140069,37,93,424,554,04
Cleveland,State House,Chris Kannady,REP,140069,116,167,1029,1312,91
Cleveland,State House,Trey Puckett,DEM,140069,41,96,478,615,91
Cleveland,President,Donald Trump,REP,140070,99,131,825,1055,
Cleveland,President,Gary Johnson,LIB,140070,15,7,122,144,
Cleveland,President,Hillary Clinton,DEM,140070,32,64,353,449,
Cleveland,U.S. Senate,James Lankford,REP,140070,108,128,877,1113,
Cleveland,U.S. Senate,Robert Murphy,LIB,140070,5,6,68,79,
Cleveland,U.S. Senate,Mike Workman,DEM,140070,27,56,283,366,
Cleveland,U.S. Senate,Mark Beard,IND,140070,0,4,25,29,
Cleveland,U.S. Senate,Sean Braddy,IND,140070,7,7,49,63,
Cleveland,U.S. House,Tom Cole,REP,140070,110,134,887,1131,04
Cleveland,U.S. House,Sevier White,LIB,140070,8,5,82,95,04
Cleveland,U.S. House,Christina Owen,DEM,140070,28,64,335,427,04
Cleveland,President,Donald Trump,REP,140071,57,42,261,360,
Cleveland,President,Gary Johnson,LIB,140071,2,4,35,41,
Cleveland,President,Hillary Clinton,DEM,140071,44,52,261,357,
Cleveland,U.S. Senate,James Lankford,REP,140071,59,46,289,394,
Cleveland,U.S. Senate,Robert Murphy,LIB,140071,0,2,18,20,
Cleveland,U.S. Senate,Mike Workman,DEM,140071,43,41,191,275,
Cleveland,U.S. Senate,Mark Beard,IND,140071,1,1,8,10,
Cleveland,U.S. Senate,Sean Braddy,IND,140071,2,8,44,54,
Cleveland,U.S. House,Tom Cole,REP,140071,59,48,297,404,04
Cleveland,U.S. House,Sevier White,LIB,140071,1,4,26,31,04
Cleveland,U.S. House,Christina Owen,DEM,140071,45,47,228,320,04
Cleveland,State Senate,Rob Standridge,REP,140071,55,56,280,391,15
Cleveland,State Senate,Shawn Sheehan,IND,140071,38,32,221,291,15
Cleveland,State House,Scott Martin,REP,140071,58,49,295,402,46
Cleveland,State House,Jacob Rosecrants,DEM,140071,44,49,247,340,46
Cleveland,President,Donald Trump,REP,140072,169,124,967,1260,
Cleveland,President,Gary Johnson,LIB,140072,6,13,99,118,
Cleveland,President,Hillary Clinton,DEM,140072,50,74,374,498,
Cleveland,U.S. Senate,James Lankford,REP,140072,180,124,1030,1334,
Cleveland,U.S. Senate,Robert Murphy,LIB,140072,7,3,59,69,
Cleveland,U.S. Senate,Mike Workman,DEM,140072,33,64,291,388,
Cleveland,U.S. Senate,Mark Beard,IND,140072,1,3,33,37,
Cleveland,U.S. Senate,Sean Braddy,IND,140072,4,16,31,51,
Cleveland,U.S. House,Tom Cole,REP,140072,184,128,1038,1350,04
Cleveland,U.S. House,Sevier White,LIB,140072,7,6,66,79,04
Cleveland,U.S. House,Christina Owen,DEM,140072,34,76,334,444,04
Cleveland,President,Donald Trump,REP,140073,249,265,1004,1518,
Cleveland,President,Gary Johnson,LIB,140073,31,28,122,181,
Cleveland,President,Hillary Clinton,DEM,140073,248,187,591,1026,
Cleveland,U.S. Senate,James Lankford,REP,140073,318,304,1143,1765,
Cleveland,U.S. Senate,Robert Murphy,LIB,140073,7,11,46,64,
Cleveland,U.S. Senate,Mike Workman,DEM,140073,190,147,412,749,
Cleveland,U.S. Senate,Mark Beard,IND,140073,8,4,17,29,
Cleveland,U.S. Senate,Sean Braddy,IND,140073,21,19,102,142,
Cleveland,U.S. House,Tom Cole,REP,140073,340,305,1154,1799,04
Cleveland,U.S. House,Sevier White,LIB,140073,15,11,77,103,04
Cleveland,U.S. House,Christina Owen,DEM,140073,184,169,488,841,04
Cleveland,State Senate,Rob Standridge,REP,140073,284,273,1022,1579,15
Cleveland,State Senate,Shawn Sheehan,IND,140073,223,190,619,1032,15
Cleveland,State House,Scott Martin,REP,140073,337,311,1174,1822,46
Cleveland,State House,Jacob Rosecrants,DEM,140073,200,169,511,880,46
Cleveland,President,Donald Trump,REP,140074,46,60,510,616,
Cleveland,President,Gary Johnson,LIB,140074,4,8,55,67,
Cleveland,President,Hillary Clinton,DEM,140074,65,49,283,397,
Cleveland,U.S. Senate,James Lankford,REP,140074,56,62,560,678,
Cleveland,U.S. Senate,Robert Murphy,LIB,140074,2,6,30,38,
Cleveland,U.S. Senate,Mike Workman,DEM,140074,45,39,214,298,
Cleveland,U.S. Senate,Mark Beard,IND,140074,1,3,11,15,
Cleveland,U.S. Senate,Sean Braddy,IND,140074,9,5,36,50,
Cleveland,U.S. House,Tom Cole,REP,140074,59,65,565,689,04
Cleveland,U.S. House,Sevier White,LIB,140074,1,7,37,45,04
Cleveland,U.S. House,Christina Owen,DEM,140074,53,43,250,346,04
Cleveland,State Senate,Rob Standridge,REP,140074,52,56,536,644,15
Cleveland,State Senate,Shawn Sheehan,IND,140074,50,55,281,386,15
Cleveland,State House,Scott Martin,REP,140074,62,69,579,710,46
Cleveland,State House,Jacob Rosecrants,DEM,140074,51,46,266,363,46
Cleveland,President,Donald Trump,REP,140076,37,44,414,495,
Cleveland,President,Gary Johnson,LIB,140076,4,1,65,70,
Cleveland,President,Hillary Clinton,DEM,140076,55,77,326,458,
Cleveland,U.S. Senate,James Lankford,REP,140076,47,51,466,564,
Cleveland,U.S. Senate,Robert Murphy,LIB,140076,2,2,34,38,
Cleveland,U.S. Senate,Mike Workman,DEM,140076,40,54,236,330,
Cleveland,U.S. Senate,Mark Beard,IND,140076,1,3,14,18,
Cleveland,U.S. Senate,Sean Braddy,IND,140076,5,14,57,76,
Cleveland,U.S. House,Tom Cole,REP,140076,45,56,470,571,04
Cleveland,U.S. House,Sevier White,LIB,140076,2,4,36,42,04
Cleveland,U.S. House,Christina Owen,DEM,140076,48,64,301,413,04
Cleveland,State Senate,Rob Standridge,REP,140076,46,54,450,550,15
Cleveland,State Senate,Shawn Sheehan,IND,140076,44,62,311,417,15
Cleveland,State House,Scott Martin,REP,140076,50,59,483,592,46
Cleveland,State House,Jacob Rosecrants,DEM,140076,44,66,319,429,46
Cleveland,President,Donald Trump,REP,140077,3,11,124,138,
Cleveland,President,Gary Johnson,LIB,140077,1,0,30,31,
Cleveland,President,Hillary Clinton,DEM,140077,6,14,145,165,
Cleveland,U.S. Senate,James Lankford,REP,140077,3,9,128,140,
Cleveland,U.S. Senate,Robert Murphy,LIB,140077,1,0,20,21,
Cleveland,U.S. Senate,Mike Workman,DEM,140077,3,11,101,115,
Cleveland,U.S. Senate,Mark Beard,IND,140077,0,3,10,13,
Cleveland,U.S. Senate,Sean Braddy,IND,140077,3,3,38,44,
Cleveland,U.S. House,Tom Cole,REP,140077,4,9,131,144,04
Cleveland,U.S. House,Sevier White,LIB,140077,1,3,29,33,04
Cleveland,U.S. House,Christina Owen,DEM,140077,5,14,141,160,04
Cleveland,State Senate,Rob Standridge,REP,140077,3,9,131,143,15
Cleveland,State Senate,Shawn Sheehan,IND,140077,7,14,151,172,15
Cleveland,State House,Scott Martin,REP,140077,2,10,128,140,46
Cleveland,State House,Jacob Rosecrants,DEM,140077,7,16,166,189,46
Cleveland,President,Donald Trump,REP,140078,140,70,1010,1220,
Cleveland,President,Gary Johnson,LIB,140078,13,5,67,85,
Cleveland,President,Hillary Clinton,DEM,140078,31,20,168,219,
Cleveland,U.S. Senate,James Lankford,REP,140078,145,67,1017,1229,
Cleveland,U.S. Senate,Robert Murphy,LIB,140078,5,3,33,41,
Cleveland,U.S. Senate,Mike Workman,DEM,140078,26,19,139,184,
Cleveland,U.S. Senate,Mark Beard,IND,140078,2,2,26,30,
Cleveland,U.S. Senate,Sean Braddy,IND,140078,8,4,35,47,
Cleveland,U.S. House,Tom Cole,REP,140078,138,65,1004,1207,04
Cleveland,U.S. House,Sevier White,LIB,140078,11,6,63,80,04
Cleveland,U.S. House,Christina Owen,DEM,140078,37,24,174,235,04
Cleveland,State Senate,Rob Standridge,REP,140078,139,64,957,1160,15
Cleveland,State Senate,Shawn Sheehan,IND,140078,38,26,252,316,15
Cleveland,State House,Josh Cockroft,REP,140078,150,67,996,1213,27
Cleveland,State House,John Karlin,DEM,140078,35,25,230,290,27
Cleveland,President,Donald Trump,REP,140080,30,21,232,283,
Cleveland,President,Gary Johnson,LIB,140080,0,3,22,25,
Cleveland,President,Hillary Clinton,DEM,140080,6,5,61,72,
Cleveland,U.S. Senate,James Lankford,REP,140080,32,23,240,295,
Cleveland,U.S. Senate,Robert Murphy,LIB,140080,0,1,7,8,
Cleveland,U.S. Senate,Mike Workman,DEM,140080,2,3,49,54,
Cleveland,U.S. Senate,Mark Beard,IND,140080,0,0,10,10,
Cleveland,U.S. Senate,Sean Braddy,IND,140080,2,2,12,16,
Cleveland,U.S. House,Tom Cole,REP,140080,31,22,232,285,04
Cleveland,U.S. House,Sevier White,LIB,140080,1,2,20,23,04
Cleveland,U.S. House,Christina Owen,DEM,140080,4,5,66,75,04
Cleveland,State House,Kevin West,REP,140080,29,20,203,252,54
Cleveland,State House,Mary Newcome-Hatch,DEM,140080,2,3,59,64,54
Cleveland,State House,Elizabeth Larios,IND,140080,5,7,50,62,54
Cleveland,President,Donald Trump,REP,140081,107,87,626,820,
Cleveland,President,Gary Johnson,LIB,140081,19,22,151,192,
Cleveland,President,Hillary Clinton,DEM,140081,106,153,643,902,
Cleveland,U.S. Senate,James Lankford,REP,140081,127,105,704,936,
Cleveland,U.S. Senate,Robert Murphy,LIB,140081,8,10,64,82,
Cleveland,U.S. Senate,Mike Workman,DEM,140081,81,125,472,678,
Cleveland,U.S. Senate,Mark Beard,IND,140081,4,4,36,44,
Cleveland,U.S. Senate,Sean Braddy,IND,140081,9,19,131,159,
Cleveland,U.S. House,Tom Cole,REP,140081,132,105,738,975,04
Cleveland,U.S. House,Sevier White,LIB,140081,6,11,82,99,04
Cleveland,U.S. House,Christina Owen,DEM,140081,92,147,590,829,04
Cleveland,State House,Marc Etters,REP,140081,110,98,695,903,45
Cleveland,State House,Claudia Griffith,DEM,140081,118,165,701,984,45
Cleveland,President,Donald Trump,REP,140082,118,128,653,899,
Cleveland,President,Gary Johnson,LIB,140082,13,20,147,180,
Cleveland,President,Hillary Clinton,DEM,140082,143,176,607,926,
Cleveland,U.S. Senate,James Lankford,REP,140082,129,148,750,1027,
Cleveland,U.S. Senate,Robert Murphy,LIB,140082,6,4,58,68,
Cleveland,U.S. Senate,Mike Workman,DEM,140082,108,139,440,687,
Cleveland,U.S. Senate,Mark Beard,IND,140082,1,6,38,45,
Cleveland,U.S. Senate,Sean Braddy,IND,140082,29,24,112,165,
Cleveland,U.S. House,Tom Cole,REP,140082,134,148,769,1051,04
Cleveland,U.S. House,Sevier White,LIB,140082,12,12,89,113,04
Cleveland,U.S. House,Christina Owen,DEM,140082,126,158,536,820,04
Cleveland,State House,Marc Etters,REP,140082,116,136,710,962,45
Cleveland,State House,Claudia Griffith,DEM,140082,154,181,679,1014,45
Cleveland,President,Donald Trump,REP,140083,17,14,234,265,
Cleveland,President,Gary Johnson,LIB,140083,2,0,18,20,
Cleveland,President,Hillary Clinton,DEM,140083,11,8,127,146,
Cleveland,U.S. Senate,James Lankford,REP,140083,17,12,259,288,
Cleveland,U.S. Senate,Robert Murphy,LIB,140083,2,2,6,10,
Cleveland,U.S. Senate,Mike Workman,DEM,140083,10,7,84,101,
Cleveland,U.S. Senate,Mark Beard,IND,140083,0,0,6,6,
Cleveland,U.S. Senate,Sean Braddy,IND,140083,1,1,25,27,
Cleveland,U.S. House,Tom Cole,REP,140083,15,12,261,288,04
Cleveland,U.S. House,Sevier White,LIB,140083,3,1,6,10,04
Cleveland,U.S. House,Christina Owen,DEM,140083,12,9,116,137,04
Cleveland,State House,Bobby Cleveland,REP,140083,17,14,221,252,20
Cleveland,State House,Matt Failing,DEM,140083,13,8,157,178,20
Cleveland,President,Donald Trump,REP,140086,155,259,781,1195,
Cleveland,President,Gary Johnson,LIB,140086,16,16,59,91,
Cleveland,President,Hillary Clinton,DEM,140086,55,91,312,458,
Cleveland,U.S. Senate,James Lankford,REP,140086,168,271,815,1254,
Cleveland,U.S. Senate,Robert Murphy,LIB,140086,8,14,31,53,
Cleveland,U.S. Senate,Mike Workman,DEM,140086,45,76,233,354,
Cleveland,U.S. Senate,Mark Beard,IND,140086,2,4,18,24,
Cleveland,U.S. Senate,Sean Braddy,IND,140086,3,3,50,56,
Cleveland,U.S. House,Tom Cole,REP,140086,166,262,813,1241,04
Cleveland,U.S. House,Sevier White,LIB,140086,6,18,50,74,04
Cleveland,U.S. House,Christina Owen,DEM,140086,55,84,284,423,04
Cleveland,State House,Chris Kannady,REP,140086,165,276,815,1256,91
Cleveland,State House,Trey Puckett,DEM,140086,61,86,315,462,91
Cleveland,President,Donald Trump,REP,140087,54,28,470,552,
Cleveland,President,Gary Johnson,LIB,140087,2,0,40,42,
Cleveland,President,Hillary Clinton,DEM,140087,12,7,140,159,
Cleveland,U.S. Senate,James Lankford,REP,140087,56,29,483,568,
Cleveland,U.S. Senate,Robert Murphy,LIB,140087,0,0,17,17,
Cleveland,U.S. Senate,Mike Workman,DEM,140087,11,4,107,122,
Cleveland,U.S. Senate,Mark Beard,IND,140087,0,1,14,15,
Cleveland,U.S. Senate,Sean Braddy,IND,140087,1,1,27,29,
Cleveland,U.S. House,Tom Cole,REP,140087,53,30,474,557,04
Cleveland,U.S. House,Sevier White,LIB,140087,2,1,41,44,04
Cleveland,U.S. House,Christina Owen,DEM,140087,13,4,130,147,04
Cleveland,State Senate,Rob Standridge,REP,140087,49,27,457,533,15
Cleveland,State Senate,Shawn Sheehan,IND,140087,17,5,156,178,15
Cleveland,State House,Josh Cockroft,REP,140087,53,26,487,566,27
Cleveland,State House,John Karlin,DEM,140087,14,5,147,166,27
Cleveland,President,Donald Trump,REP,140088,185,264,996,1445,
Cleveland,President,Gary Johnson,LIB,140088,10,18,77,105,
Cleveland,President,Hillary Clinton,DEM,140088,74,97,340,511,
Cleveland,U.S. Senate,James Lankford,REP,140088,209,274,1087,1570,
Cleveland,U.S. Senate,Robert Murphy,LIB,140088,6,5,30,41,
Cleveland,U.S. Senate,Mike Workman,DEM,140088,56,85,258,399,
Cleveland,U.S. Senate,Mark Beard,IND,140088,3,5,31,39,
Cleveland,U.S. Senate,Sean Braddy,IND,140088,2,10,28,40,
Cleveland,U.S. House,Tom Cole,REP,140088,205,271,1093,1569,04
Cleveland,U.S. House,Sevier White,LIB,140088,8,8,53,69,04
Cleveland,U.S. House,Christina Owen,DEM,140088,61,100,285,446,04
Cleveland,State House,Chris Kannady,REP,140088,205,277,1089,1571,91
Cleveland,State House,Trey Puckett,DEM,140088,61,99,326,486,91
Cleveland,President,Donald Trump,REP,140089,158,209,946,1313,
Cleveland,President,Gary Johnson,LIB,140089,18,25,118,161,
Cleveland,President,Hillary Clinton,DEM,140089,65,116,452,633,
Cleveland,U.S. Senate,James Lankford,REP,140089,174,223,1050,1447,
Cleveland,U.S. Senate,Robert Murphy,LIB,140089,5,12,67,84,
Cleveland,U.S. Senate,Mike Workman,DEM,140089,53,85,324,462,
Cleveland,U.S. Senate,Mark Beard,IND,140089,3,10,27,40,
Cleveland,U.S. Senate,Sean Braddy,IND,140089,11,20,55,86,
Cleveland,U.S. House,Tom Cole,REP,140089,173,225,1025,1423,04
Cleveland,U.S. House,Sevier White,LIB,140089,10,24,95,129,04
Cleveland,U.S. House,Christina Owen,DEM,140089,63,99,397,559,04
Cleveland,President,Donald Trump,REP,140090,0,0,0,0,
Cleveland,President,Gary Johnson,LIB,140090,0,0,0,0,
Cleveland,President,Hillary Clinton,DEM,140090,0,0,0,0,
Cleveland,U.S. Senate,James Lankford,REP,140090,0,0,0,0,
Cleveland,U.S. Senate,Robert Murphy,LIB,140090,0,0,0,0,
Cleveland,U.S. Senate,Mike Workman,DEM,140090,0,0,0,0,
Cleveland,U.S. Senate,Mark Beard,IND,140090,0,0,0,0,
Cleveland,U.S. Senate,Sean Braddy,IND,140090,0,0,0,0,
Cleveland,U.S. House,Tom Cole,REP,140090,0,0,0,0,04
Cleveland,U.S. House,Sevier White,LIB,140090,0,0,0,0,04
Cleveland,U.S. House,Christina Owen,DEM,140090,0,0,0,0,04
Cleveland,State House,Kevin West,REP,140090,0,0,0,0,54
Cleveland,State House,Mary Newcome-Hatch,DEM,140090,0,0,0,0,54
Cleveland,State House,Elizabeth Larios,IND,140090,0,0,0,0,54
Cleveland,President,Donald Trump,REP,140091,15,14,68,97,
Cleveland,President,Gary Johnson,LIB,140091,1,1,8,10,
Cleveland,President,Hillary Clinton,DEM,140091,7,8,21,36,
Cleveland,U.S. Senate,James Lankford,REP,140091,14,18,78,110,
Cleveland,U.S. Senate,Robert Murphy,LIB,140091,1,0,2,3,
Cleveland,U.S. Senate,Mike Workman,DEM,140091,8,3,13,24,
Cleveland,U.S. Senate,Mark Beard,IND,140091,0,0,0,0,
Cleveland,U.S. Senate,Sean Braddy,IND,140091,0,0,5,5,
Cleveland,U.S. House,Tom Cole,REP,140091,14,17,76,107,04
Cleveland,U.S. House,Sevier White,LIB,140091,1,0,6,7,04
Cleveland,U.S. House,Christina Owen,DEM,140091,8,4,16,28,04
Cleveland,State Senate,Rob Standridge,REP,140091,13,18,69,100,15
Cleveland,State Senate,Shawn Sheehan,IND,140091,7,1,24,32,15
Cleveland,State House,Scott Martin,REP,140091,13,17,71,101,46
Cleveland,State House,Jacob Rosecrants,DEM,140091,9,4,23,36,46
Cleveland,President,Donald Trump,REP,140092,0,0,1,1,
Cleveland,President,Gary Johnson,LIB,140092,0,0,1,1,
Cleveland,President,Hillary Clinton,DEM,140092,0,1,1,2,
Cleveland,U.S. Senate,James Lankford,REP,140092,0,0,1,1,
Cleveland,U.S. Senate,Robert Murphy,LIB,140092,0,0,0,0,
Cleveland,U.S. Senate,Mike Workman,DEM,140092,0,1,1,2,
Cleveland,U.S. Senate,Mark Beard,IND,140092,0,0,0,0,
Cleveland,U.S. Senate,Sean Braddy,IND,140092,0,0,1,1,
Cleveland,U.S. House,Tom Cole,REP,140092,0,0,1,1,04
Cleveland,U.S. House,Sevier White,LIB,140092,0,0,1,1,04
Cleveland,U.S. House,Christina Owen,DEM,140092,0,1,1,2,04
Cleveland,State House,Scott Martin,REP,140092,0,0,0,0,46
Cleveland,State House,Jacob Rosecrants,DEM,140092,0,1,3,4,46
Cleveland,President,Donald Trump,REP,140093,14,12,148,174,
Cleveland,President,Gary Johnson,LIB,140093,1,3,41,45,
Cleveland,President,Hillary Clinton,DEM,140093,58,54,281,393,
Cleveland,U.S. Senate,James Lankford,REP,140093,19,17,200,236,
Cleveland,U.S. Senate,Robert Murphy,LIB,140093,2,8,16,26,
Cleveland,U.S. Senate,Mike Workman,DEM,140093,47,36,210,293,
Cleveland,U.S. Senate,Mark Beard,IND,140093,0,3,7,10,
Cleveland,U.S. Senate,Sean Braddy,IND,140093,6,5,37,48,
Cleveland,U.S. House,Tom Cole,REP,140093,31,20,205,256,04
Cleveland,U.S. House,Sevier White,LIB,140093,1,5,25,31,04
Cleveland,U.S. House,Christina Owen,DEM,140093,40,45,239,324,04
Cleveland,State House,Scott Martin,REP,140093,23,18,208,249,46
Cleveland,State House,Jacob Rosecrants,DEM,140093,50,51,257,358,46
Cleveland,President,Donald Trump,REP,140094,19,29,147,195,
Cleveland,President,Gary Johnson,LIB,140094,0,0,26,26,
Cleveland,President,Hillary Clinton,DEM,140094,11,16,79,106,
Cleveland,U.S. Senate,James Lankford,REP,140094,21,29,157,207,
Cleveland,U.S. Senate,Robert Murphy,LIB,140094,2,1,7,10,
Cleveland,U.S. Senate,Mike Workman,DEM,140094,6,14,68,88,
Cleveland,U.S. Senate,Mark Beard,IND,140094,0,0,6,6,
Cleveland,U.S. Senate,Sean Braddy,IND,140094,2,2,17,21,
Cleveland,U.S. House,Tom Cole,REP,140094,19,31,161,211,04
Cleveland,U.S. House,Sevier White,LIB,140094,1,1,16,18,04
Cleveland,U.S. House,Christina Owen,DEM,140094,11,14,77,102,04
Cleveland,State Senate,Rob Standridge,REP,140094,22,29,156,207,15
Cleveland,State Senate,Shawn Sheehan,IND,140094,9,13,83,105,15
Cleveland,State House,Marc Etters,REP,140094,20,29,155,204,45
Cleveland,State House,Claudia Griffith,DEM,140094,11,17,96,124,45
Cleveland,President,Donald Trump,REP,140095,17,6,316,339,
Cleveland,President,Gary Johnson,LIB,140095,0,0,26,26,
Cleveland,President,Hillary Clinton,DEM,140095,10,1,102,113,
Cleveland,U.S. Senate,James Lankford,REP,140095,19,6,308,333,
Cleveland,U.S. Senate,Robert Murphy,LIB,140095,1,0,17,18,
Cleveland,U.S. Senate,Mike Workman,DEM,140095,6,0,87,93,
Cleveland,U.S. Senate,Mark Beard,IND,140095,0,0,13,13,
Cleveland,U.S. Senate,Sean Braddy,IND,140095,1,1,20,22,
Cleveland,U.S. House,Tom Cole,REP,140095,17,6,316,339,04
Cleveland,U.S. House,Sevier White,LIB,140095,3,0,17,20,04
Cleveland,U.S. House,Christina Owen,DEM,140095,7,1,112,120,04
Cleveland,State Senate,Rob Standridge,REP,140095,18,6,314,338,15
Cleveland,State Senate,Shawn Sheehan,IND,140095,8,1,106,115,15
Cleveland,State House,Bobby Cleveland,REP,140095,17,7,263,287,20
Cleveland,State House,Matt Failing,DEM,140095,10,0,177,187,20
Coal,President,Donald Trump,REP,150002,6,12,282,300,
Coal,President,Gary Johnson,LIB,150002,0,0,18,18,
Coal,President,Hillary Clinton,DEM,150002,5,0,71,76,
Coal,U.S. Senate,James Lankford,REP,150002,8,11,241,260,
Coal,U.S. Senate,Robert Murphy,LIB,150002,0,0,7,7,
Coal,U.S. Senate,Mike Workman,DEM,150002,3,0,101,104,
Coal,U.S. Senate,Mark Beard,IND,150002,0,0,10,10,
Coal,U.S. Senate,Sean Braddy,IND,150002,0,0,10,10,
Coal,U.S. House,Markwayne Mullin,REP,150002,8,10,229,247,02
Coal,U.S. House,Joshua Harris-Till,DEM,150002,3,1,99,103,02
Coal,U.S. House,John Mccarthy,IND,150002,0,1,34,35,02
Coal,President,Donald Trump,REP,150003,6,25,121,152,
Coal,President,Gary Johnson,LIB,150003,0,3,5,8,
Coal,President,Hillary Clinton,DEM,150003,2,3,25,30,
Coal,U.S. Senate,James Lankford,REP,150003,6,21,103,130,
Coal,U.S. Senate,Robert Murphy,LIB,150003,0,1,2,3,
Coal,U.S. Senate,Mike Workman,DEM,150003,2,5,42,49,
Coal,U.S. Senate,Mark Beard,IND,150003,0,2,1,3,
Coal,U.S. Senate,Sean Braddy,IND,150003,0,1,5,6,
Coal,U.S. House,Markwayne Mullin,REP,150003,5,24,106,135,02
Coal,U.S. House,Joshua Harris-Till,DEM,150003,3,6,35,44,02
Coal,U.S. House,John Mccarthy,IND,150003,0,1,10,11,02
Coal,President,Donald Trump,REP,150004,18,61,243,322,
Coal,President,Gary Johnson,LIB,150004,2,3,6,11,
Coal,President,Hillary Clinton,DEM,150004,3,21,44,68,
Coal,U.S. Senate,James Lankford,REP,150004,17,55,193,265,
Coal,U.S. Senate,Robert Murphy,LIB,150004,0,1,6,7,
Coal,U.S. Senate,Mike Workman,DEM,150004,4,25,70,99,
Coal,U.S. Senate,Mark Beard,IND,150004,0,1,6,7,
Coal,U.S. Senate,Sean Braddy,IND,150004,0,1,12,13,
Coal,U.S. House,Markwayne Mullin,REP,150004,17,60,203,280,02
Coal,U.S. House,Joshua Harris-Till,DEM,150004,4,21,60,85,02
Coal,U.S. House,John Mccarthy,IND,150004,0,1,21,22,02
Coal,President,Donald Trump,REP,150005,9,70,263,342,
Coal,President,Gary Johnson,LIB,150005,0,1,11,12,
Coal,President,Hillary Clinton,DEM,150005,3,15,65,83,
Coal,U.S. Senate,James Lankford,REP,150005,6,56,183,245,
Coal,U.S. Senate,Robert Murphy,LIB,150005,0,0,17,17,
Coal,U.S. Senate,Mike Workman,DEM,150005,2,19,99,120,
Coal,U.S. Senate,Mark Beard,IND,150005,0,1,13,14,
Coal,U.S. Senate,Sean Braddy,IND,150005,0,3,7,10,
Coal,U.S. House,Markwayne Mullin,REP,150005,6,58,206,270,02
Coal,U.S. House,Joshua Harris-Till,DEM,150005,3,14,88,105,02
Coal,U.S. House,John Mccarthy,IND,150005,0,8,28,36,02
Coal,President,Donald Trump,REP,150006,5,27,82,114,
Coal,President,Gary Johnson,LIB,150006,0,0,13,13,
Coal,President,Hillary Clinton,DEM,150006,1,2,20,23,
Coal,U.S. Senate,James Lankford,REP,150006,4,24,68,96,
Coal,U.S. Senate,Robert Murphy,LIB,150006,0,1,2,3,
Coal,U.S. Senate,Mike Workman,DEM,150006,2,2,33,37,
Coal,U.S. Senate,Mark Beard,IND,150006,0,0,2,2,
Coal,U.S. Senate,Sean Braddy,IND,150006,0,0,6,6,
Coal,U.S. House,Markwayne Mullin,REP,150006,3,26,73,102,02
Coal,U.S. House,Joshua Harris-Till,DEM,150006,3,1,24,28,02
Coal,U.S. House,John Mccarthy,IND,150006,0,1,14,15,02
Coal,President,Donald Trump,REP,150007,4,40,172,216,
Coal,President,Gary Johnson,LIB,150007,0,1,5,6,
Coal,President,Hillary Clinton,DEM,150007,6,6,38,50,
Coal,U.S. Senate,James Lankford,REP,150007,3,37,140,180,
Coal,U.S. Senate,Robert Murphy,LIB,150007,0,1,6,7,
Coal,U.S. Senate,Mike Workman,DEM,150007,3,6,52,61,
Coal,U.S. Senate,Mark Beard,IND,150007,1,1,5,7,
Coal,U.S. Senate,Sean Braddy,IND,150007,0,0,5,5,
Coal,U.S. House,Markwayne Mullin,REP,150007,3,38,148,189,02
Coal,U.S. House,Joshua Harris-Till,DEM,150007,4,7,44,55,02
Coal,U.S. House,John Mccarthy,IND,150007,0,0,16,16,02
Coal,President,Donald Trump,REP,150009,0,6,84,90,
Coal,President,Gary Johnson,LIB,150009,0,2,0,2,
Coal,President,Hillary Clinton,DEM,150009,0,0,19,19,
Coal,U.S. Senate,James Lankford,REP,150009,0,6,69,75,
Coal,U.S. Senate,Robert Murphy,LIB,150009,0,0,0,0,
Coal,U.S. Senate,Mike Workman,DEM,150009,0,1,25,26,
Coal,U.S. Senate,Mark Beard,IND,150009,0,0,3,3,
Coal,U.S. Senate,Sean Braddy,IND,150009,0,1,2,3,
Coal,U.S. House,Markwayne Mullin,REP,150009,0,5,73,78,02
Coal,U.S. House,Joshua Harris-Till,DEM,150009,0,1,20,21,02
Coal,U.S. House,John Mccarthy,IND,150009,0,2,6,8,02
Coal,President,Donald Trump,REP,150010,4,12,110,126,
Coal,President,Gary Johnson,LIB,150010,0,0,8,8,
Coal,President,Hillary Clinton,DEM,150010,0,0,13,13,
Coal,U.S. Senate,James Lankford,REP,150010,3,10,88,101,
Coal,U.S. Senate,Robert Murphy,LIB,150010,0,0,4,4,
Coal,U.S. Senate,Mike Workman,DEM,150010,1,1,25,27,
Coal,U.S. Senate,Mark Beard,IND,150010,0,0,2,2,
Coal,U.S. Senate,Sean Braddy,IND,150010,0,1,2,3,
Coal,U.S. House,Markwayne Mullin,REP,150010,3,11,91,105,02
Coal,U.S. House,Joshua Harris-Till,DEM,150010,0,1,21,22,02
Coal,U.S. House,John Mccarthy,IND,150010,1,0,9,10,02
Coal,President,Donald Trump,REP,150011,8,27,201,236,
Coal,President,Gary Johnson,LIB,150011,1,2,9,12,
Coal,President,Hillary Clinton,DEM,150011,1,5,43,49,
Coal,U.S. Senate,James Lankford,REP,150011,5,14,154,173,
Coal,U.S. Senate,Robert Murphy,LIB,150011,0,0,5,5,
Coal,U.S. Senate,Mike Workman,DEM,150011,2,17,71,90,
Coal,U.S. Senate,Mark Beard,IND,150011,0,1,6,7,
Coal,U.S. Senate,Sean Braddy,IND,150011,1,0,4,5,
Coal,U.S. House,Markwayne Mullin,REP,150011,6,21,159,186,02
Coal,U.S. House,Joshua Harris-Till,DEM,150011,1,12,62,75,02
Coal,U.S. House,John Mccarthy,IND,150011,1,1,16,18,02
Comanche,President,Donald Trump,REP,160001,74,68,507,649,
Comanche,President,Gary Johnson,LIB,160001,7,8,58,73,
Comanche,President,Hillary Clinton,DEM,160001,44,77,386,507,
Comanche,U.S. Senate,James Lankford,REP,160001,79,73,560,712,
Comanche,U.S. Senate,Robert Murphy,LIB,160001,5,2,27,34,
Comanche,U.S. Senate,Mike Workman,DEM,160001,30,71,308,409,
Comanche,U.S. Senate,Mark Beard,IND,160001,1,1,21,23,
Comanche,U.S. Senate,Sean Braddy,IND,160001,3,6,31,40,
Comanche,U.S. House,Tom Cole,REP,160001,82,76,602,760,04
Comanche,U.S. House,Sevier White,LIB,160001,5,4,24,33,04
Comanche,U.S. House,Christina Owen,DEM,160001,35,73,322,430,04
Comanche,State House,John Michael Montgomery,REP,160001,72,75,541,688,62
Comanche,State House,Larry Bush,DEM,160001,45,78,403,526,62
Comanche,President,Donald Trump,REP,160002,47,65,384,496,
Comanche,President,Gary Johnson,LIB,160002,3,4,56,63,
Comanche,President,Hillary Clinton,DEM,160002,33,90,363,486,
Comanche,U.S. Senate,James Lankford,REP,160002,52,69,423,544,
Comanche,U.S. Senate,Robert Murphy,LIB,160002,1,6,24,31,
Comanche,U.S. Senate,Mike Workman,DEM,160002,29,78,310,417,
Comanche,U.S. Senate,Mark Beard,IND,160002,0,1,17,18,
Comanche,U.S. Senate,Sean Braddy,IND,160002,2,4,29,35,
Comanche,U.S. House,Tom Cole,REP,160002,55,73,448,576,04
Comanche,U.S. House,Sevier White,LIB,160002,1,6,31,38,04
Comanche,U.S. House,Christina Owen,DEM,160002,27,79,326,432,04
Comanche,State House,John Michael Montgomery,REP,160002,49,67,419,535,62
Comanche,State House,Larry Bush,DEM,160002,32,91,385,508,62
Comanche,President,Donald Trump,REP,160003,25,37,358,420,
Comanche,President,Gary Johnson,LIB,160003,1,8,56,65,
Comanche,President,Hillary Clinton,DEM,160003,21,61,320,402,
Comanche,U.S. Senate,James Lankford,REP,160003,27,41,363,431,
Comanche,U.S. Senate,Robert Murphy,LIB,160003,0,2,29,31,
Comanche,U.S. Senate,Mike Workman,DEM,160003,18,51,282,351,
Comanche,U.S. Senate,Mark Beard,IND,160003,0,5,21,26,
Comanche,U.S. Senate,Sean Braddy,IND,160003,1,7,35,43,
Comanche,U.S. House,Tom Cole,REP,160003,30,45,394,469,04
Comanche,U.S. House,Sevier White,LIB,160003,1,6,40,47,04
Comanche,U.S. House,Christina Owen,DEM,160003,16,55,295,366,04
Comanche,State House,John Michael Montgomery,REP,160003,28,42,372,442,62
Comanche,State House,Larry Bush,DEM,160003,19,63,353,435,62
Comanche,President,Donald Trump,REP,160007,39,66,387,492,
Comanche,President,Gary Johnson,LIB,160007,5,5,49,59,
Comanche,President,Hillary Clinton,DEM,160007,30,76,304,410,
Comanche,U.S. Senate,James Lankford,REP,160007,43,67,394,504,
Comanche,U.S. Senate,Robert Murphy,LIB,160007,3,8,27,38,
Comanche,U.S. Senate,Mike Workman,DEM,160007,27,68,259,354,
Comanche,U.S. Senate,Mark Beard,IND,160007,1,2,17,20,
Comanche,U.S. Senate,Sean Braddy,IND,160007,0,4,36,40,
Comanche,U.S. House,Tom Cole,REP,160007,47,76,435,558,04
Comanche,U.S. House,Sevier White,LIB,160007,5,7,32,44,04
Comanche,U.S. House,Christina Owen,DEM,160007,22,67,267,356,04
Comanche,State House,John Michael Montgomery,REP,160007,40,66,387,493,62
Comanche,State House,Larry Bush,DEM,160007,34,83,346,463,62
Comanche,President,Donald Trump,REP,160008,96,115,564,775,
Comanche,President,Gary Johnson,LIB,160008,10,6,64,80,
Comanche,President,Hillary Clinton,DEM,160008,62,103,425,590,
Comanche,U.S. Senate,James Lankford,REP,160008,115,120,594,829,
Comanche,U.S. Senate,Robert Murphy,LIB,160008,3,4,47,54,
Comanche,U.S. Senate,Mike Workman,DEM,160008,45,95,338,478,
Comanche,U.S. Senate,Mark Beard,IND,160008,2,0,22,24,
Comanche,U.S. Senate,Sean Braddy,IND,160008,5,4,45,54,
Comanche,U.S. House,Tom Cole,REP,160008,117,129,653,899,04
Comanche,U.S. House,Sevier White,LIB,160008,2,3,35,40,04
Comanche,U.S. House,Christina Owen,DEM,160008,49,91,363,503,04
Comanche,State House,John Michael Montgomery,REP,160008,108,117,579,804,62
Comanche,State House,Larry Bush,DEM,160008,58,106,467,631,62
Comanche,President,Donald Trump,REP,160009,41,103,479,623,
Comanche,President,Gary Johnson,LIB,160009,4,6,53,63,
Comanche,President,Hillary Clinton,DEM,160009,29,120,455,604,
Comanche,U.S. Senate,James Lankford,REP,160009,41,109,515,665,
Comanche,U.S. Senate,Robert Murphy,LIB,160009,3,2,33,38,
Comanche,U.S. Senate,Mike Workman,DEM,160009,27,106,384,517,
Comanche,U.S. Senate,Mark Beard,IND,160009,2,4,23,29,
Comanche,U.S. Senate,Sean Braddy,IND,160009,0,6,30,36,
Comanche,U.S. House,Tom Cole,REP,160009,39,124,553,716,04
Comanche,U.S. House,Sevier White,LIB,160009,4,3,52,59,04
Comanche,U.S. House,Christina Owen,DEM,160009,26,102,381,509,04
Comanche,State House,John Michael Montgomery,REP,160009,39,103,490,632,62
Comanche,State House,Larry Bush,DEM,160009,28,127,492,647,62
Comanche,President,Donald Trump,REP,160011,31,56,354,441,
Comanche,President,Gary Johnson,LIB,160011,3,2,58,63,
Comanche,President,Hillary Clinton,DEM,160011,49,101,409,559,
Comanche,U.S. Senate,James Lankford,REP,160011,35,56,404,495,
Comanche,U.S. Senate,Robert Murphy,LIB,160011,1,1,27,29,
Comanche,U.S. Senate,Mike Workman,DEM,160011,43,92,350,485,
Comanche,U.S. Senate,Mark Beard,IND,160011,1,5,15,21,
Comanche,U.S. Senate,Sean Braddy,IND,160011,2,3,25,30,
Comanche,U.S. House,Tom Cole,REP,160011,36,62,428,526,04
Comanche,U.S. House,Sevier White,LIB,160011,3,1,40,44,04
Comanche,U.S. House,Christina Owen,DEM,160011,42,95,355,492,04
Comanche,State Senate,Chris Kidd,REP,160011,34,60,411,505,31
Comanche,State Senate,Perry Brinegar,DEM,160011,44,97,406,547,31
Comanche,State House,John Michael Montgomery,REP,160011,32,58,378,468,62
Comanche,State House,Larry Bush,DEM,160011,46,99,445,590,62
Comanche,President,Donald Trump,REP,160013,25,32,483,540,
Comanche,President,Gary Johnson,LIB,160013,4,4,75,83,
Comanche,President,Hillary Clinton,DEM,160013,16,50,451,517,
Comanche,U.S. Senate,James Lankford,REP,160013,22,36,502,560,
Comanche,U.S. Senate,Robert Murphy,LIB,160013,5,3,40,48,
Comanche,U.S. Senate,Mike Workman,DEM,160013,9,40,374,423,
Comanche,U.S. Senate,Mark Beard,IND,160013,2,2,38,42,
Comanche,U.S. Senate,Sean Braddy,IND,160013,5,4,48,57,
Comanche,U.S. House,Tom Cole,REP,160013,30,38,571,639,04
Comanche,U.S. House,Sevier White,LIB,160013,0,3,56,59,04
Comanche,U.S. House,Christina Owen,DEM,160013,14,43,384,441,04
Comanche,State House,Rande Worthen,REP,160013,30,33,535,598,64
Comanche,State House,Jacobi Crowley,DEM,160013,12,51,464,527,64
Comanche,President,Donald Trump,REP,160014,21,22,108,151,
Comanche,President,Gary Johnson,LIB,160014,8,2,23,33,
Comanche,President,Hillary Clinton,DEM,160014,20,14,102,136,
Comanche,U.S. Senate,James Lankford,REP,160014,21,22,117,160,
Comanche,U.S. Senate,Robert Murphy,LIB,160014,7,3,11,21,
Comanche,U.S. Senate,Mike Workman,DEM,160014,15,14,88,117,
Comanche,U.S. Senate,Mark Beard,IND,160014,0,0,7,7,
Comanche,U.S. Senate,Sean Braddy,IND,160014,1,0,9,10,
Comanche,U.S. House,Tom Cole,REP,160014,25,23,118,166,04
Comanche,U.S. House,Sevier White,LIB,160014,3,3,13,19,04
Comanche,U.S. House,Christina Owen,DEM,160014,17,13,101,131,04
Comanche,State House,Scooter Park,REP,160014,21,24,121,166,65
Comanche,State House,Rick Gilleland,DEM,160014,17,13,110,140,65
Comanche,President,Donald Trump,REP,160015,52,69,403,524,
Comanche,President,Gary Johnson,LIB,160015,2,2,61,65,
Comanche,President,Hillary Clinton,DEM,160015,35,47,320,402,
Comanche,U.S. Senate,James Lankford,REP,160015,52,72,430,554,
Comanche,U.S. Senate,Robert Murphy,LIB,160015,1,6,30,37,
Comanche,U.S. Senate,Mike Workman,DEM,160015,30,35,268,333,
Comanche,U.S. Senate,Mark Beard,IND,160015,2,1,19,22,
Comanche,U.S. Senate,Sean Braddy,IND,160015,5,4,28,37,
Comanche,U.S. House,Tom Cole,REP,160015,58,78,478,614,04
Comanche,U.S. House,Sevier White,LIB,160015,2,3,30,35,04
Comanche,U.S. House,Christina Owen,DEM,160015,30,37,274,341,04
Comanche,State House,Rande Worthen,REP,160015,60,69,451,580,64
Comanche,State House,Jacobi Crowley,DEM,160015,29,48,323,400,64
Comanche,President,Donald Trump,REP,160017,53,71,456,580,
Comanche,President,Gary Johnson,LIB,160017,5,6,68,79,
Comanche,President,Hillary Clinton,DEM,160017,43,53,301,397,
Comanche,U.S. Senate,James Lankford,REP,160017,62,76,482,620,
Comanche,U.S. Senate,Robert Murphy,LIB,160017,0,4,44,48,
Comanche,U.S. Senate,Mike Workman,DEM,160017,34,44,245,323,
Comanche,U.S. Senate,Mark Beard,IND,160017,2,2,21,25,
Comanche,U.S. Senate,Sean Braddy,IND,160017,3,5,32,40,
Comanche,U.S. House,Tom Cole,REP,160017,68,79,529,676,04
Comanche,U.S. House,Sevier White,LIB,160017,1,3,37,41,04
Comanche,U.S. House,Christina Owen,DEM,160017,32,49,257,338,04
Comanche,State House,Rande Worthen,REP,160017,68,77,495,640,64
Comanche,State House,Jacobi Crowley,DEM,160017,33,53,326,412,64
Comanche,President,Donald Trump,REP,160019,16,29,365,410,
Comanche,President,Gary Johnson,LIB,160019,0,3,52,55,
Comanche,President,Hillary Clinton,DEM,160019,18,16,199,233,
Comanche,U.S. Senate,James Lankford,REP,160019,17,33,385,435,
Comanche,U.S. Senate,Robert Murphy,LIB,160019,0,1,25,26,
Comanche,U.S. Senate,Mike Workman,DEM,160019,11,12,162,185,
Comanche,U.S. Senate,Mark Beard,IND,160019,0,1,14,15,
Comanche,U.S. Senate,Sean Braddy,IND,160019,6,1,27,34,
Comanche,U.S. House,Tom Cole,REP,160019,22,34,424,480,04
Comanche,U.S. House,Sevier White,LIB,160019,0,2,30,32,04
Comanche,U.S. House,Christina Owen,DEM,160019,13,12,164,189,04
Comanche,State House,Rande Worthen,REP,160019,20,35,395,450,64
Comanche,State House,Jacobi Crowley,DEM,160019,12,13,219,244,64
Comanche,President,Donald Trump,REP,160020,31,29,323,383,
Comanche,President,Gary Johnson,LIB,160020,2,6,58,66,
Comanche,President,Hillary Clinton,DEM,160020,20,58,281,359,
Comanche,U.S. Senate,James Lankford,REP,160020,31,29,337,397,
Comanche,U.S. Senate,Robert Murphy,LIB,160020,1,1,26,28,
Comanche,U.S. Senate,Mike Workman,DEM,160020,20,51,239,310,
Comanche,U.S. Senate,Mark Beard,IND,160020,0,1,23,24,
Comanche,U.S. Senate,Sean Braddy,IND,160020,1,10,34,45,
Comanche,U.S. House,Tom Cole,REP,160020,36,34,374,444,04
Comanche,U.S. House,Sevier White,LIB,160020,0,0,41,41,04
Comanche,U.S. House,Christina Owen,DEM,160020,17,58,247,322,04
Comanche,State House,Rande Worthen,REP,160020,32,31,359,422,64
Comanche,State House,Jacobi Crowley,DEM,160020,21,60,298,379,64
Comanche,President,Donald Trump,REP,160021,19,19,225,263,
Comanche,President,Gary Johnson,LIB,160021,4,8,40,52,
Comanche,President,Hillary Clinton,DEM,160021,14,30,200,244,
Comanche,U.S. Senate,James Lankford,REP,160021,19,20,238,277,
Comanche,U.S. Senate,Robert Murphy,LIB,160021,2,4,20,26,
Comanche,U.S. Senate,Mike Workman,DEM,160021,14,28,173,215,
Comanche,U.S. Senate,Mark Beard,IND,160021,0,1,7,8,
Comanche,U.S. Senate,Sean Braddy,IND,160021,2,3,21,26,
Comanche,U.S. House,Tom Cole,REP,160021,23,24,259,306,04
Comanche,U.S. House,Sevier White,LIB,160021,2,2,23,27,04
Comanche,U.S. House,Christina Owen,DEM,160021,12,31,178,221,04
Comanche,State House,Rande Worthen,REP,160021,20,19,244,283,64
Comanche,State House,Jacobi Crowley,DEM,160021,15,35,217,267,64
Comanche,President,Donald Trump,REP,160025,0,4,50,54,
Comanche,President,Gary Johnson,LIB,160025,0,0,20,20,
Comanche,President,Hillary Clinton,DEM,160025,11,29,289,329,
Comanche,U.S. Senate,James Lankford,REP,160025,0,4,56,60,
Comanche,U.S. Senate,Robert Murphy,LIB,160025,0,0,12,12,
Comanche,U.S. Senate,Mike Workman,DEM,160025,10,29,273,312,
Comanche,U.S. Senate,Mark Beard,IND,160025,1,0,5,6,
Comanche,U.S. Senate,Sean Braddy,IND,160025,0,0,12,12,
Comanche,U.S. House,Tom Cole,REP,160025,0,4,66,70,04
Comanche,U.S. House,Sevier White,LIB,160025,0,0,10,10,04
Comanche,U.S. House,Christina Owen,DEM,160025,10,29,281,320,04
Comanche,State Senate,Chris Kidd,REP,160025,1,4,63,68,31
Comanche,State Senate,Perry Brinegar,DEM,160025,9,29,292,330,31
Comanche,State House,John Michael Montgomery,REP,160025,2,4,57,63,62
Comanche,State House,Larry Bush,DEM,160025,8,29,297,334,62
Comanche,President,Donald Trump,REP,160026,7,11,203,221,
Comanche,President,Gary Johnson,LIB,160026,0,0,29,29,
Comanche,President,Hillary Clinton,DEM,160026,3,8,149,160,
Comanche,U.S. Senate,James Lankford,REP,160026,6,13,204,223,
Comanche,U.S. Senate,Robert Murphy,LIB,160026,0,2,17,19,
Comanche,U.S. Senate,Mike Workman,DEM,160026,3,3,127,133,
Comanche,U.S. Senate,Mark Beard,IND,160026,0,2,13,15,
Comanche,U.S. Senate,Sean Braddy,IND,160026,1,0,20,21,
Comanche,U.S. House,Tom Cole,REP,160026,6,14,227,247,04
Comanche,U.S. House,Sevier White,LIB,160026,1,1,26,28,04
Comanche,U.S. House,Christina Owen,DEM,160026,3,5,127,135,04
Comanche,State Senate,Chris Kidd,REP,160026,7,14,211,232,31
Comanche,State Senate,Perry Brinegar,DEM,160026,3,6,166,175,31
Comanche,State House,Jeff Coody,REP,160026,6,12,205,223,63
Comanche,State House,Randy Batt,DEM,160026,4,7,175,186,63
Comanche,President,Donald Trump,REP,160027,8,20,183,211,
Comanche,President,Gary Johnson,LIB,160027,1,3,41,45,
Comanche,President,Hillary Clinton,DEM,160027,9,21,161,191,
Comanche,U.S. Senate,James Lankford,REP,160027,8,23,187,218,
Comanche,U.S. Senate,Robert Murphy,LIB,160027,2,0,24,26,
Comanche,U.S. Senate,Mike Workman,DEM,160027,7,18,140,165,
Comanche,U.S. Senate,Mark Beard,IND,160027,1,1,15,17,
Comanche,U.S. Senate,Sean Braddy,IND,160027,0,2,17,19,
Comanche,U.S. House,Tom Cole,REP,160027,8,23,206,237,04
Comanche,U.S. House,Sevier White,LIB,160027,3,1,29,33,04
Comanche,U.S. House,Christina Owen,DEM,160027,7,20,149,176,04
Comanche,State Senate,Chris Kidd,REP,160027,9,22,199,230,31
Comanche,State Senate,Perry Brinegar,DEM,160027,9,22,180,211,31
Comanche,State House,Rande Worthen,REP,160027,9,20,203,232,64
Comanche,State House,Jacobi Crowley,DEM,160027,9,24,178,211,64
Comanche,President,Donald Trump,REP,160029,3,6,52,61,
Comanche,President,Gary Johnson,LIB,160029,2,1,9,12,
Comanche,President,Hillary Clinton,DEM,160029,8,18,205,231,
Comanche,U.S. Senate,James Lankford,REP,160029,3,7,65,75,
Comanche,U.S. Senate,Robert Murphy,LIB,160029,1,0,3,4,
Comanche,U.S. Senate,Mike Workman,DEM,160029,9,16,175,200,
Comanche,U.S. Senate,Mark Beard,IND,160029,0,1,8,9,
Comanche,U.S. Senate,Sean Braddy,IND,160029,0,1,16,17,
Comanche,U.S. House,Tom Cole,REP,160029,1,8,76,85,04
Comanche,U.S. House,Sevier White,LIB,160029,2,0,4,6,04
Comanche,U.S. House,Christina Owen,DEM,160029,10,17,187,214,04
Comanche,State Senate,Chris Kidd,REP,160029,4,7,63,74,31
Comanche,State Senate,Perry Brinegar,DEM,160029,8,18,203,229,31
Comanche,State House,Jeff Coody,REP,160029,2,8,71,81,63
Comanche,State House,Randy Batt,DEM,160029,10,17,195,222,63
Comanche,President,Donald Trump,REP,160030,4,10,120,134,
Comanche,President,Gary Johnson,LIB,160030,1,0,14,15,
Comanche,President,Hillary Clinton,DEM,160030,4,19,115,138,
Comanche,U.S. Senate,James Lankford,REP,160030,7,11,131,149,
Comanche,U.S. Senate,Robert Murphy,LIB,160030,0,2,3,5,
Comanche,U.S. Senate,Mike Workman,DEM,160030,2,15,95,112,
Comanche,U.S. Senate,Mark Beard,IND,160030,0,0,8,8,
Comanche,U.S. Senate,Sean Braddy,IND,160030,0,2,11,13,
Comanche,U.S. House,Tom Cole,REP,160030,8,11,135,154,04
Comanche,U.S. House,Sevier White,LIB,160030,0,2,9,11,04
Comanche,U.S. House,Christina Owen,DEM,160030,1,17,104,122,04
Comanche,State Senate,Chris Kidd,REP,160030,4,11,130,145,31
Comanche,State Senate,Perry Brinegar,DEM,160030,5,19,118,142,31
Comanche,State House,Scooter Park,REP,160030,4,10,123,137,65
Comanche,State House,Rick Gilleland,DEM,160030,5,20,124,149,65
Comanche,President,Donald Trump,REP,160031,156,270,925,1351,
Comanche,President,Gary Johnson,LIB,160031,17,21,86,124,
Comanche,President,Hillary Clinton,DEM,160031,87,196,496,779,
Comanche,U.S. Senate,James Lankford,REP,160031,183,298,1002,1483,
Comanche,U.S. Senate,Robert Murphy,LIB,160031,10,3,47,60,
Comanche,U.S. Senate,Mike Workman,DEM,160031,63,169,387,619,
Comanche,U.S. Senate,Mark Beard,IND,160031,1,11,31,43,
Comanche,U.S. Senate,Sean Braddy,IND,160031,3,4,32,39,
Comanche,U.S. House,Tom Cole,REP,160031,188,303,1032,1523,04
Comanche,U.S. House,Sevier White,LIB,160031,17,9,46,72,04
Comanche,U.S. House,Christina Owen,DEM,160031,56,175,419,650,04
Comanche,State Senate,Chris Kidd,REP,160031,175,291,991,1457,31
Comanche,State Senate,Perry Brinegar,DEM,160031,77,196,501,774,31
Comanche,State House,Rande Worthen,REP,160031,184,286,999,1469,64
Comanche,State House,Jacobi Crowley,DEM,160031,71,200,489,760,64
Comanche,President,Donald Trump,REP,160032,0,0,8,8,
Comanche,President,Gary Johnson,LIB,160032,0,0,3,3,
Comanche,President,Hillary Clinton,DEM,160032,3,6,74,83,
Comanche,U.S. Senate,James Lankford,REP,160032,0,0,8,8,
Comanche,U.S. Senate,Robert Murphy,LIB,160032,0,0,2,2,
Comanche,U.S. Senate,Mike Workman,DEM,160032,3,6,71,80,
Comanche,U.S. Senate,Mark Beard,IND,160032,0,0,2,2,
Comanche,U.S. Senate,Sean Braddy,IND,160032,0,0,2,2,
Comanche,U.S. House,Tom Cole,REP,160032,0,0,10,10,04
Comanche,U.S. House,Sevier White,LIB,160032,0,0,3,3,04
Comanche,U.S. House,Christina Owen,DEM,160032,3,6,72,81,04
Comanche,State Senate,Chris Kidd,REP,160032,0,0,8,8,31
Comanche,State Senate,Perry Brinegar,DEM,160032,3,6,77,86,31
Comanche,State House,Rande Worthen,REP,160032,0,0,6,6,64
Comanche,State House,Jacobi Crowley,DEM,160032,3,6,79,88,64
Comanche,President,Donald Trump,REP,160033,17,11,207,235,
Comanche,President,Gary Johnson,LIB,160033,0,4,24,28,
Comanche,President,Hillary Clinton,DEM,160033,22,24,121,167,
Comanche,U.S. Senate,James Lankford,REP,160033,16,11,222,249,
Comanche,U.S. Senate,Robert Murphy,LIB,160033,2,1,14,17,
Comanche,U.S. Senate,Mike Workman,DEM,160033,17,22,90,129,
Comanche,U.S. Senate,Mark Beard,IND,160033,0,0,8,8,
Comanche,U.S. Senate,Sean Braddy,IND,160033,2,5,16,23,
Comanche,U.S. House,Tom Cole,REP,160033,17,13,231,261,04
Comanche,U.S. House,Sevier White,LIB,160033,2,2,21,25,04
Comanche,U.S. House,Christina Owen,DEM,160033,18,24,101,143,04
Comanche,State Senate,Chris Kidd,REP,160033,13,13,216,242,31
Comanche,State Senate,Perry Brinegar,DEM,160033,22,26,136,184,31
Comanche,State House,Rande Worthen,REP,160033,17,13,207,237,64
Comanche,State House,Jacobi Crowley,DEM,160033,19,26,141,186,64
Comanche,President,Donald Trump,REP,160034,58,115,578,751,
Comanche,President,Gary Johnson,LIB,160034,2,8,76,86,
Comanche,President,Hillary Clinton,DEM,160034,34,96,414,544,
Comanche,U.S. Senate,James Lankford,REP,160034,59,117,612,788,
Comanche,U.S. Senate,Robert Murphy,LIB,160034,2,8,27,37,
Comanche,U.S. Senate,Mike Workman,DEM,160034,29,84,359,472,
Comanche,U.S. Senate,Mark Beard,IND,160034,1,4,27,32,
Comanche,U.S. Senate,Sean Braddy,IND,160034,2,5,41,48,
Comanche,U.S. House,Tom Cole,REP,160034,58,119,668,845,04
Comanche,U.S. House,Sevier White,LIB,160034,2,8,31,41,04
Comanche,U.S. House,Christina Owen,DEM,160034,32,89,369,490,04
Comanche,State Senate,Chris Kidd,REP,160034,63,123,616,802,31
Comanche,State Senate,Perry Brinegar,DEM,160034,28,92,438,558,31
Comanche,State House,Jeff Coody,REP,160034,56,125,636,817,63
Comanche,State House,Randy Batt,DEM,160034,33,91,423,547,63
Comanche,President,Donald Trump,REP,160035,10,10,223,243,
Comanche,President,Gary Johnson,LIB,160035,0,1,11,12,
Comanche,President,Hillary Clinton,DEM,160035,0,3,70,73,
Comanche,U.S. Senate,James Lankford,REP,160035,10,11,221,242,
Comanche,U.S. Senate,Robert Murphy,LIB,160035,0,0,8,8,
Comanche,U.S. Senate,Mike Workman,DEM,160035,0,3,65,68,
Comanche,U.S. Senate,Mark Beard,IND,160035,0,0,5,5,
Comanche,U.S. Senate,Sean Braddy,IND,160035,0,0,5,5,
Comanche,U.S. House,Tom Cole,REP,160035,10,10,227,247,04
Comanche,U.S. House,Sevier White,LIB,160035,0,1,9,10,04
Comanche,U.S. House,Christina Owen,DEM,160035,0,3,69,72,04
Comanche,State House,Jeff Coody,REP,160035,9,11,206,226,63
Comanche,State House,Randy Batt,DEM,160035,1,3,100,104,63
Comanche,President,Donald Trump,REP,160036,14,8,213,235,
Comanche,President,Gary Johnson,LIB,160036,1,0,15,16,
Comanche,President,Hillary Clinton,DEM,160036,9,8,89,106,
Comanche,U.S. Senate,James Lankford,REP,160036,17,8,212,237,
Comanche,U.S. Senate,Robert Murphy,LIB,160036,2,0,10,12,
Comanche,U.S. Senate,Mike Workman,DEM,160036,5,7,77,89,
Comanche,U.S. Senate,Mark Beard,IND,160036,0,1,6,7,
Comanche,U.S. Senate,Sean Braddy,IND,160036,0,0,9,9,
Comanche,U.S. House,Tom Cole,REP,160036,19,7,225,251,04
Comanche,U.S. House,Sevier White,LIB,160036,1,1,17,19,04
Comanche,U.S. House,Christina Owen,DEM,160036,4,8,73,85,04
Comanche,State House,Jeff Coody,REP,160036,16,8,209,233,63
Comanche,State House,Randy Batt,DEM,160036,6,8,103,117,63
Comanche,President,Donald Trump,REP,160037,8,4,215,227,
Comanche,President,Gary Johnson,LIB,160037,1,0,10,11,
Comanche,President,Hillary Clinton,DEM,160037,0,2,58,60,
Comanche,U.S. Senate,James Lankford,REP,160037,7,4,227,238,
Comanche,U.S. Senate,Robert Murphy,LIB,160037,2,0,5,7,
Comanche,U.S. Senate,Mike Workman,DEM,160037,0,0,36,36,
Comanche,U.S. Senate,Mark Beard,IND,160037,0,0,4,4,
Comanche,U.S. Senate,Sean Braddy,IND,160037,0,2,7,9,
Comanche,U.S. House,Tom Cole,REP,160037,6,4,240,250,04
Comanche,U.S. House,Sevier White,LIB,160037,2,0,6,8,04
Comanche,U.S. House,Christina Owen,DEM,160037,1,2,34,37,04
Comanche,State House,Jeff Coody,REP,160037,8,2,215,225,63
Comanche,State House,Randy Batt,DEM,160037,1,4,64,69,63
Comanche,President,Donald Trump,REP,160038,123,144,1352,1619,
Comanche,President,Gary Johnson,LIB,160038,15,5,113,133,
Comanche,President,Hillary Clinton,DEM,160038,53,54,346,453,
Comanche,U.S. Senate,James Lankford,REP,160038,128,149,1385,1662,
Comanche,U.S. Senate,Robert Murphy,LIB,160038,11,3,55,69,
Comanche,U.S. Senate,Mike Workman,DEM,160038,45,44,293,382,
Comanche,U.S. Senate,Mark Beard,IND,160038,2,5,47,54,
Comanche,U.S. Senate,Sean Braddy,IND,160038,3,3,31,37,
Comanche,U.S. House,Tom Cole,REP,160038,132,142,1456,1730,04
Comanche,U.S. House,Sevier White,LIB,160038,5,7,73,85,04
Comanche,U.S. House,Christina Owen,DEM,160038,50,55,278,383,04
Comanche,State Senate,Chris Kidd,REP,160038,122,144,1358,1624,31
Comanche,State Senate,Perry Brinegar,DEM,160038,62,58,441,561,31
Comanche,State House,Scooter Park,REP,160038,108,143,1339,1590,65
Comanche,State House,Rick Gilleland,DEM,160038,75,60,464,599,65
Comanche,President,Donald Trump,REP,160039,30,7,634,671,
Comanche,President,Gary Johnson,LIB,160039,3,0,40,43,
Comanche,President,Hillary Clinton,DEM,160039,8,0,157,165,
Comanche,U.S. Senate,James Lankford,REP,160039,28,7,654,689,
Comanche,U.S. Senate,Robert Murphy,LIB,160039,3,0,20,23,
Comanche,U.S. Senate,Mike Workman,DEM,160039,7,0,128,135,
Comanche,U.S. Senate,Mark Beard,IND,160039,2,0,12,14,
Comanche,U.S. Senate,Sean Braddy,IND,160039,1,0,13,14,
Comanche,U.S. House,Tom Cole,REP,160039,27,7,684,718,04
Comanche,U.S. House,Sevier White,LIB,160039,5,0,29,34,04
Comanche,U.S. House,Christina Owen,DEM,160039,8,0,116,124,04
Comanche,State Senate,Chris Kidd,REP,160039,30,7,586,623,31
Comanche,State Senate,Perry Brinegar,DEM,160039,9,0,243,252,31
Comanche,State House,Scooter Park,REP,160039,29,6,624,659,65
Comanche,State House,Rick Gilleland,DEM,160039,10,1,198,209,65
Comanche,President,Donald Trump,REP,160040,35,10,716,761,
Comanche,President,Gary Johnson,LIB,160040,5,0,37,42,
Comanche,President,Hillary Clinton,DEM,160040,5,3,128,136,
Comanche,U.S. Senate,James Lankford,REP,160040,35,10,675,720,
Comanche,U.S. Senate,Robert Murphy,LIB,160040,4,1,25,30,
Comanche,U.S. Senate,Mike Workman,DEM,160040,6,2,131,139,
Comanche,U.S. Senate,Mark Beard,IND,160040,0,0,20,20,
Comanche,U.S. Senate,Sean Braddy,IND,160040,0,0,24,24,
Comanche,U.S. House,Tom Cole,REP,160040,35,11,717,763,04
Comanche,U.S. House,Sevier White,LIB,160040,3,0,27,30,04
Comanche,U.S. House,Christina Owen,DEM,160040,6,2,133,141,04
Comanche,State Senate,Chris Kidd,REP,160040,34,11,650,695,31
Comanche,State Senate,Perry Brinegar,DEM,160040,8,2,228,238,31
Comanche,State House,Scooter Park,REP,160040,32,11,683,726,65
Comanche,State House,Rick Gilleland,DEM,160040,10,2,194,206,65
Comanche,President,Donald Trump,REP,160041,15,9,398,422,
Comanche,President,Gary Johnson,LIB,160041,4,0,26,30,
Comanche,President,Hillary Clinton,DEM,160041,4,3,94,101,
Comanche,U.S. Senate,James Lankford,REP,160041,17,9,392,418,
Comanche,U.S. Senate,Robert Murphy,LIB,160041,1,0,14,15,
Comanche,U.S. Senate,Mike Workman,DEM,160041,5,2,85,92,
Comanche,U.S. Senate,Mark Beard,IND,160041,2,0,14,16,
Comanche,U.S. Senate,Sean Braddy,IND,160041,0,0,12,12,
Comanche,U.S. House,Tom Cole,REP,160041,20,10,405,435,04
Comanche,U.S. House,Sevier White,LIB,160041,3,0,17,20,04
Comanche,U.S. House,Christina Owen,DEM,160041,2,2,98,102,04
Comanche,State House,Jeff Coody,REP,160041,14,8,325,347,63
Comanche,State House,Randy Batt,DEM,160041,11,4,194,209,63
Comanche,President,Donald Trump,REP,160042,164,141,1151,1456,
Comanche,President,Gary Johnson,LIB,160042,17,8,105,130,
Comanche,President,Hillary Clinton,DEM,160042,75,118,420,613,
Comanche,U.S. Senate,James Lankford,REP,160042,176,133,1169,1478,
Comanche,U.S. Senate,Robert Murphy,LIB,160042,6,10,52,68,
Comanche,U.S. Senate,Mike Workman,DEM,160042,68,109,354,531,
Comanche,U.S. Senate,Mark Beard,IND,160042,3,3,37,43,
Comanche,U.S. Senate,Sean Braddy,IND,160042,3,12,61,76,
Comanche,U.S. House,Tom Cole,REP,160042,188,141,1264,1593,04
Comanche,U.S. House,Sevier White,LIB,160042,6,9,59,74,04
Comanche,U.S. House,Christina Owen,DEM,160042,62,117,354,533,04
Comanche,State House,Jeff Coody,REP,160042,139,129,961,1229,63
Comanche,State House,Randy Batt,DEM,160042,118,138,715,971,63
Comanche,President,Donald Trump,REP,160043,17,10,233,260,
Comanche,President,Gary Johnson,LIB,160043,3,0,6,9,
Comanche,President,Hillary Clinton,DEM,160043,3,4,40,47,
Comanche,U.S. Senate,James Lankford,REP,160043,20,11,225,256,
Comanche,U.S. Senate,Robert Murphy,LIB,160043,0,0,6,6,
Comanche,U.S. Senate,Mike Workman,DEM,160043,1,3,32,36,
Comanche,U.S. Senate,Mark Beard,IND,160043,0,0,5,5,
Comanche,U.S. Senate,Sean Braddy,IND,160043,1,0,7,8,
Comanche,U.S. House,Tom Cole,REP,160043,21,12,237,270,04
Comanche,U.S. House,Sevier White,LIB,160043,1,1,8,10,04
Comanche,U.S. House,Christina Owen,DEM,160043,1,1,33,35,04
Comanche,State Senate,Chris Kidd,REP,160043,15,12,220,247,31
Comanche,State Senate,Perry Brinegar,DEM,160043,7,2,56,65,31
Comanche,State House,Jeff Coody,REP,160043,16,10,219,245,63
Comanche,State House,Randy Batt,DEM,160043,7,4,58,69,63
Comanche,President,Donald Trump,REP,160045,35,34,527,596,
Comanche,President,Gary Johnson,LIB,160045,1,2,27,30,
Comanche,President,Hillary Clinton,DEM,160045,5,32,146,183,
Comanche,U.S. Senate,James Lankford,REP,160045,34,37,529,600,
Comanche,U.S. Senate,Robert Murphy,LIB,160045,1,0,9,10,
Comanche,U.S. Senate,Mike Workman,DEM,160045,4,28,135,167,
Comanche,U.S. Senate,Mark Beard,IND,160045,1,1,13,15,
Comanche,U.S. Senate,Sean Braddy,IND,160045,1,1,10,12,
Comanche,U.S. House,Tom Cole,REP,160045,34,37,551,622,04
Comanche,U.S. House,Sevier White,LIB,160045,2,3,18,23,04
Comanche,U.S. House,Christina Owen,DEM,160045,5,27,129,161,04
Comanche,State Senate,Chris Kidd,REP,160045,34,34,535,603,31
Comanche,State Senate,Perry Brinegar,DEM,160045,6,32,159,197,31
Comanche,State House,Jeff Coody,REP,160045,33,36,465,534,63
Comanche,State House,Randy Batt,DEM,160045,7,30,235,272,63
Comanche,President,Donald Trump,REP,160046,8,4,228,240,
Comanche,President,Gary Johnson,LIB,160046,3,1,13,17,
Comanche,President,Hillary Clinton,DEM,160046,3,1,42,46,
Comanche,U.S. Senate,James Lankford,REP,160046,13,5,234,252,
Comanche,U.S. Senate,Robert Murphy,LIB,160046,0,0,7,7,
Comanche,U.S. Senate,Mike Workman,DEM,160046,1,1,30,32,
Comanche,U.S. Senate,Mark Beard,IND,160046,0,0,6,6,
Comanche,U.S. Senate,Sean Braddy,IND,160046,0,0,7,7,
Comanche,U.S. House,Tom Cole,REP,160046,13,5,238,256,04
Comanche,U.S. House,Sevier White,LIB,160046,0,0,9,9,04
Comanche,U.S. House,Christina Owen,DEM,160046,1,1,34,36,04
Comanche,State Senate,Chris Kidd,REP,160046,13,4,221,238,31
Comanche,State Senate,Perry Brinegar,DEM,160046,1,1,58,60,31
Comanche,State House,Jeff Coody,REP,160046,9,5,208,222,63
Comanche,State House,Randy Batt,DEM,160046,5,1,75,81,63
Comanche,President,Donald Trump,REP,160048,5,19,432,456,
Comanche,President,Gary Johnson,LIB,160048,1,1,30,32,
Comanche,President,Hillary Clinton,DEM,160048,2,6,145,153,
Comanche,U.S. Senate,James Lankford,REP,160048,5,22,433,460,
Comanche,U.S. Senate,Robert Murphy,LIB,160048,1,1,17,19,
Comanche,U.S. Senate,Mike Workman,DEM,160048,2,3,122,127,
Comanche,U.S. Senate,Mark Beard,IND,160048,0,0,18,18,
Comanche,U.S. Senate,Sean Braddy,IND,160048,0,1,19,20,
Comanche,U.S. House,Tom Cole,REP,160048,5,23,459,487,04
Comanche,U.S. House,Sevier White,LIB,160048,1,1,24,26,04
Comanche,U.S. House,Christina Owen,DEM,160048,2,3,124,129,04
Comanche,State Senate,Chris Kidd,REP,160048,5,22,411,438,31
Comanche,State Senate,Perry Brinegar,DEM,160048,2,5,191,198,31
Comanche,State House,Jeff Coody,REP,160048,6,18,409,433,63
Comanche,State House,Randy Batt,DEM,160048,1,9,194,204,63
Comanche,President,Donald Trump,REP,160049,19,22,442,483,
Comanche,President,Gary Johnson,LIB,160049,2,1,18,21,
Comanche,President,Hillary Clinton,DEM,160049,7,14,107,128,
Comanche,U.S. Senate,James Lankford,REP,160049,22,24,457,503,
Comanche,U.S. Senate,Robert Murphy,LIB,160049,1,0,10,11,
Comanche,U.S. Senate,Mike Workman,DEM,160049,4,12,79,95,
Comanche,U.S. Senate,Mark Beard,IND,160049,0,0,4,4,
Comanche,U.S. Senate,Sean Braddy,IND,160049,0,1,15,16,
Comanche,U.S. House,Tom Cole,REP,160049,21,24,450,495,04
Comanche,U.S. House,Sevier White,LIB,160049,1,2,22,25,04
Comanche,U.S. House,Christina Owen,DEM,160049,5,11,94,110,04
Comanche,State Senate,Chris Kidd,REP,160049,21,24,404,449,31
Comanche,State Senate,Perry Brinegar,DEM,160049,6,13,161,180,31
Comanche,State House,Scooter Park,REP,160049,21,21,436,478,65
Comanche,State House,Rick Gilleland,DEM,160049,5,15,124,144,65
Comanche,President,Donald Trump,REP,160050,156,158,720,1034,
Comanche,President,Gary Johnson,LIB,160050,7,6,58,71,
Comanche,President,Hillary Clinton,DEM,160050,67,102,334,503,
Comanche,U.S. Senate,James Lankford,REP,160050,179,163,768,1110,
Comanche,U.S. Senate,Robert Murphy,LIB,160050,1,6,29,36,
Comanche,U.S. Senate,Mike Workman,DEM,160050,48,89,262,399,
Comanche,U.S. Senate,Mark Beard,IND,160050,2,5,15,22,
Comanche,U.S. Senate,Sean Braddy,IND,160050,1,5,37,43,
Comanche,U.S. House,Tom Cole,REP,160050,181,170,790,1141,04
Comanche,U.S. House,Sevier White,LIB,160050,3,6,32,41,04
Comanche,U.S. House,Christina Owen,DEM,160050,49,91,289,429,04
Comanche,State House,John Michael Montgomery,REP,160050,164,154,751,1069,62
Comanche,State House,Larry Bush,DEM,160050,66,112,360,538,62
Comanche,President,Donald Trump,REP,160051,42,42,623,707,
Comanche,President,Gary Johnson,LIB,160051,9,1,50,60,
Comanche,President,Hillary Clinton,DEM,160051,10,11,207,228,
Comanche,U.S. Senate,James Lankford,REP,160051,44,39,638,721,
Comanche,U.S. Senate,Robert Murphy,LIB,160051,6,1,28,35,
Comanche,U.S. Senate,Mike Workman,DEM,160051,8,12,166,186,
Comanche,U.S. Senate,Mark Beard,IND,160051,1,1,22,24,
Comanche,U.S. Senate,Sean Braddy,IND,160051,3,1,24,28,
Comanche,U.S. House,Tom Cole,REP,160051,45,40,667,752,04
Comanche,U.S. House,Sevier White,LIB,160051,7,2,36,45,04
Comanche,U.S. House,Christina Owen,DEM,160051,9,12,176,197,04
Comanche,State House,Jeff Coody,REP,160051,43,39,661,743,63
Comanche,State House,Randy Batt,DEM,160051,17,15,217,249,63
Comanche,President,Donald Trump,REP,160053,0,0,0,0,
Comanche,President,Gary Johnson,LIB,160053,0,0,0,0,
Comanche,President,Hillary Clinton,DEM,160053,0,0,0,0,
Comanche,U.S. Senate,James Lankford,REP,160053,0,0,0,0,
Comanche,U.S. Senate,Robert Murphy,LIB,160053,0,0,0,0,
Comanche,U.S. Senate,Mike Workman,DEM,160053,0,0,0,0,
Comanche,U.S. Senate,Mark Beard,IND,160053,0,0,0,0,
Comanche,U.S. Senate,Sean Braddy,IND,160053,0,0,0,0,
Comanche,U.S. House,Tom Cole,REP,160053,0,0,0,0,04
Comanche,U.S. House,Sevier White,LIB,160053,0,0,0,0,04
Comanche,U.S. House,Christina Owen,DEM,160053,0,0,0,0,04
Comanche,State House,Scooter Park,REP,160053,0,0,0,0,65
Comanche,State House,Rick Gilleland,DEM,160053,0,0,0,0,65
Cotton,President,Donald Trump,REP,170001,4,10,62,76,
Cotton,President,Gary Johnson,LIB,170001,0,0,3,3,
Cotton,President,Hillary Clinton,DEM,170001,3,0,16,19,
Cotton,U.S. Senate,James Lankford,REP,170001,4,7,62,73,
Cotton,U.S. Senate,Robert Murphy,LIB,170001,0,0,1,1,
Cotton,U.S. Senate,Mike Workman,DEM,170001,3,2,15,20,
Cotton,U.S. Senate,Mark Beard,IND,170001,0,0,2,2,
Cotton,U.S. Senate,Sean Braddy,IND,170001,0,1,1,2,
Cotton,U.S. House,Tom Cole,REP,170001,4,10,63,77,04
Cotton,U.S. House,Sevier White,LIB,170001,0,0,2,2,04
Cotton,U.S. House,Christina Owen,DEM,170001,3,0,15,18,04
Cotton,State Senate,Chris Kidd,REP,170001,4,10,58,72,31
Cotton,State Senate,Perry Brinegar,DEM,170001,3,0,23,26,31
Cotton,State House,Scooter Park,REP,170001,4,10,63,77,65
Cotton,State House,Rick Gilleland,DEM,170001,3,0,17,20,65
Cotton,President,Donald Trump,REP,170003,22,93,236,351,
Cotton,President,Gary Johnson,LIB,170003,1,5,17,23,
Cotton,President,Hillary Clinton,DEM,170003,5,16,41,62,
Cotton,U.S. Senate,James Lankford,REP,170003,23,95,233,351,
Cotton,U.S. Senate,Robert Murphy,LIB,170003,0,2,8,10,
Cotton,U.S. Senate,Mike Workman,DEM,170003,6,10,37,53,
Cotton,U.S. Senate,Mark Beard,IND,170003,0,4,9,13,
Cotton,U.S. Senate,Sean Braddy,IND,170003,0,3,8,11,
Cotton,U.S. House,Tom Cole,REP,170003,24,96,247,367,04
Cotton,U.S. House,Sevier White,LIB,170003,0,2,5,7,04
Cotton,U.S. House,Christina Owen,DEM,170003,5,14,42,61,04
Cotton,State Senate,Chris Kidd,REP,170003,22,91,237,350,31
Cotton,State Senate,Perry Brinegar,DEM,170003,6,22,56,84,31
Cotton,State House,Scooter Park,REP,170003,22,99,232,353,65
Cotton,State House,Rick Gilleland,DEM,170003,7,15,58,80,65
Cotton,President,Donald Trump,REP,170004,8,57,196,261,
Cotton,President,Gary Johnson,LIB,170004,0,5,15,20,
Cotton,President,Hillary Clinton,DEM,170004,3,13,56,72,
Cotton,U.S. Senate,James Lankford,REP,170004,9,58,192,259,
Cotton,U.S. Senate,Robert Murphy,LIB,170004,1,2,6,9,
Cotton,U.S. Senate,Mike Workman,DEM,170004,2,11,44,57,
Cotton,U.S. Senate,Mark Beard,IND,170004,0,1,9,10,
Cotton,U.S. Senate,Sean Braddy,IND,170004,0,3,9,12,
Cotton,U.S. House,Tom Cole,REP,170004,10,60,205,275,04
Cotton,U.S. House,Sevier White,LIB,170004,0,1,10,11,04
Cotton,U.S. House,Christina Owen,DEM,170004,2,14,44,60,04
Cotton,State Senate,Chris Kidd,REP,170004,11,62,201,274,31
Cotton,State Senate,Perry Brinegar,DEM,170004,1,13,58,72,31
Cotton,State House,Scooter Park,REP,170004,11,63,208,282,65
Cotton,State House,Rick Gilleland,DEM,170004,1,12,55,68,65
Cotton,President,Donald Trump,REP,170005,9,50,307,366,
Cotton,President,Gary Johnson,LIB,170005,2,3,21,26,
Cotton,President,Hillary Clinton,DEM,170005,3,5,101,109,
Cotton,U.S. Senate,James Lankford,REP,170005,9,52,291,352,
Cotton,U.S. Senate,Robert Murphy,LIB,170005,0,1,9,10,
Cotton,U.S. Senate,Mike Workman,DEM,170005,4,3,98,105,
Cotton,U.S. Senate,Mark Beard,IND,170005,0,2,12,14,
Cotton,U.S. Senate,Sean Braddy,IND,170005,0,0,8,8,
Cotton,U.S. House,Tom Cole,REP,170005,10,49,314,373,04
Cotton,U.S. House,Sevier White,LIB,170005,0,1,11,12,04
Cotton,U.S. House,Christina Owen,DEM,170005,4,6,96,106,04
Cotton,State Senate,Chris Kidd,REP,170005,11,51,308,370,31
Cotton,State Senate,Perry Brinegar,DEM,170005,3,7,108,118,31
Cotton,State House,Scooter Park,REP,170005,11,54,335,400,65
Cotton,State House,Rick Gilleland,DEM,170005,3,4,83,90,65
Cotton,President,Donald Trump,REP,170007,11,62,207,280,
Cotton,President,Gary Johnson,LIB,170007,3,2,9,14,
Cotton,President,Hillary Clinton,DEM,170007,1,7,60,68,
Cotton,U.S. Senate,James Lankford,REP,170007,12,64,216,292,
Cotton,U.S. Senate,Robert Murphy,LIB,170007,1,0,1,2,
Cotton,U.S. Senate,Mike Workman,DEM,170007,1,4,46,51,
Cotton,U.S. Senate,Mark Beard,IND,170007,0,1,6,7,
Cotton,U.S. Senate,Sean Braddy,IND,170007,0,0,6,6,
Cotton,U.S. House,Tom Cole,REP,170007,12,65,220,297,04
Cotton,U.S. House,Sevier White,LIB,170007,2,0,7,9,04
Cotton,U.S. House,Christina Owen,DEM,170007,0,6,47,53,04
Cotton,State Senate,Chris Kidd,REP,170007,11,64,212,287,31
Cotton,State Senate,Perry Brinegar,DEM,170007,2,7,61,70,31
Cotton,State House,Scooter Park,REP,170007,11,55,222,288,65
Cotton,State House,Rick Gilleland,DEM,170007,1,16,54,71,65
Cotton,President,Donald Trump,REP,170008,3,6,45,54,
Cotton,President,Gary Johnson,LIB,170008,1,0,1,2,
Cotton,President,Hillary Clinton,DEM,170008,0,0,10,10,
Cotton,U.S. Senate,James Lankford,REP,170008,2,5,46,53,
Cotton,U.S. Senate,Robert Murphy,LIB,170008,0,0,0,0,
Cotton,U.S. Senate,Mike Workman,DEM,170008,1,0,6,7,
Cotton,U.S. Senate,Mark Beard,IND,170008,1,1,1,3,
Cotton,U.S. Senate,Sean Braddy,IND,170008,0,0,1,1,
Cotton,U.S. House,Tom Cole,REP,170008,4,6,46,56,04
Cotton,U.S. House,Sevier White,LIB,170008,0,0,1,1,04
Cotton,U.S. House,Christina Owen,DEM,170008,0,0,7,7,04
Cotton,State Senate,Chris Kidd,REP,170008,3,6,45,54,31
Cotton,State Senate,Perry Brinegar,DEM,170008,1,0,8,9,31
Cotton,State House,Scooter Park,REP,170008,3,6,45,54,65
Cotton,State House,Rick Gilleland,DEM,170008,1,0,9,10,65
Cotton,President,Donald Trump,REP,170009,11,64,202,277,
Cotton,President,Gary Johnson,LIB,170009,0,9,14,23,
Cotton,President,Hillary Clinton,DEM,170009,2,5,41,48,
Cotton,U.S. Senate,James Lankford,REP,170009,11,58,198,267,
Cotton,U.S. Senate,Robert Murphy,LIB,170009,0,6,8,14,
Cotton,U.S. Senate,Mike Workman,DEM,170009,2,11,39,52,
Cotton,U.S. Senate,Mark Beard,IND,170009,0,2,5,7,
Cotton,U.S. Senate,Sean Braddy,IND,170009,0,1,4,5,
Cotton,U.S. House,Tom Cole,REP,170009,11,65,202,278,04
Cotton,U.S. House,Sevier White,LIB,170009,1,5,6,12,04
Cotton,U.S. House,Christina Owen,DEM,170009,1,7,48,56,04
Cotton,State Senate,Chris Kidd,REP,170009,10,67,193,270,31
Cotton,State Senate,Perry Brinegar,DEM,170009,3,9,62,74,31
Cotton,State House,Scooter Park,REP,170009,11,62,205,278,65
Cotton,State House,Rick Gilleland,DEM,170009,2,15,48,65,65
Cotton,President,Donald Trump,REP,170010,5,15,134,154,
Cotton,President,Gary Johnson,LIB,170010,0,0,2,2,
Cotton,President,Hillary Clinton,DEM,170010,1,0,14,15,
Cotton,U.S. Senate,James Lankford,REP,170010,7,14,130,151,
Cotton,U.S. Senate,Robert Murphy,LIB,170010,0,0,1,1,
Cotton,U.S. Senate,Mike Workman,DEM,170010,0,0,16,16,
Cotton,U.S. Senate,Mark Beard,IND,170010,0,0,3,3,
Cotton,U.S. Senate,Sean Braddy,IND,170010,0,0,2,2,
Cotton,U.S. House,Tom Cole,REP,170010,7,13,136,156,04
Cotton,U.S. House,Sevier White,LIB,170010,0,0,1,1,04
Cotton,U.S. House,Christina Owen,DEM,170010,0,0,15,15,04
Cotton,State Senate,Chris Kidd,REP,170010,7,14,130,151,31
Cotton,State Senate,Perry Brinegar,DEM,170010,0,0,22,22,31
Cotton,State House,Scooter Park,REP,170010,7,15,128,150,65
Cotton,State House,Rick Gilleland,DEM,170010,0,0,24,24,65
Cotton,President,Donald Trump,REP,170011,4,22,209,235,
Cotton,President,Gary Johnson,LIB,170011,1,0,10,11,
Cotton,President,Hillary Clinton,DEM,170011,0,0,21,21,
Cotton,U.S. Senate,James Lankford,REP,170011,5,21,187,213,
Cotton,U.S. Senate,Robert Murphy,LIB,170011,0,1,8,9,
Cotton,U.S. Senate,Mike Workman,DEM,170011,0,0,26,26,
Cotton,U.S. Senate,Mark Beard,IND,170011,0,0,10,10,
Cotton,U.S. Senate,Sean Braddy,IND,170011,0,0,5,5,
Cotton,U.S. House,Tom Cole,REP,170011,5,20,192,217,04
Cotton,U.S. House,Sevier White,LIB,170011,0,0,13,13,04
Cotton,U.S. House,Christina Owen,DEM,170011,0,1,27,28,04
Cotton,State Senate,Chris Kidd,REP,170011,4,21,200,225,31
Cotton,State Senate,Perry Brinegar,DEM,170011,0,0,38,38,31
Cotton,State House,Scooter Park,REP,170011,5,18,207,230,65
Cotton,State House,Rick Gilleland,DEM,170011,0,3,36,39,65
Craig,President,Donald Trump,REP,180140,22,24,529,575,
Craig,President,Gary Johnson,LIB,180140,1,0,13,14,
Craig,President,Hillary Clinton,DEM,180140,0,5,91,96,
Craig,U.S. Senate,James Lankford,REP,180140,20,24,474,518,
Craig,U.S. Senate,Robert Murphy,LIB,180140,0,1,8,9,
Craig,U.S. Senate,Mike Workman,DEM,180140,2,4,122,128,
Craig,U.S. Senate,Mark Beard,IND,180140,0,0,16,16,
Craig,U.S. Senate,Sean Braddy,IND,180140,1,0,9,10,
Craig,U.S. House,Markwayne Mullin,REP,180140,22,24,485,531,02
Craig,U.S. House,Joshua Harris-Till,DEM,180140,1,5,108,114,02
Craig,U.S. House,John Mccarthy,IND,180140,0,0,37,37,02
Craig,State Senate,Micheal Bergstrom,REP,180140,13,17,370,400,1
Craig,State Senate,John Myers,DEM,180140,8,12,261,281,1
Craig,President,Donald Trump,REP,180320,19,21,86,126,
Craig,President,Gary Johnson,LIB,180320,2,0,8,10,
Craig,President,Hillary Clinton,DEM,180320,2,2,24,28,
Craig,U.S. Senate,James Lankford,REP,180320,21,20,79,120,
Craig,U.S. Senate,Robert Murphy,LIB,180320,0,0,4,4,
Craig,U.S. Senate,Mike Workman,DEM,180320,2,2,25,29,
Craig,U.S. Senate,Mark Beard,IND,180320,0,1,4,5,
Craig,U.S. Senate,Sean Braddy,IND,180320,0,0,2,2,
Craig,U.S. House,Markwayne Mullin,REP,180320,20,20,83,123,02
Craig,U.S. House,Joshua Harris-Till,DEM,180320,2,3,25,30,02
Craig,U.S. House,John Mccarthy,IND,180320,1,0,6,7,02
Craig,State Senate,Micheal Bergstrom,REP,180320,12,12,49,73,1
Craig,State Senate,John Myers,DEM,180320,10,12,66,88,1
Craig,President,Donald Trump,REP,180410,6,22,277,305,
Craig,President,Gary Johnson,LIB,180410,1,2,20,23,
Craig,President,Hillary Clinton,DEM,180410,3,4,72,79,
Craig,U.S. Senate,James Lankford,REP,180410,6,18,255,279,
Craig,U.S. Senate,Robert Murphy,LIB,180410,0,1,12,13,
Craig,U.S. Senate,Mike Workman,DEM,180410,4,7,83,94,
Craig,U.S. Senate,Mark Beard,IND,180410,0,0,7,7,
Craig,U.S. Senate,Sean Braddy,IND,180410,0,1,6,7,
Craig,U.S. House,Markwayne Mullin,REP,180410,5,20,272,297,02
Craig,U.S. House,Joshua Harris-Till,DEM,180410,4,7,73,84,02
Craig,U.S. House,John Mccarthy,IND,180410,1,0,20,21,02
Craig,State Senate,Micheal Bergstrom,REP,180410,3,13,261,277,1
Craig,State Senate,John Myers,DEM,180410,7,14,111,132,1
Craig,President,Donald Trump,REP,180520,8,38,249,295,
Craig,President,Gary Johnson,LIB,180520,0,0,13,13,
Craig,President,Hillary Clinton,DEM,180520,3,5,70,78,
Craig,U.S. Senate,James Lankford,REP,180520,9,36,238,283,
Craig,U.S. Senate,Robert Murphy,LIB,180520,0,0,6,6,
Craig,U.S. Senate,Mike Workman,DEM,180520,1,7,69,77,
Craig,U.S. Senate,Mark Beard,IND,180520,0,1,6,7,
Craig,U.S. Senate,Sean Braddy,IND,180520,0,0,6,6,
Craig,U.S. House,Markwayne Mullin,REP,180520,9,36,255,300,02
Craig,U.S. House,Joshua Harris-Till,DEM,180520,1,8,62,71,02
Craig,U.S. House,John Mccarthy,IND,180520,0,0,10,10,02
Craig,State Senate,Micheal Bergstrom,REP,180520,5,18,143,166,1
Craig,State Senate,John Myers,DEM,180520,4,26,187,217,1
Craig,President,Donald Trump,REP,180611,6,39,288,333,
Craig,President,Gary Johnson,LIB,180611,0,2,29,31,
Craig,President,Hillary Clinton,DEM,180611,4,23,104,131,
Craig,U.S. Senate,James Lankford,REP,180611,7,45,282,334,
Craig,U.S. Senate,Robert Murphy,LIB,180611,0,0,17,17,
Craig,U.S. Senate,Mike Workman,DEM,180611,3,18,97,118,
Craig,U.S. Senate,Mark Beard,IND,180611,0,1,10,11,
Craig,U.S. Senate,Sean Braddy,IND,180611,0,0,9,9,
Craig,U.S. House,Markwayne Mullin,REP,180611,7,46,297,350,02
Craig,U.S. House,Joshua Harris-Till,DEM,180611,3,17,82,102,02
Craig,U.S. House,John Mccarthy,IND,180611,0,1,37,38,02
Craig,State Senate,Micheal Bergstrom,REP,180611,4,22,167,193,1
Craig,State Senate,John Myers,DEM,180611,6,42,251,299,1
Craig,President,Donald Trump,REP,180612,9,23,204,236,
Craig,President,Gary Johnson,LIB,180612,0,3,12,15,
Craig,President,Hillary Clinton,DEM,180612,4,13,83,100,
Craig,U.S. Senate,James Lankford,REP,180612,11,21,222,254,
Craig,U.S. Senate,Robert Murphy,LIB,180612,1,0,8,9,
Craig,U.S. Senate,Mike Workman,DEM,180612,1,15,60,76,
Craig,U.S. Senate,Mark Beard,IND,180612,0,2,3,5,
Craig,U.S. Senate,Sean Braddy,IND,180612,0,0,4,4,
Craig,U.S. House,Markwayne Mullin,REP,180612,11,24,213,248,02
Craig,U.S. House,Joshua Harris-Till,DEM,180612,1,12,59,72,02
Craig,U.S. House,John Mccarthy,IND,180612,1,2,23,26,02
Craig,State Senate,Micheal Bergstrom,REP,180612,5,15,143,163,1
Craig,State Senate,John Myers,DEM,180612,8,24,153,185,1
Craig,President,Donald Trump,REP,180621,14,80,451,545,
Craig,President,Gary Johnson,LIB,180621,4,4,33,41,
Craig,President,Hillary Clinton,DEM,180621,18,36,171,225,
Craig,U.S. Senate,James Lankford,REP,180621,19,86,450,555,
Craig,U.S. Senate,Robert Murphy,LIB,180621,2,2,15,19,
Craig,U.S. Senate,Mike Workman,DEM,180621,15,30,159,204,
Craig,U.S. Senate,Mark Beard,IND,180621,0,1,9,10,
Craig,U.S. Senate,Sean Braddy,IND,180621,0,2,12,14,
Craig,U.S. House,Markwayne Mullin,REP,180621,16,88,474,578,02
Craig,U.S. House,Joshua Harris-Till,DEM,180621,15,30,145,190,02
Craig,U.S. House,John Mccarthy,IND,180621,5,2,28,35,02
Craig,State Senate,Micheal Bergstrom,REP,180621,12,46,267,325,1
Craig,State Senate,John Myers,DEM,180621,24,74,381,479,1
Craig,President,Donald Trump,REP,180622,18,35,244,297,
Craig,President,Gary Johnson,LIB,180622,0,2,28,30,
Craig,President,Hillary Clinton,DEM,180622,4,21,134,159,
Craig,U.S. Senate,James Lankford,REP,180622,13,35,248,296,
Craig,U.S. Senate,Robert Murphy,LIB,180622,1,1,6,8,
Craig,U.S. Senate,Mike Workman,DEM,180622,5,22,136,163,
Craig,U.S. Senate,Mark Beard,IND,180622,2,0,11,13,
Craig,U.S. Senate,Sean Braddy,IND,180622,0,1,3,4,
Craig,U.S. House,Markwayne Mullin,REP,180622,15,39,251,305,02
Craig,U.S. House,Joshua Harris-Till,DEM,180622,3,18,123,144,02
Craig,U.S. House,John Mccarthy,IND,180622,3,1,29,33,02
Craig,State Senate,Micheal Bergstrom,REP,180622,11,20,164,195,1
Craig,State Senate,John Myers,DEM,180622,10,38,241,289,1
Craig,President,Donald Trump,REP,180710,15,38,259,312,
Craig,President,Gary Johnson,LIB,180710,0,4,15,19,
Craig,President,Hillary Clinton,DEM,180710,6,8,62,76,
Craig,U.S. Senate,James Lankford,REP,180710,14,37,261,312,
Craig,U.S. Senate,Robert Murphy,LIB,180710,1,0,5,6,
Craig,U.S. Senate,Mike Workman,DEM,180710,6,10,60,76,
Craig,U.S. Senate,Mark Beard,IND,180710,0,1,1,2,
Craig,U.S. Senate,Sean Braddy,IND,180710,0,1,3,4,
Craig,U.S. House,Markwayne Mullin,REP,180710,14,36,267,317,02
Craig,U.S. House,Joshua Harris-Till,DEM,180710,6,10,48,64,02
Craig,U.S. House,John Mccarthy,IND,180710,1,3,18,22,02
Craig,State Senate,Micheal Bergstrom,REP,180710,5,28,174,207,1
Craig,State Senate,John Myers,DEM,180710,16,22,161,199,1
Craig,President,Donald Trump,REP,180810,7,52,400,459,
Craig,President,Gary Johnson,LIB,180810,2,1,17,20,
Craig,President,Hillary Clinton,DEM,180810,4,14,77,95,
Craig,U.S. Senate,James Lankford,REP,180810,10,51,391,452,
Craig,U.S. Senate,Robert Murphy,LIB,180810,0,1,11,12,
Craig,U.S. Senate,Mike Workman,DEM,180810,3,12,73,88,
Craig,U.S. Senate,Mark Beard,IND,180810,0,1,6,7,
Craig,U.S. Senate,Sean Braddy,IND,180810,0,0,10,10,
Craig,U.S. House,Markwayne Mullin,REP,180810,9,52,392,453,02
Craig,U.S. House,Joshua Harris-Till,DEM,180810,2,12,77,91,02
Craig,U.S. House,John Mccarthy,IND,180810,2,1,20,23,02
Craig,State Senate,Micheal Bergstrom,REP,180810,8,32,296,336,1
Craig,State Senate,John Myers,DEM,180810,5,33,193,231,1
Craig,President,Donald Trump,REP,180820,15,73,411,499,
Craig,President,Gary Johnson,LIB,180820,1,0,18,19,
Craig,President,Hillary Clinton,DEM,180820,4,7,89,100,
Craig,U.S. Senate,James Lankford,REP,180820,18,66,398,482,
Craig,U.S. Senate,Robert Murphy,LIB,180820,1,1,10,12,
Craig,U.S. Senate,Mike Workman,DEM,180820,1,11,89,101,
Craig,U.S. Senate,Mark Beard,IND,180820,0,0,9,9,
Craig,U.S. Senate,Sean Braddy,IND,180820,0,0,11,11,
Craig,U.S. House,Markwayne Mullin,REP,180820,18,67,403,488,02
Craig,U.S. House,Joshua Harris-Till,DEM,180820,2,7,87,96,02
Craig,U.S. House,John Mccarthy,IND,180820,0,6,28,34,02
Craig,State Senate,Micheal Bergstrom,REP,180820,15,46,276,337,1
Craig,State Senate,John Myers,DEM,180820,5,34,233,272,1
Craig,President,Donald Trump,REP,180910,8,52,241,301,
Craig,President,Gary Johnson,LIB,180910,0,3,12,15,
Craig,President,Hillary Clinton,DEM,180910,4,8,73,85,
Craig,U.S. Senate,James Lankford,REP,180910,7,52,251,310,
Craig,U.S. Senate,Robert Murphy,LIB,180910,0,0,7,7,
Craig,U.S. Senate,Mike Workman,DEM,180910,5,8,59,72,
Craig,U.S. Senate,Mark Beard,IND,180910,0,1,4,5,
Craig,U.S. Senate,Sean Braddy,IND,180910,0,0,4,4,
Craig,U.S. House,Markwayne Mullin,REP,180910,8,54,259,321,02
Craig,U.S. House,Joshua Harris-Till,DEM,180910,4,7,53,64,02
Craig,U.S. House,John Mccarthy,IND,180910,0,0,14,14,02
Craig,State Senate,Micheal Bergstrom,REP,180910,5,22,167,194,1
Craig,State Senate,John Myers,DEM,180910,7,41,158,206,1
Creek,President,Donald Trump,REP,190111,20,108,505,633,
Creek,President,Gary Johnson,LIB,190111,2,2,45,49,
Creek,President,Hillary Clinton,DEM,190111,6,44,142,192,
Creek,U.S. Senate,James Lankford,REP,190111,18,108,501,627,
Creek,U.S. Senate,Robert Murphy,LIB,190111,1,1,25,27,
Creek,U.S. Senate,Mike Workman,DEM,190111,4,39,123,166,
Creek,U.S. Senate,Mark Beard,IND,190111,2,2,15,19,
Creek,U.S. Senate,Sean Braddy,IND,190111,2,3,22,27,
Creek,U.S. House,Frank Lucas,REP,190111,16,105,505,626,03
Creek,U.S. House,Frankie Robbins,DEM,190111,10,46,169,225,03
Creek,President,Donald Trump,REP,190112,4,23,229,256,
Creek,President,Gary Johnson,LIB,190112,1,5,13,19,
Creek,President,Hillary Clinton,DEM,190112,3,10,39,52,
Creek,U.S. Senate,James Lankford,REP,190112,4,21,214,239,
Creek,U.S. Senate,Robert Murphy,LIB,190112,1,5,8,14,
Creek,U.S. Senate,Mike Workman,DEM,190112,3,11,37,51,
Creek,U.S. Senate,Mark Beard,IND,190112,0,0,8,8,
Creek,U.S. Senate,Sean Braddy,IND,190112,0,0,13,13,
Creek,U.S. House,Frank Lucas,REP,190112,5,24,217,246,03
Creek,U.S. House,Frankie Robbins,DEM,190112,3,13,55,71,03
Creek,President,Donald Trump,REP,190121,37,191,707,935,
Creek,President,Gary Johnson,LIB,190121,4,9,51,64,
Creek,President,Hillary Clinton,DEM,190121,20,65,165,250,
Creek,U.S. Senate,James Lankford,REP,190121,36,200,714,950,
Creek,U.S. Senate,Robert Murphy,LIB,190121,1,6,30,37,
Creek,U.S. Senate,Mike Workman,DEM,190121,21,54,146,221,
Creek,U.S. Senate,Mark Beard,IND,190121,2,2,17,21,
Creek,U.S. Senate,Sean Braddy,IND,190121,0,3,10,13,
Creek,U.S. House,Frank Lucas,REP,190121,38,194,726,958,03
Creek,U.S. House,Frankie Robbins,DEM,190121,22,70,185,277,03
Creek,State House,Kyle Hilbert,REP,190121,34,156,621,811,29
Creek,State House,Macy Gleason,DEM,190121,25,109,291,425,29
Creek,President,Donald Trump,REP,190122,2,14,69,85,
Creek,President,Gary Johnson,LIB,190122,0,2,10,12,
Creek,President,Hillary Clinton,DEM,190122,5,30,148,183,
Creek,U.S. Senate,James Lankford,REP,190122,2,13,75,90,
Creek,U.S. Senate,Robert Murphy,LIB,190122,0,1,8,9,
Creek,U.S. Senate,Mike Workman,DEM,190122,6,29,130,165,
Creek,U.S. Senate,Mark Beard,IND,190122,0,2,5,7,
Creek,U.S. Senate,Sean Braddy,IND,190122,0,1,6,7,
Creek,U.S. House,Frank Lucas,REP,190122,2,15,75,92,03
Creek,U.S. House,Frankie Robbins,DEM,190122,6,31,149,186,03
Creek,President,Donald Trump,REP,190131,10,72,285,367,
Creek,President,Gary Johnson,LIB,190131,2,4,27,33,
Creek,President,Hillary Clinton,DEM,190131,8,30,107,145,
Creek,U.S. Senate,James Lankford,REP,190131,10,70,291,371,
Creek,U.S. Senate,Robert Murphy,LIB,190131,0,3,13,16,
Creek,U.S. Senate,Mike Workman,DEM,190131,7,28,87,122,
Creek,U.S. Senate,Mark Beard,IND,190131,0,2,12,14,
Creek,U.S. Senate,Sean Braddy,IND,190131,1,2,8,11,
Creek,U.S. House,Frank Lucas,REP,190131,10,67,290,367,03
Creek,U.S. House,Frankie Robbins,DEM,190131,8,32,121,161,03
Creek,President,Donald Trump,REP,190132,27,183,495,705,
Creek,President,Gary Johnson,LIB,190132,1,3,39,43,
Creek,President,Hillary Clinton,DEM,190132,17,59,135,211,
Creek,U.S. Senate,James Lankford,REP,190132,26,183,489,698,
Creek,U.S. Senate,Robert Murphy,LIB,190132,1,2,15,18,
Creek,U.S. Senate,Mike Workman,DEM,190132,11,51,115,177,
Creek,U.S. Senate,Mark Beard,IND,190132,1,1,21,23,
Creek,U.S. Senate,Sean Braddy,IND,190132,1,5,20,26,
Creek,U.S. House,Frank Lucas,REP,190132,28,186,502,716,03
Creek,U.S. House,Frankie Robbins,DEM,190132,13,54,150,217,03
Creek,President,Donald Trump,REP,190142,52,372,949,1373,
Creek,President,Gary Johnson,LIB,190142,10,27,104,141,
Creek,President,Hillary Clinton,DEM,190142,19,153,326,498,
Creek,U.S. Senate,James Lankford,REP,190142,55,383,939,1377,
Creek,U.S. Senate,Robert Murphy,LIB,190142,4,18,51,73,
Creek,U.S. Senate,Mike Workman,DEM,190142,18,129,308,455,
Creek,U.S. Senate,Mark Beard,IND,190142,2,8,38,48,
Creek,U.S. Senate,Sean Braddy,IND,190142,1,10,24,35,
Creek,U.S. House,Frank Lucas,REP,190142,58,392,968,1418,03
Creek,U.S. House,Frankie Robbins,DEM,190142,19,146,373,538,03
Creek,President,Donald Trump,REP,190143,22,132,425,579,
Creek,President,Gary Johnson,LIB,190143,3,12,54,69,
Creek,President,Hillary Clinton,DEM,190143,12,70,176,258,
Creek,U.S. Senate,James Lankford,REP,190143,21,134,425,580,
Creek,U.S. Senate,Robert Murphy,LIB,190143,3,8,23,34,
Creek,U.S. Senate,Mike Workman,DEM,190143,13,59,170,242,
Creek,U.S. Senate,Mark Beard,IND,190143,1,4,15,20,
Creek,U.S. Senate,Sean Braddy,IND,190143,0,6,13,19,
Creek,U.S. House,Frank Lucas,REP,190143,22,132,426,580,03
Creek,U.S. House,Frankie Robbins,DEM,190143,14,70,205,289,03
Creek,President,Donald Trump,REP,190211,13,7,255,275,
Creek,President,Gary Johnson,LIB,190211,0,0,13,13,
Creek,President,Hillary Clinton,DEM,190211,15,6,105,126,
Creek,U.S. Senate,James Lankford,REP,190211,10,7,245,262,
Creek,U.S. Senate,Robert Murphy,LIB,190211,0,0,13,13,
Creek,U.S. Senate,Mike Workman,DEM,190211,15,3,98,116,
Creek,U.S. Senate,Mark Beard,IND,190211,1,0,9,10,
Creek,U.S. Senate,Sean Braddy,IND,190211,1,3,8,12,
Creek,U.S. House,Frank Lucas,REP,190211,11,5,239,255,03
Creek,U.S. House,Frankie Robbins,DEM,190211,16,8,130,154,03
Creek,State House,Kyle Hilbert,REP,190211,12,5,216,233,29
Creek,State House,Macy Gleason,DEM,190211,15,8,158,181,29
Creek,President,Donald Trump,REP,190221,5,6,175,186,
Creek,President,Gary Johnson,LIB,190221,0,0,17,17,
Creek,President,Hillary Clinton,DEM,190221,0,3,99,102,
Creek,U.S. Senate,James Lankford,REP,190221,5,7,169,181,
Creek,U.S. Senate,Robert Murphy,LIB,190221,0,0,8,8,
Creek,U.S. Senate,Mike Workman,DEM,190221,0,1,85,86,
Creek,U.S. Senate,Mark Beard,IND,190221,0,0,8,8,
Creek,U.S. Senate,Sean Braddy,IND,190221,0,1,14,15,
Creek,U.S. House,Frank Lucas,REP,190221,4,6,172,182,03
Creek,U.S. House,Frankie Robbins,DEM,190221,1,3,109,113,03
Creek,State House,Kyle Hilbert,REP,190221,4,5,164,173,29
Creek,State House,Macy Gleason,DEM,190221,1,4,124,129,29
Creek,President,Donald Trump,REP,190231,10,19,271,300,
Creek,President,Gary Johnson,LIB,190231,0,1,17,18,
Creek,President,Hillary Clinton,DEM,190231,7,2,120,129,
Creek,U.S. Senate,James Lankford,REP,190231,10,18,282,310,
Creek,U.S. Senate,Robert Murphy,LIB,190231,0,2,11,13,
Creek,U.S. Senate,Mike Workman,DEM,190231,5,2,101,108,
Creek,U.S. Senate,Mark Beard,IND,190231,1,0,6,7,
Creek,U.S. Senate,Sean Braddy,IND,190231,0,0,10,10,
Creek,U.S. House,Frank Lucas,REP,190231,11,19,272,302,03
Creek,U.S. House,Frankie Robbins,DEM,190231,5,3,132,140,03
Creek,State House,Kyle Hilbert,REP,190231,9,19,249,277,29
Creek,State House,Macy Gleason,DEM,190231,7,3,161,171,29
Creek,President,Donald Trump,REP,190241,13,11,292,316,
Creek,President,Gary Johnson,LIB,190241,1,2,21,24,
Creek,President,Hillary Clinton,DEM,190241,7,4,100,111,
Creek,U.S. Senate,James Lankford,REP,190241,15,10,272,297,
Creek,U.S. Senate,Robert Murphy,LIB,190241,0,0,14,14,
Creek,U.S. Senate,Mike Workman,DEM,190241,5,5,109,119,
Creek,U.S. Senate,Mark Beard,IND,190241,0,0,10,10,
Creek,U.S. Senate,Sean Braddy,IND,190241,1,1,9,11,
Creek,U.S. House,Frank Lucas,REP,190241,16,11,288,315,03
Creek,U.S. House,Frankie Robbins,DEM,190241,5,5,123,133,03
Creek,State House,Kyle Hilbert,REP,190241,13,12,256,281,29
Creek,State House,Macy Gleason,DEM,190241,7,4,158,169,29
Creek,President,Donald Trump,REP,190311,20,15,663,698,
Creek,President,Gary Johnson,LIB,190311,3,0,44,47,
Creek,President,Hillary Clinton,DEM,190311,17,8,143,168,
Creek,U.S. Senate,James Lankford,REP,190311,20,14,651,685,
Creek,U.S. Senate,Robert Murphy,LIB,190311,1,0,29,30,
Creek,U.S. Senate,Mike Workman,DEM,190311,11,8,127,146,
Creek,U.S. Senate,Mark Beard,IND,190311,0,1,17,18,
Creek,U.S. Senate,Sean Braddy,IND,190311,3,0,20,23,
Creek,U.S. House,Frank Lucas,REP,190311,22,15,662,699,03
Creek,U.S. House,Frankie Robbins,DEM,190311,13,8,177,198,03
Creek,President,Donald Trump,REP,190401,21,107,524,652,
Creek,President,Gary Johnson,LIB,190401,0,10,37,47,
Creek,President,Hillary Clinton,DEM,190401,2,23,90,115,
Creek,U.S. Senate,James Lankford,REP,190401,20,106,499,625,
Creek,U.S. Senate,Robert Murphy,LIB,190401,0,2,25,27,
Creek,U.S. Senate,Mike Workman,DEM,190401,2,30,84,116,
Creek,U.S. Senate,Mark Beard,IND,190401,1,2,25,28,
Creek,U.S. Senate,Sean Braddy,IND,190401,0,1,15,16,
Creek,U.S. House,Frank Lucas,REP,190401,18,108,500,626,03
Creek,U.S. House,Frankie Robbins,DEM,190401,3,33,133,169,03
Creek,State House,Kyle Hilbert,REP,190401,19,90,432,541,29
Creek,State House,Macy Gleason,DEM,190401,4,51,212,267,29
Creek,President,Donald Trump,REP,190402,30,166,488,684,
Creek,President,Gary Johnson,LIB,190402,2,8,36,46,
Creek,President,Hillary Clinton,DEM,190402,19,41,134,194,
Creek,U.S. Senate,James Lankford,REP,190402,30,172,479,681,
Creek,U.S. Senate,Robert Murphy,LIB,190402,0,0,18,18,
Creek,U.S. Senate,Mike Workman,DEM,190402,16,38,113,167,
Creek,U.S. Senate,Mark Beard,IND,190402,2,2,20,24,
Creek,U.S. Senate,Sean Braddy,IND,190402,2,1,18,21,
Creek,U.S. House,Frank Lucas,REP,190402,32,170,481,683,03
Creek,U.S. House,Frankie Robbins,DEM,190402,18,43,159,220,03
Creek,State House,Kyle Hilbert,REP,190402,21,146,412,579,29
Creek,State House,Macy Gleason,DEM,190402,29,67,229,325,29
Creek,President,Donald Trump,REP,190403,21,78,647,746,
Creek,President,Gary Johnson,LIB,190403,5,2,30,37,
Creek,President,Hillary Clinton,DEM,190403,5,26,123,154,
Creek,U.S. Senate,James Lankford,REP,190403,24,86,625,735,
Creek,U.S. Senate,Robert Murphy,LIB,190403,1,1,14,16,
Creek,U.S. Senate,Mike Workman,DEM,190403,3,18,133,154,
Creek,U.S. Senate,Mark Beard,IND,190403,2,0,10,12,
Creek,U.S. Senate,Sean Braddy,IND,190403,3,2,21,26,
Creek,U.S. House,Frank Lucas,REP,190403,25,85,632,742,03
Creek,U.S. House,Frankie Robbins,DEM,190403,8,23,163,194,03
Creek,State House,Kyle Hilbert,REP,190403,25,68,541,634,29
Creek,State House,Macy Gleason,DEM,190403,8,40,254,302,29
Creek,President,Donald Trump,REP,190404,70,124,1263,1457,
Creek,President,Gary Johnson,LIB,190404,5,6,72,83,
Creek,President,Hillary Clinton,DEM,190404,18,45,254,317,
Creek,U.S. Senate,James Lankford,REP,190404,74,123,1275,1472,
Creek,U.S. Senate,Robert Murphy,LIB,190404,4,0,42,46,
Creek,U.S. Senate,Mike Workman,DEM,190404,15,36,224,275,
Creek,U.S. Senate,Mark Beard,IND,190404,1,4,25,30,
Creek,U.S. Senate,Sean Braddy,IND,190404,1,9,28,38,
Creek,U.S. House,Frank Lucas,REP,190404,75,123,1277,1475,03
Creek,U.S. House,Frankie Robbins,DEM,190404,20,49,298,367,03
Creek,State House,Kyle Hilbert,REP,190404,57,95,879,1031,29
Creek,State House,Macy Gleason,DEM,190404,35,78,703,816,29
Creek,President,Donald Trump,REP,190405,46,80,728,854,
Creek,President,Gary Johnson,LIB,190405,6,1,46,53,
Creek,President,Hillary Clinton,DEM,190405,10,12,97,119,
Creek,U.S. Senate,James Lankford,REP,190405,47,73,689,809,
Creek,U.S. Senate,Robert Murphy,LIB,190405,2,4,27,33,
Creek,U.S. Senate,Mike Workman,DEM,190405,10,13,116,139,
Creek,U.S. Senate,Mark Beard,IND,190405,3,3,15,21,
Creek,U.S. Senate,Sean Braddy,IND,190405,0,0,17,17,
Creek,U.S. House,Frank Lucas,REP,190405,50,80,706,836,03
Creek,U.S. House,Frankie Robbins,DEM,190405,12,11,152,175,03
Creek,President,Donald Trump,REP,190406,14,8,457,479,
Creek,President,Gary Johnson,LIB,190406,1,0,22,23,
Creek,President,Hillary Clinton,DEM,190406,1,0,96,97,
Creek,U.S. Senate,James Lankford,REP,190406,15,7,453,475,
Creek,U.S. Senate,Robert Murphy,LIB,190406,1,0,13,14,
Creek,U.S. Senate,Mike Workman,DEM,190406,1,0,92,93,
Creek,U.S. Senate,Mark Beard,IND,190406,0,0,9,9,
Creek,U.S. Senate,Sean Braddy,IND,190406,0,0,9,9,
Creek,U.S. House,Frank Lucas,REP,190406,15,6,453,474,03
Creek,U.S. House,Frankie Robbins,DEM,190406,1,1,122,124,03
Creek,President,Donald Trump,REP,190407,4,17,238,259,
Creek,President,Gary Johnson,LIB,190407,0,2,10,12,
Creek,President,Hillary Clinton,DEM,190407,0,0,57,57,
Creek,U.S. Senate,James Lankford,REP,190407,4,17,240,261,
Creek,U.S. Senate,Robert Murphy,LIB,190407,0,0,6,6,
Creek,U.S. Senate,Mike Workman,DEM,190407,0,1,51,52,
Creek,U.S. Senate,Mark Beard,IND,190407,0,1,5,6,
Creek,U.S. Senate,Sean Braddy,IND,190407,0,0,3,3,
Creek,U.S. House,Frank Lucas,REP,190407,4,17,233,254,03
Creek,U.S. House,Frankie Robbins,DEM,190407,0,2,69,71,03
Creek,President,Donald Trump,REP,190408,10,13,297,320,
Creek,President,Gary Johnson,LIB,190408,2,3,17,22,
Creek,President,Hillary Clinton,DEM,190408,0,0,49,49,
Creek,U.S. Senate,James Lankford,REP,190408,10,14,298,322,
Creek,U.S. Senate,Robert Murphy,LIB,190408,0,0,10,10,
Creek,U.S. Senate,Mike Workman,DEM,190408,0,1,40,41,
Creek,U.S. Senate,Mark Beard,IND,190408,0,0,11,11,
Creek,U.S. Senate,Sean Braddy,IND,190408,0,1,5,6,
Creek,U.S. House,Frank Lucas,REP,190408,10,15,305,330,03
Creek,U.S. House,Frankie Robbins,DEM,190408,0,1,55,56,03
Creek,State House,Kyle Hilbert,REP,190408,11,12,286,309,29
Creek,State House,Macy Gleason,DEM,190408,1,4,78,83,29
Creek,President,Donald Trump,REP,190409,28,44,626,698,
Creek,President,Gary Johnson,LIB,190409,2,2,34,38,
Creek,President,Hillary Clinton,DEM,190409,6,20,144,170,
Creek,U.S. Senate,James Lankford,REP,190409,27,50,623,700,
Creek,U.S. Senate,Robert Murphy,LIB,190409,3,2,16,21,
Creek,U.S. Senate,Mike Workman,DEM,190409,5,14,132,151,
Creek,U.S. Senate,Mark Beard,IND,190409,1,1,14,16,
Creek,U.S. Senate,Sean Braddy,IND,190409,0,0,15,15,
Creek,U.S. House,Frank Lucas,REP,190409,29,47,621,697,03
Creek,U.S. House,Frankie Robbins,DEM,190409,8,18,166,192,03
Creek,State House,Kyle Hilbert,REP,190409,25,40,550,615,29
Creek,State House,Macy Gleason,DEM,190409,12,25,242,279,29
Creek,President,Donald Trump,REP,190410,3,4,197,204,
Creek,President,Gary Johnson,LIB,190410,0,0,14,14,
Creek,President,Hillary Clinton,DEM,190410,2,2,13,17,
Creek,U.S. Senate,James Lankford,REP,190410,4,2,192,198,
Creek,U.S. Senate,Robert Murphy,LIB,190410,0,0,5,5,
Creek,U.S. Senate,Mike Workman,DEM,190410,1,2,21,24,
Creek,U.S. Senate,Mark Beard,IND,190410,0,0,4,4,
Creek,U.S. Senate,Sean Braddy,IND,190410,0,1,2,3,
Creek,U.S. House,Frank Lucas,REP,190410,4,2,188,194,03
Creek,U.S. House,Frankie Robbins,DEM,190410,1,3,33,37,03
Creek,State House,Kyle Hilbert,REP,190410,3,3,185,191,29
Creek,State House,Macy Gleason,DEM,190410,2,3,38,43,29
Creek,President,Donald Trump,REP,190411,8,9,381,398,
Creek,President,Gary Johnson,LIB,190411,0,0,25,25,
Creek,President,Hillary Clinton,DEM,190411,3,3,111,117,
Creek,U.S. Senate,James Lankford,REP,190411,8,8,356,372,
Creek,U.S. Senate,Robert Murphy,LIB,190411,0,0,15,15,
Creek,U.S. Senate,Mike Workman,DEM,190411,3,3,112,118,
Creek,U.S. Senate,Mark Beard,IND,190411,0,1,11,12,
Creek,U.S. Senate,Sean Braddy,IND,190411,0,0,16,16,
Creek,U.S. House,Frank Lucas,REP,190411,8,8,355,371,03
Creek,U.S. House,Frankie Robbins,DEM,190411,3,3,150,156,03
Creek,State House,Kyle Hilbert,REP,190411,7,9,391,407,29
Creek,State House,Macy Gleason,DEM,190411,4,3,125,132,29
Creek,President,Donald Trump,REP,190412,13,20,384,417,
Creek,President,Gary Johnson,LIB,190412,0,1,25,26,
Creek,President,Hillary Clinton,DEM,190412,7,9,97,113,
Creek,U.S. Senate,James Lankford,REP,190412,12,18,378,408,
Creek,U.S. Senate,Robert Murphy,LIB,190412,0,1,13,14,
Creek,U.S. Senate,Mike Workman,DEM,190412,7,8,88,103,
Creek,U.S. Senate,Mark Beard,IND,190412,0,1,9,10,
Creek,U.S. Senate,Sean Braddy,IND,190412,0,1,12,13,
Creek,U.S. House,Frank Lucas,REP,190412,12,19,385,416,03
Creek,U.S. House,Frankie Robbins,DEM,190412,7,10,111,128,03
Creek,State House,Kyle Hilbert,REP,190412,12,17,353,382,29
Creek,State House,Macy Gleason,DEM,190412,7,12,152,171,29
Creek,President,Donald Trump,REP,190413,16,22,582,620,
Creek,President,Gary Johnson,LIB,190413,0,3,23,26,
Creek,President,Hillary Clinton,DEM,190413,5,13,149,167,
Creek,U.S. Senate,James Lankford,REP,190413,18,28,586,632,
Creek,U.S. Senate,Robert Murphy,LIB,190413,0,0,11,11,
Creek,U.S. Senate,Mike Workman,DEM,190413,3,10,134,147,
Creek,U.S. Senate,Mark Beard,IND,190413,0,0,8,8,
Creek,U.S. Senate,Sean Braddy,IND,190413,0,0,13,13,
Creek,U.S. House,Frank Lucas,REP,190413,18,25,577,620,03
Creek,U.S. House,Frankie Robbins,DEM,190413,3,13,167,183,03
Creek,State House,Kyle Hilbert,REP,190413,16,23,547,586,29
Creek,State House,Macy Gleason,DEM,190413,4,15,204,223,29
Creek,President,Donald Trump,REP,190414,42,236,1091,1369,
Creek,President,Gary Johnson,LIB,190414,1,10,59,70,
Creek,President,Hillary Clinton,DEM,190414,20,48,208,276,
Creek,U.S. Senate,James Lankford,REP,190414,43,243,1063,1349,
Creek,U.S. Senate,Robert Murphy,LIB,190414,1,2,36,39,
Creek,U.S. Senate,Mike Workman,DEM,190414,15,45,200,260,
Creek,U.S. Senate,Mark Beard,IND,190414,1,1,22,24,
Creek,U.S. Senate,Sean Braddy,IND,190414,2,6,20,28,
Creek,U.S. House,Frank Lucas,REP,190414,43,245,1078,1366,03
Creek,U.S. House,Frankie Robbins,DEM,190414,19,50,256,325,03
Creek,State House,Kyle Hilbert,REP,190414,39,223,917,1179,29
Creek,State House,Macy Gleason,DEM,190414,23,70,421,514,29
Creek,President,Donald Trump,REP,190415,8,40,304,352,
Creek,President,Gary Johnson,LIB,190415,0,0,18,18,
Creek,President,Hillary Clinton,DEM,190415,4,14,60,78,
Creek,U.S. Senate,James Lankford,REP,190415,7,44,296,347,
Creek,U.S. Senate,Robert Murphy,LIB,190415,2,0,11,13,
Creek,U.S. Senate,Mike Workman,DEM,190415,2,6,56,64,
Creek,U.S. Senate,Mark Beard,IND,190415,0,1,7,8,
Creek,U.S. Senate,Sean Braddy,IND,190415,0,2,7,9,
Creek,State House,Kyle Hilbert,REP,190415,10,33,256,299,29
Creek,State House,Macy Gleason,DEM,190415,1,20,116,137,29
Creek,President,Donald Trump,REP,190416,16,49,582,647,
Creek,President,Gary Johnson,LIB,190416,3,4,31,38,
Creek,President,Hillary Clinton,DEM,190416,4,3,126,133,
Creek,U.S. Senate,James Lankford,REP,190416,19,50,570,639,
Creek,U.S. Senate,Robert Murphy,LIB,190416,0,1,20,21,
Creek,U.S. Senate,Mike Workman,DEM,190416,3,3,105,111,
Creek,U.S. Senate,Mark Beard,IND,190416,0,1,13,14,
Creek,U.S. Senate,Sean Braddy,IND,190416,0,1,14,15,
Creek,President,Donald Trump,REP,190417,46,296,1073,1415,
Creek,President,Gary Johnson,LIB,190417,3,12,67,82,
Creek,President,Hillary Clinton,DEM,190417,10,66,223,299,
Creek,U.S. Senate,James Lankford,REP,190417,42,294,1075,1411,
Creek,U.S. Senate,Robert Murphy,LIB,190417,3,2,26,31,
Creek,U.S. Senate,Mike Workman,DEM,190417,10,57,185,252,
Creek,U.S. Senate,Mark Beard,IND,190417,1,8,22,31,
Creek,U.S. Senate,Sean Braddy,IND,190417,2,3,30,35,
Creek,President,Donald Trump,REP,190418,49,209,670,928,
Creek,President,Gary Johnson,LIB,190418,3,3,42,48,
Creek,President,Hillary Clinton,DEM,190418,15,80,160,255,
Creek,U.S. Senate,James Lankford,REP,190418,57,218,699,974,
Creek,U.S. Senate,Robert Murphy,LIB,190418,0,2,14,16,
Creek,U.S. Senate,Mike Workman,DEM,190418,10,69,128,207,
Creek,U.S. Senate,Mark Beard,IND,190418,0,1,8,9,
Creek,U.S. Senate,Sean Braddy,IND,190418,1,2,17,20,
Creek,U.S. House,Frank Lucas,REP,190418,56,210,699,965,03
Creek,U.S. House,Frankie Robbins,DEM,190418,8,72,156,236,03
Creek,President,Donald Trump,REP,190419,37,115,641,793,
Creek,President,Gary Johnson,LIB,190419,6,5,39,50,
Creek,President,Hillary Clinton,DEM,190419,9,40,168,217,
Creek,U.S. Senate,James Lankford,REP,190419,37,110,647,794,
Creek,U.S. Senate,Robert Murphy,LIB,190419,2,2,25,29,
Creek,U.S. Senate,Mike Workman,DEM,190419,8,39,138,185,
Creek,U.S. Senate,Mark Beard,IND,190419,3,2,16,21,
Creek,U.S. Senate,Sean Braddy,IND,190419,2,6,14,22,
Creek,U.S. House,Frank Lucas,REP,190419,39,109,650,798,03
Creek,U.S. House,Frankie Robbins,DEM,190419,11,49,176,236,03
Creek,President,Donald Trump,REP,190420,16,42,344,402,
Creek,President,Gary Johnson,LIB,190420,1,2,30,33,
Creek,President,Hillary Clinton,DEM,190420,15,35,105,155,
Creek,U.S. Senate,James Lankford,REP,190420,16,43,379,438,
Creek,U.S. Senate,Robert Murphy,LIB,190420,1,1,15,17,
Creek,U.S. Senate,Mike Workman,DEM,190420,11,33,82,126,
Creek,U.S. Senate,Mark Beard,IND,190420,1,0,6,7,
Creek,U.S. Senate,Sean Braddy,IND,190420,2,1,2,5,
Creek,U.S. House,Frank Lucas,REP,190420,18,44,376,438,03
Creek,U.S. House,Frankie Robbins,DEM,190420,13,35,99,147,03
Creek,President,Donald Trump,REP,190421,58,69,597,724,
Creek,President,Gary Johnson,LIB,190421,4,1,41,46,
Creek,President,Hillary Clinton,DEM,190421,27,25,185,237,
Creek,U.S. Senate,James Lankford,REP,190421,66,71,615,752,
Creek,U.S. Senate,Robert Murphy,LIB,190421,3,2,15,20,
Creek,U.S. Senate,Mike Workman,DEM,190421,21,20,159,200,
Creek,U.S. Senate,Mark Beard,IND,190421,0,1,16,17,
Creek,U.S. Senate,Sean Braddy,IND,190421,0,1,16,17,
Creek,U.S. House,Frank Lucas,REP,190421,63,69,615,747,03
Creek,U.S. House,Frankie Robbins,DEM,190421,24,24,190,238,03
Creek,President,Donald Trump,REP,190422,26,43,380,449,
Creek,President,Gary Johnson,LIB,190422,0,1,27,28,
Creek,President,Hillary Clinton,DEM,190422,4,10,66,80,
Creek,U.S. Senate,James Lankford,REP,190422,28,44,373,445,
Creek,U.S. Senate,Robert Murphy,LIB,190422,0,1,11,12,
Creek,U.S. Senate,Mike Workman,DEM,190422,2,8,60,70,
Creek,U.S. Senate,Mark Beard,IND,190422,0,0,11,11,
Creek,U.S. Senate,Sean Braddy,IND,190422,0,1,12,13,
Creek,U.S. House,Frank Lucas,REP,190422,26,43,373,442,03
Creek,U.S. House,Frankie Robbins,DEM,190422,4,11,89,104,03
Creek,State House,Kyle Hilbert,REP,190422,23,40,330,393,29
Creek,State House,Macy Gleason,DEM,190422,7,12,133,152,29
Custer,President,Donald Trump,REP,200001,15,60,309,384,
Custer,President,Gary Johnson,LIB,200001,1,4,46,51,
Custer,President,Hillary Clinton,DEM,200001,9,33,178,220,
Custer,U.S. Senate,James Lankford,REP,200001,16,58,332,406,
Custer,U.S. Senate,Robert Murphy,LIB,200001,0,4,31,35,
Custer,U.S. Senate,Mike Workman,DEM,200001,4,33,140,177,
Custer,U.S. Senate,Mark Beard,IND,200001,0,3,14,17,
Custer,U.S. Senate,Sean Braddy,IND,200001,1,1,14,16,
Custer,U.S. House,Frank Lucas,REP,200001,17,64,371,452,03
Custer,U.S. House,Frankie Robbins,DEM,200001,5,34,157,196,03
Custer,President,Donald Trump,REP,200003,16,136,496,648,
Custer,President,Gary Johnson,LIB,200003,3,4,41,48,
Custer,President,Hillary Clinton,DEM,200003,6,24,151,181,
Custer,U.S. Senate,James Lankford,REP,200003,22,141,528,691,
Custer,U.S. Senate,Robert Murphy,LIB,200003,1,6,18,25,
Custer,U.S. Senate,Mike Workman,DEM,200003,3,16,119,138,
Custer,U.S. Senate,Mark Beard,IND,200003,0,2,8,10,
Custer,U.S. Senate,Sean Braddy,IND,200003,0,2,17,19,
Custer,U.S. House,Frank Lucas,REP,200003,20,141,570,731,03
Custer,U.S. House,Frankie Robbins,DEM,200003,4,27,119,150,03
Custer,President,Donald Trump,REP,200005,27,124,475,626,
Custer,President,Gary Johnson,LIB,200005,3,6,42,51,
Custer,President,Hillary Clinton,DEM,200005,13,53,131,197,
Custer,U.S. Senate,James Lankford,REP,200005,29,143,548,720,
Custer,U.S. Senate,Robert Murphy,LIB,200005,0,5,18,23,
Custer,U.S. Senate,Mike Workman,DEM,200005,9,35,79,123,
Custer,U.S. Senate,Mark Beard,IND,200005,0,1,7,8,
Custer,U.S. Senate,Sean Braddy,IND,200005,2,1,7,10,
Custer,U.S. House,Frank Lucas,REP,200005,31,144,553,728,03
Custer,U.S. House,Frankie Robbins,DEM,200005,10,41,107,158,03
Custer,President,Donald Trump,REP,200007,29,71,236,336,
Custer,President,Gary Johnson,LIB,200007,0,3,19,22,
Custer,President,Hillary Clinton,DEM,200007,6,40,141,187,
Custer,U.S. Senate,James Lankford,REP,200007,28,77,248,353,
Custer,U.S. Senate,Robert Murphy,LIB,200007,0,2,8,10,
Custer,U.S. Senate,Mike Workman,DEM,200007,5,32,125,162,
Custer,U.S. Senate,Mark Beard,IND,200007,2,2,5,9,
Custer,U.S. Senate,Sean Braddy,IND,200007,0,1,10,11,
Custer,U.S. House,Frank Lucas,REP,200007,30,79,262,371,03
Custer,U.S. House,Frankie Robbins,DEM,200007,5,36,133,174,03
Custer,President,Donald Trump,REP,200012,17,60,437,514,
Custer,President,Gary Johnson,LIB,200012,0,3,28,31,
Custer,President,Hillary Clinton,DEM,200012,5,16,63,84,
Custer,U.S. Senate,James Lankford,REP,200012,17,62,453,532,
Custer,U.S. Senate,Robert Murphy,LIB,200012,0,0,11,11,
Custer,U.S. Senate,Mike Workman,DEM,200012,4,16,44,64,
Custer,U.S. Senate,Mark Beard,IND,200012,0,0,5,5,
Custer,U.S. Senate,Sean Braddy,IND,200012,1,1,10,12,
Custer,U.S. House,Frank Lucas,REP,200012,19,63,456,538,03
Custer,U.S. House,Frankie Robbins,DEM,200012,3,16,63,82,03
Custer,President,Donald Trump,REP,200013,7,20,211,238,
Custer,President,Gary Johnson,LIB,200013,0,0,13,13,
Custer,President,Hillary Clinton,DEM,200013,0,6,35,41,
Custer,U.S. Senate,James Lankford,REP,200013,7,22,212,241,
Custer,U.S. Senate,Robert Murphy,LIB,200013,0,0,1,1,
Custer,U.S. Senate,Mike Workman,DEM,200013,0,4,37,41,
Custer,U.S. Senate,Mark Beard,IND,200013,0,0,4,4,
Custer,U.S. Senate,Sean Braddy,IND,200013,0,0,2,2,
Custer,U.S. House,Frank Lucas,REP,200013,7,23,216,246,03
Custer,U.S. House,Frankie Robbins,DEM,200013,0,3,39,42,03
Custer,President,Donald Trump,REP,200018,50,108,790,948,
Custer,President,Gary Johnson,LIB,200018,3,7,46,56,
Custer,President,Hillary Clinton,DEM,200018,13,27,190,230,
Custer,U.S. Senate,James Lankford,REP,200018,54,114,832,1000,
Custer,U.S. Senate,Robert Murphy,LIB,200018,0,2,28,30,
Custer,U.S. Senate,Mike Workman,DEM,200018,11,19,141,171,
Custer,U.S. Senate,Mark Beard,IND,200018,0,1,6,7,
Custer,U.S. Senate,Sean Braddy,IND,200018,0,5,18,23,
Custer,U.S. House,Frank Lucas,REP,200018,54,116,845,1015,03
Custer,U.S. House,Frankie Robbins,DEM,200018,11,24,177,212,03
Custer,President,Donald Trump,REP,200019,45,88,697,830,
Custer,President,Gary Johnson,LIB,200019,2,5,77,84,
Custer,President,Hillary Clinton,DEM,200019,18,16,173,207,
Custer,U.S. Senate,James Lankford,REP,200019,48,92,753,893,
Custer,U.S. Senate,Robert Murphy,LIB,200019,0,2,32,34,
Custer,U.S. Senate,Mike Workman,DEM,200019,9,13,143,165,
Custer,U.S. Senate,Mark Beard,IND,200019,1,1,14,16,
Custer,U.S. Senate,Sean Braddy,IND,200019,3,1,12,16,
Custer,U.S. House,Frank Lucas,REP,200019,45,92,779,916,03
Custer,U.S. House,Frankie Robbins,DEM,200019,17,17,174,208,03
Custer,President,Donald Trump,REP,200020,68,94,874,1036,
Custer,President,Gary Johnson,LIB,200020,3,2,46,51,
Custer,President,Hillary Clinton,DEM,200020,24,27,173,224,
Custer,U.S. Senate,James Lankford,REP,200020,80,98,914,1092,
Custer,U.S. Senate,Robert Murphy,LIB,200020,1,1,24,26,
Custer,U.S. Senate,Mike Workman,DEM,200020,14,22,130,166,
Custer,U.S. Senate,Mark Beard,IND,200020,0,0,14,14,
Custer,U.S. Senate,Sean Braddy,IND,200020,0,0,11,11,
Custer,U.S. House,Frank Lucas,REP,200020,77,94,936,1107,03
Custer,U.S. House,Frankie Robbins,DEM,200020,18,25,154,197,03
Custer,President,Donald Trump,REP,200021,33,48,806,887,
Custer,President,Gary Johnson,LIB,200021,4,3,144,151,
Custer,President,Hillary Clinton,DEM,200021,21,28,303,352,
Custer,U.S. Senate,James Lankford,REP,200021,33,53,880,966,
Custer,U.S. Senate,Robert Murphy,LIB,200021,3,2,54,59,
Custer,U.S. Senate,Mike Workman,DEM,200021,18,23,242,283,
Custer,U.S. Senate,Mark Beard,IND,200021,0,1,25,26,
Custer,U.S. Senate,Sean Braddy,IND,200021,3,0,49,52,
Custer,U.S. House,Frank Lucas,REP,200021,38,56,909,1003,03
Custer,U.S. House,Frankie Robbins,DEM,200021,18,24,330,372,03
Custer,President,Donald Trump,REP,200022,12,27,226,265,
Custer,President,Gary Johnson,LIB,200022,0,0,11,11,
Custer,President,Hillary Clinton,DEM,200022,2,4,23,29,
Custer,U.S. Senate,James Lankford,REP,200022,13,29,236,278,
Custer,U.S. Senate,Robert Murphy,LIB,200022,0,0,5,5,
Custer,U.S. Senate,Mike Workman,DEM,200022,1,2,19,22,
Custer,U.S. Senate,Mark Beard,IND,200022,0,0,2,2,
Custer,U.S. Senate,Sean Braddy,IND,200022,0,0,0,0,
Custer,U.S. House,Frank Lucas,REP,200022,13,29,233,275,03
Custer,U.S. House,Frankie Robbins,DEM,200022,1,2,28,31,03
Custer,President,Donald Trump,REP,200023,29,28,603,660,
Custer,President,Gary Johnson,LIB,200023,1,1,24,26,
Custer,President,Hillary Clinton,DEM,200023,4,9,85,98,
Custer,U.S. Senate,James Lankford,REP,200023,30,29,622,681,
Custer,U.S. Senate,Robert Murphy,LIB,200023,0,1,13,14,
Custer,U.S. Senate,Mike Workman,DEM,200023,4,9,59,72,
Custer,U.S. Senate,Mark Beard,IND,200023,0,0,6,6,
Custer,U.S. Senate,Sean Braddy,IND,200023,0,0,14,14,
Custer,U.S. House,Frank Lucas,REP,200023,30,30,635,695,03
Custer,U.S. House,Frankie Robbins,DEM,200023,4,9,77,90,03
Custer,President,Donald Trump,REP,200026,31,40,383,454,
Custer,President,Gary Johnson,LIB,200026,0,1,15,16,
Custer,President,Hillary Clinton,DEM,200026,3,7,44,54,
Custer,U.S. Senate,James Lankford,REP,200026,28,40,396,464,
Custer,U.S. Senate,Robert Murphy,LIB,200026,0,2,4,6,
Custer,U.S. Senate,Mike Workman,DEM,200026,5,5,34,44,
Custer,U.S. Senate,Mark Beard,IND,200026,1,0,3,4,
Custer,U.S. Senate,Sean Braddy,IND,200026,0,0,6,6,
Custer,U.S. House,Frank Lucas,REP,200026,30,41,400,471,03
Custer,U.S. House,Frankie Robbins,DEM,200026,4,5,41,50,03
Delaware,President,Donald Trump,REP,210001,64,23,718,805,
Delaware,President,Gary Johnson,LIB,210001,6,0,17,23,
Delaware,President,Hillary Clinton,DEM,210001,13,8,180,201,
Delaware,U.S. Senate,James Lankford,REP,210001,59,25,710,794,
Delaware,U.S. Senate,Robert Murphy,LIB,210001,4,1,10,15,
Delaware,U.S. Senate,Mike Workman,DEM,210001,12,5,160,177,
Delaware,U.S. Senate,Mark Beard,IND,210001,5,0,16,21,
Delaware,U.S. Senate,Sean Braddy,IND,210001,2,0,18,20,
Delaware,U.S. House,Markwayne Mullin,REP,210001,61,22,717,800,02
Delaware,U.S. House,Joshua Harris-Till,DEM,210001,13,7,157,177,02
Delaware,U.S. House,John Mccarthy,IND,210001,8,2,36,46,02
Delaware,State Senate,Micheal Bergstrom,REP,210001,57,24,634,715,1
Delaware,State Senate,John Myers,DEM,210001,20,7,272,299,1
Delaware,State House,Josh West,REP,210001,61,22,669,752,5
Delaware,State House,Matt Nowlin,DEM,210001,17,8,225,250,5
Delaware,President,Donald Trump,REP,210002,19,12,311,342,
Delaware,President,Gary Johnson,LIB,210002,2,0,10,12,
Delaware,President,Hillary Clinton,DEM,210002,5,7,100,112,
Delaware,U.S. Senate,James Lankford,REP,210002,18,13,297,328,
Delaware,U.S. Senate,Robert Murphy,LIB,210002,0,0,10,10,
Delaware,U.S. Senate,Mike Workman,DEM,210002,7,6,89,102,
Delaware,U.S. Senate,Mark Beard,IND,210002,0,0,9,9,
Delaware,U.S. Senate,Sean Braddy,IND,210002,0,0,10,10,
Delaware,U.S. House,Markwayne Mullin,REP,210002,21,12,299,332,02
Delaware,U.S. House,Joshua Harris-Till,DEM,210002,5,6,79,90,02
Delaware,U.S. House,John Mccarthy,IND,210002,0,1,38,39,02
Delaware,State Senate,Micheal Bergstrom,REP,210002,14,12,260,286,1
Delaware,State Senate,John Myers,DEM,210002,12,7,153,172,1
Delaware,State House,Josh West,REP,210002,17,14,285,316,5
Delaware,State House,Matt Nowlin,DEM,210002,8,5,126,139,5
Delaware,President,Donald Trump,REP,210003,45,26,584,655,
Delaware,President,Gary Johnson,LIB,210003,2,0,27,29,
Delaware,President,Hillary Clinton,DEM,210003,18,19,199,236,
Delaware,U.S. Senate,James Lankford,REP,210003,42,28,574,644,
Delaware,U.S. Senate,Robert Murphy,LIB,210003,4,1,13,18,
Delaware,U.S. Senate,Mike Workman,DEM,210003,16,15,190,221,
Delaware,U.S. Senate,Mark Beard,IND,210003,0,1,18,19,
Delaware,U.S. Senate,Sean Braddy,IND,210003,2,0,13,15,
Delaware,U.S. House,Markwayne Mullin,REP,210003,45,28,573,646,02
Delaware,U.S. House,Joshua Harris-Till,DEM,210003,14,16,184,214,02
Delaware,U.S. House,John Mccarthy,IND,210003,5,0,50,55,02
Delaware,State Senate,Micheal Bergstrom,REP,210003,35,23,541,599,1
Delaware,State Senate,John Myers,DEM,210003,29,22,259,310,1
Delaware,State House,Josh West,REP,210003,40,27,552,619,5
Delaware,State House,Matt Nowlin,DEM,210003,22,18,253,293,5
Delaware,President,Donald Trump,REP,210004,16,24,328,368,
Delaware,President,Gary Johnson,LIB,210004,0,3,18,21,
Delaware,President,Hillary Clinton,DEM,210004,8,9,110,127,
Delaware,U.S. Senate,James Lankford,REP,210004,16,25,318,359,
Delaware,U.S. Senate,Robert Murphy,LIB,210004,0,0,13,13,
Delaware,U.S. Senate,Mike Workman,DEM,210004,7,10,108,125,
Delaware,U.S. Senate,Mark Beard,IND,210004,1,0,7,8,
Delaware,U.S. Senate,Sean Braddy,IND,210004,0,0,5,5,
Delaware,U.S. House,Markwayne Mullin,REP,210004,15,26,313,354,02
Delaware,U.S. House,Joshua Harris-Till,DEM,210004,8,9,102,119,02
Delaware,U.S. House,John Mccarthy,IND,210004,1,1,37,39,02
Delaware,State Senate,Micheal Bergstrom,REP,210004,15,22,273,310,1
Delaware,State Senate,John Myers,DEM,210004,9,14,175,198,1
Delaware,State House,Hoguen Apperson,REP,210004,16,23,242,281,7
Delaware,State House,Ben Loring,DEM,210004,8,13,199,220,7
Delaware,President,Donald Trump,REP,210005,51,61,622,734,
Delaware,President,Gary Johnson,LIB,210005,5,3,23,31,
Delaware,President,Hillary Clinton,DEM,210005,24,31,138,193,
Delaware,U.S. Senate,James Lankford,REP,210005,59,60,595,714,
Delaware,U.S. Senate,Robert Murphy,LIB,210005,1,3,17,21,
Delaware,U.S. Senate,Mike Workman,DEM,210005,19,27,132,178,
Delaware,U.S. Senate,Mark Beard,IND,210005,0,2,17,19,
Delaware,U.S. Senate,Sean Braddy,IND,210005,1,3,10,14,
Delaware,U.S. House,Markwayne Mullin,REP,210005,52,61,600,713,02
Delaware,U.S. House,Joshua Harris-Till,DEM,210005,21,30,132,183,02
Delaware,U.S. House,John Mccarthy,IND,210005,7,2,40,49,02
Delaware,State Senate,Wayne Shaw,REP,210005,57,54,529,640,3
Delaware,State Senate,Rhonda Cox,DEM,210005,22,40,246,308,3
Delaware,State House,Josh West,REP,210005,54,61,602,717,5
Delaware,State House,Matt Nowlin,DEM,210005,24,33,169,226,5
Delaware,President,Donald Trump,REP,210006,36,38,502,576,
Delaware,President,Gary Johnson,LIB,210006,1,1,16,18,
Delaware,President,Hillary Clinton,DEM,210006,13,18,133,164,
Delaware,U.S. Senate,James Lankford,REP,210006,39,42,481,562,
Delaware,U.S. Senate,Robert Murphy,LIB,210006,0,0,9,9,
Delaware,U.S. Senate,Mike Workman,DEM,210006,12,16,132,160,
Delaware,U.S. Senate,Mark Beard,IND,210006,0,1,8,9,
Delaware,U.S. Senate,Sean Braddy,IND,210006,0,0,12,12,
Delaware,U.S. House,Markwayne Mullin,REP,210006,36,40,480,556,02
Delaware,U.S. House,Joshua Harris-Till,DEM,210006,11,17,123,151,02
Delaware,U.S. House,John Mccarthy,IND,210006,4,2,38,44,02
Delaware,State Senate,Wayne Shaw,REP,210006,34,37,433,504,3
Delaware,State Senate,Rhonda Cox,DEM,210006,17,22,208,247,3
Delaware,State House,Hoguen Apperson,REP,210006,33,35,382,450,7
Delaware,State House,Ben Loring,DEM,210006,16,24,246,286,7
Delaware,President,Donald Trump,REP,210007,93,164,984,1241,
Delaware,President,Gary Johnson,LIB,210007,5,9,37,51,
Delaware,President,Hillary Clinton,DEM,210007,32,71,272,375,
Delaware,U.S. Senate,James Lankford,REP,210007,91,174,997,1262,
Delaware,U.S. Senate,Robert Murphy,LIB,210007,2,3,22,27,
Delaware,U.S. Senate,Mike Workman,DEM,210007,33,58,231,322,
Delaware,U.S. Senate,Mark Beard,IND,210007,1,5,20,26,
Delaware,U.S. Senate,Sean Braddy,IND,210007,1,5,21,27,
Delaware,U.S. House,Markwayne Mullin,REP,210007,93,170,1009,1272,02
Delaware,U.S. House,Joshua Harris-Till,DEM,210007,31,63,230,324,02
Delaware,U.S. House,John Mccarthy,IND,210007,4,11,55,70,02
Delaware,State Senate,Wayne Shaw,REP,210007,90,155,904,1149,3
Delaware,State Senate,Rhonda Cox,DEM,210007,36,87,387,510,3
Delaware,State House,Josh West,REP,210007,93,170,987,1250,5
Delaware,State House,Matt Nowlin,DEM,210007,34,71,303,408,5
Delaware,President,Donald Trump,REP,210008,10,39,258,307,
Delaware,President,Gary Johnson,LIB,210008,1,1,5,7,
Delaware,President,Hillary Clinton,DEM,210008,3,7,44,54,
Delaware,U.S. Senate,James Lankford,REP,210008,12,34,240,286,
Delaware,U.S. Senate,Robert Murphy,LIB,210008,1,1,7,9,
Delaware,U.S. Senate,Mike Workman,DEM,210008,1,9,48,58,
Delaware,U.S. Senate,Mark Beard,IND,210008,0,2,6,8,
Delaware,U.S. Senate,Sean Braddy,IND,210008,0,0,7,7,
Delaware,U.S. House,Markwayne Mullin,REP,210008,11,30,244,285,02
Delaware,U.S. House,Joshua Harris-Till,DEM,210008,1,11,36,48,02
Delaware,U.S. House,John Mccarthy,IND,210008,2,5,26,33,02
Delaware,State Senate,Wayne Shaw,REP,210008,12,34,222,268,3
Delaware,State Senate,Rhonda Cox,DEM,210008,2,12,85,99,3
Delaware,State House,Josh West,REP,210008,11,36,256,303,5
Delaware,State House,Matt Nowlin,DEM,210008,3,8,52,63,5
Delaware,President,Donald Trump,REP,210009,94,174,938,1206,
Delaware,President,Gary Johnson,LIB,210009,5,7,56,68,
Delaware,President,Hillary Clinton,DEM,210009,36,75,223,334,
Delaware,U.S. Senate,James Lankford,REP,210009,95,181,934,1210,
Delaware,U.S. Senate,Robert Murphy,LIB,210009,2,1,28,31,
Delaware,U.S. Senate,Mike Workman,DEM,210009,30,69,203,302,
Delaware,U.S. Senate,Mark Beard,IND,210009,2,3,21,26,
Delaware,U.S. Senate,Sean Braddy,IND,210009,2,1,20,23,
Delaware,U.S. House,Markwayne Mullin,REP,210009,99,177,936,1212,02
Delaware,U.S. House,Joshua Harris-Till,DEM,210009,29,68,197,294,02
Delaware,U.S. House,John Mccarthy,IND,210009,4,8,69,81,02
Delaware,State Senate,Wayne Shaw,REP,210009,87,157,823,1067,3
Delaware,State Senate,Rhonda Cox,DEM,210009,45,98,386,529,3
Delaware,State House,Josh West,REP,210009,97,176,945,1218,5
Delaware,State House,Matt Nowlin,DEM,210009,31,76,264,371,5
Delaware,President,Donald Trump,REP,210010,2,12,23,37,
Delaware,President,Gary Johnson,LIB,210010,0,0,0,0,
Delaware,President,Hillary Clinton,DEM,210010,0,1,3,4,
Delaware,U.S. Senate,James Lankford,REP,210010,2,12,17,31,
Delaware,U.S. Senate,Robert Murphy,LIB,210010,0,0,0,0,
Delaware,U.S. Senate,Mike Workman,DEM,210010,0,1,8,9,
Delaware,U.S. Senate,Mark Beard,IND,210010,0,0,1,1,
Delaware,U.S. Senate,Sean Braddy,IND,210010,0,0,0,0,
Delaware,U.S. House,Markwayne Mullin,REP,210010,2,10,15,27,02
Delaware,U.S. House,Joshua Harris-Till,DEM,210010,0,1,7,8,02
Delaware,U.S. House,John Mccarthy,IND,210010,0,2,4,6,02
Delaware,State Senate,Micheal Bergstrom,REP,210010,1,10,18,29,1
Delaware,State Senate,John Myers,DEM,210010,0,3,8,11,1
Delaware,State House,Rhonda Hopkins,REP,210010,0,11,15,26,86
Delaware,State House,Shannon Grimes,LIB,210010,0,0,0,0,86
Delaware,State House,Will Fourkiller,DEM,210010,2,2,11,15,86
Delaware,President,Donald Trump,REP,210011,36,51,572,659,
Delaware,President,Gary Johnson,LIB,210011,1,0,21,22,
Delaware,President,Hillary Clinton,DEM,210011,12,20,117,149,
Delaware,U.S. Senate,James Lankford,REP,210011,36,50,551,637,
Delaware,U.S. Senate,Robert Murphy,LIB,210011,1,1,15,17,
Delaware,U.S. Senate,Mike Workman,DEM,210011,12,18,124,154,
Delaware,U.S. Senate,Mark Beard,IND,210011,1,1,6,8,
Delaware,U.S. Senate,Sean Braddy,IND,210011,0,1,9,10,
Delaware,U.S. House,Markwayne Mullin,REP,210011,39,50,560,649,02
Delaware,U.S. House,Joshua Harris-Till,DEM,210011,10,19,118,147,02
Delaware,U.S. House,John Mccarthy,IND,210011,1,2,33,36,02
Delaware,State Senate,Wayne Shaw,REP,210011,39,45,501,585,3
Delaware,State Senate,Rhonda Cox,DEM,210011,11,27,207,245,3
Delaware,State House,Hoguen Apperson,REP,210011,33,41,433,507,7
Delaware,State House,Ben Loring,DEM,210011,16,30,263,309,7
Delaware,President,Donald Trump,REP,210012,26,70,362,458,
Delaware,President,Gary Johnson,LIB,210012,2,6,17,25,
Delaware,President,Hillary Clinton,DEM,210012,6,20,86,112,
Delaware,U.S. Senate,James Lankford,REP,210012,25,72,339,436,
Delaware,U.S. Senate,Robert Murphy,LIB,210012,2,0,12,14,
Delaware,U.S. Senate,Mike Workman,DEM,210012,6,23,92,121,
Delaware,U.S. Senate,Mark Beard,IND,210012,0,1,8,9,
Delaware,U.S. Senate,Sean Braddy,IND,210012,2,1,7,10,
Delaware,U.S. House,Markwayne Mullin,REP,210012,27,70,350,447,02
Delaware,U.S. House,Joshua Harris-Till,DEM,210012,7,20,85,112,02
Delaware,U.S. House,John Mccarthy,IND,210012,2,8,23,33,02
Delaware,State Senate,Micheal Bergstrom,REP,210012,24,59,307,390,1
Delaware,State Senate,John Myers,DEM,210012,12,36,142,190,1
Delaware,State House,Josh West,REP,210012,25,67,347,439,5
Delaware,State House,Matt Nowlin,DEM,210012,11,30,106,147,5
Delaware,President,Donald Trump,REP,210014,22,106,362,490,
Delaware,President,Gary Johnson,LIB,210014,1,4,28,33,
Delaware,President,Hillary Clinton,DEM,210014,9,37,92,138,
Delaware,U.S. Senate,James Lankford,REP,210014,24,100,319,443,
Delaware,U.S. Senate,Robert Murphy,LIB,210014,0,3,11,14,
Delaware,U.S. Senate,Mike Workman,DEM,210014,7,39,109,155,
Delaware,U.S. Senate,Mark Beard,IND,210014,0,3,13,16,
Delaware,U.S. Senate,Sean Braddy,IND,210014,1,3,18,22,
Delaware,U.S. House,Markwayne Mullin,REP,210014,23,104,360,487,02
Delaware,U.S. House,Joshua Harris-Till,DEM,210014,9,35,90,134,02
Delaware,U.S. House,John Mccarthy,IND,210014,0,9,29,38,02
Delaware,State Senate,Micheal Bergstrom,REP,210014,17,80,255,352,1
Delaware,State Senate,John Myers,DEM,210014,15,67,214,296,1
Delaware,State House,Josh West,REP,210014,23,99,324,446,5
Delaware,State House,Matt Nowlin,DEM,210014,9,46,151,206,5
Delaware,President,Donald Trump,REP,210015,36,83,449,568,
Delaware,President,Gary Johnson,LIB,210015,3,11,27,41,
Delaware,President,Hillary Clinton,DEM,210015,12,33,119,164,
Delaware,U.S. Senate,James Lankford,REP,210015,33,80,425,538,
Delaware,U.S. Senate,Robert Murphy,LIB,210015,2,3,13,18,
Delaware,U.S. Senate,Mike Workman,DEM,210015,16,40,124,180,
Delaware,U.S. Senate,Mark Beard,IND,210015,0,1,16,17,
Delaware,U.S. Senate,Sean Braddy,IND,210015,0,4,10,14,
Delaware,U.S. House,Markwayne Mullin,REP,210015,33,81,435,549,02
Delaware,U.S. House,Joshua Harris-Till,DEM,210015,15,39,122,176,02
Delaware,U.S. House,John Mccarthy,IND,210015,2,8,37,47,02
Delaware,State Senate,Micheal Bergstrom,REP,210015,31,66,372,469,1
Delaware,State Senate,John Myers,DEM,210015,19,59,215,293,1
Delaware,State House,Josh West,REP,210015,32,78,410,520,5
Delaware,State House,Matt Nowlin,DEM,210015,16,49,173,238,5
Delaware,President,Donald Trump,REP,210016,13,96,274,383,
Delaware,President,Gary Johnson,LIB,210016,1,2,16,19,
Delaware,President,Hillary Clinton,DEM,210016,13,26,99,138,
Delaware,U.S. Senate,James Lankford,REP,210016,10,87,248,345,
Delaware,U.S. Senate,Robert Murphy,LIB,210016,0,1,22,23,
Delaware,U.S. Senate,Mike Workman,DEM,210016,15,27,102,144,
Delaware,U.S. Senate,Mark Beard,IND,210016,0,2,7,9,
Delaware,U.S. Senate,Sean Braddy,IND,210016,1,6,5,12,
Delaware,U.S. House,Markwayne Mullin,REP,210016,12,80,260,352,02
Delaware,U.S. House,Joshua Harris-Till,DEM,210016,12,31,97,140,02
Delaware,U.S. House,John Mccarthy,IND,210016,2,12,30,44,02
Delaware,State Senate,Micheal Bergstrom,REP,210016,8,72,206,286,1
Delaware,State Senate,John Myers,DEM,210016,17,49,178,244,1
Delaware,State House,Josh West,REP,210016,12,90,255,357,5
Delaware,State House,Matt Nowlin,DEM,210016,13,30,125,168,5
Delaware,President,Donald Trump,REP,210017,8,51,167,226,
Delaware,President,Gary Johnson,LIB,210017,2,8,7,17,
Delaware,President,Hillary Clinton,DEM,210017,8,17,46,71,
Delaware,U.S. Senate,James Lankford,REP,210017,8,55,148,211,
Delaware,U.S. Senate,Robert Murphy,LIB,210017,1,5,4,10,
Delaware,U.S. Senate,Mike Workman,DEM,210017,8,15,59,82,
Delaware,U.S. Senate,Mark Beard,IND,210017,0,1,3,4,
Delaware,U.S. Senate,Sean Braddy,IND,210017,0,0,4,4,
Delaware,U.S. House,Markwayne Mullin,REP,210017,9,56,161,226,02
Delaware,U.S. House,Joshua Harris-Till,DEM,210017,8,15,48,71,02
Delaware,U.S. House,John Mccarthy,IND,210017,0,5,9,14,02
Delaware,State Senate,Micheal Bergstrom,REP,210017,7,45,118,170,1
Delaware,State Senate,John Myers,DEM,210017,10,29,92,131,1
Delaware,State House,Josh West,REP,210017,9,53,148,210,5
Delaware,State House,Matt Nowlin,DEM,210017,7,21,68,96,5
Delaware,President,Donald Trump,REP,210018,17,58,288,363,
Delaware,President,Gary Johnson,LIB,210018,1,2,11,14,
Delaware,President,Hillary Clinton,DEM,210018,3,11,70,84,
Delaware,U.S. Senate,James Lankford,REP,210018,17,49,253,319,
Delaware,U.S. Senate,Robert Murphy,LIB,210018,1,3,17,21,
Delaware,U.S. Senate,Mike Workman,DEM,210018,2,14,78,94,
Delaware,U.S. Senate,Mark Beard,IND,210018,0,1,3,4,
Delaware,U.S. Senate,Sean Braddy,IND,210018,1,1,11,13,
Delaware,U.S. House,Markwayne Mullin,REP,210018,19,57,278,354,02
Delaware,U.S. House,Joshua Harris-Till,DEM,210018,2,11,60,73,02
Delaware,U.S. House,John Mccarthy,IND,210018,0,3,25,28,02
Delaware,State Senate,Wayne Shaw,REP,210018,14,42,201,257,3
Delaware,State Senate,Rhonda Cox,DEM,210018,7,25,158,190,3
Delaware,State House,Josh West,REP,210018,18,55,244,317,5
Delaware,State House,Matt Nowlin,DEM,210018,3,15,113,131,5
Delaware,President,Donald Trump,REP,210019,34,26,635,695,
Delaware,President,Gary Johnson,LIB,210019,2,2,35,39,
Delaware,President,Hillary Clinton,DEM,210019,13,11,162,186,
Delaware,U.S. Senate,James Lankford,REP,210019,36,26,607,669,
Delaware,U.S. Senate,Robert Murphy,LIB,210019,0,1,14,15,
Delaware,U.S. Senate,Mike Workman,DEM,210019,10,11,160,181,
Delaware,U.S. Senate,Mark Beard,IND,210019,0,3,8,11,
Delaware,U.S. Senate,Sean Braddy,IND,210019,2,1,26,29,
Delaware,U.S. House,Markwayne Mullin,REP,210019,39,26,625,690,02
Delaware,U.S. House,Joshua Harris-Till,DEM,210019,8,13,149,170,02
Delaware,U.S. House,John Mccarthy,IND,210019,1,3,45,49,02
Delaware,State Senate,Wayne Shaw,REP,210019,25,22,482,529,3
Delaware,State Senate,Rhonda Cox,DEM,210019,24,18,341,383,3
Delaware,State House,Rhonda Hopkins,REP,210019,16,20,286,322,86
Delaware,State House,Shannon Grimes,LIB,210019,2,1,20,23,86
Delaware,State House,Will Fourkiller,DEM,210019,31,20,511,562,86
Delaware,President,Donald Trump,REP,210020,5,4,126,135,
Delaware,President,Gary Johnson,LIB,210020,0,1,13,14,
Delaware,President,Hillary Clinton,DEM,210020,3,1,58,62,
Delaware,U.S. Senate,James Lankford,REP,210020,6,4,116,126,
Delaware,U.S. Senate,Robert Murphy,LIB,210020,0,1,8,9,
Delaware,U.S. Senate,Mike Workman,DEM,210020,3,1,62,66,
Delaware,U.S. Senate,Mark Beard,IND,210020,0,0,5,5,
Delaware,U.S. Senate,Sean Braddy,IND,210020,0,0,3,3,
Delaware,U.S. House,Markwayne Mullin,REP,210020,6,4,131,141,02
Delaware,U.S. House,Joshua Harris-Till,DEM,210020,3,1,48,52,02
Delaware,U.S. House,John Mccarthy,IND,210020,0,1,15,16,02
Delaware,State Senate,Micheal Bergstrom,REP,210020,6,4,89,99,1
Delaware,State Senate,John Myers,DEM,210020,3,2,100,105,1
Delaware,State House,Josh West,REP,210020,5,5,97,107,5
Delaware,State House,Matt Nowlin,DEM,210020,4,1,91,96,5
Delaware,President,Donald Trump,REP,210021,2,3,109,114,
Delaware,President,Gary Johnson,LIB,210021,0,0,12,12,
Delaware,President,Hillary Clinton,DEM,210021,0,2,26,28,
Delaware,U.S. Senate,James Lankford,REP,210021,2,2,105,109,
Delaware,U.S. Senate,Robert Murphy,LIB,210021,0,0,1,1,
Delaware,U.S. Senate,Mike Workman,DEM,210021,0,3,30,33,
Delaware,U.S. Senate,Mark Beard,IND,210021,0,0,4,4,
Delaware,U.S. Senate,Sean Braddy,IND,210021,0,0,6,6,
Delaware,U.S. House,Markwayne Mullin,REP,210021,2,4,108,114,02
Delaware,U.S. House,Joshua Harris-Till,DEM,210021,0,1,26,27,02
Delaware,U.S. House,John Mccarthy,IND,210021,0,0,13,13,02
Delaware,State Senate,Wayne Shaw,REP,210021,2,2,77,81,3
Delaware,State Senate,Rhonda Cox,DEM,210021,0,3,67,70,3
Delaware,State House,Josh West,REP,210021,2,2,89,93,5
Delaware,State House,Matt Nowlin,DEM,210021,0,3,52,55,5
Delaware,President,Donald Trump,REP,210022,48,74,793,915,
Delaware,President,Gary Johnson,LIB,210022,3,2,48,53,
Delaware,President,Hillary Clinton,DEM,210022,20,14,244,278,
Delaware,U.S. Senate,James Lankford,REP,210022,42,73,722,837,
Delaware,U.S. Senate,Robert Murphy,LIB,210022,3,0,23,26,
Delaware,U.S. Senate,Mike Workman,DEM,210022,22,11,290,323,
Delaware,U.S. Senate,Mark Beard,IND,210022,2,1,15,18,
Delaware,U.S. Senate,Sean Braddy,IND,210022,4,3,25,32,
Delaware,U.S. House,Markwayne Mullin,REP,210022,49,76,773,898,02
Delaware,U.S. House,Joshua Harris-Till,DEM,210022,19,10,247,276,02
Delaware,U.S. House,John Mccarthy,IND,210022,6,3,56,65,02
Delaware,State Senate,Wayne Shaw,REP,210022,33,64,542,639,3
Delaware,State Senate,Rhonda Cox,DEM,210022,40,23,531,594,3
Delaware,State House,Rhonda Hopkins,REP,210022,17,58,358,433,86
Delaware,State House,Shannon Grimes,LIB,210022,5,3,37,45,86
Delaware,State House,Will Fourkiller,DEM,210022,51,28,675,754,86
Delaware,President,Donald Trump,REP,210023,29,15,505,549,
Delaware,President,Gary Johnson,LIB,210023,4,0,26,30,
Delaware,President,Hillary Clinton,DEM,210023,7,5,89,101,
Delaware,U.S. Senate,James Lankford,REP,210023,28,15,479,522,
Delaware,U.S. Senate,Robert Murphy,LIB,210023,2,0,10,12,
Delaware,U.S. Senate,Mike Workman,DEM,210023,8,5,101,114,
Delaware,U.S. Senate,Mark Beard,IND,210023,1,0,10,11,
Delaware,U.S. Senate,Sean Braddy,IND,210023,0,0,11,11,
Delaware,U.S. House,Markwayne Mullin,REP,210023,29,15,498,542,02
Delaware,U.S. House,Joshua Harris-Till,DEM,210023,7,5,80,92,02
Delaware,U.S. House,John Mccarthy,IND,210023,3,0,33,36,02
Delaware,State Senate,Wayne Shaw,REP,210023,28,13,419,460,3
Delaware,State Senate,Rhonda Cox,DEM,210023,11,7,191,209,3
Delaware,State House,Rhonda Hopkins,REP,210023,20,12,308,340,86
Delaware,State House,Shannon Grimes,LIB,210023,5,1,22,28,86
Delaware,State House,Will Fourkiller,DEM,210023,15,7,272,294,86
Dewey,President,Donald Trump,REP,220001,5,33,209,247,
Dewey,President,Gary Johnson,LIB,220001,0,1,3,4,
Dewey,President,Hillary Clinton,DEM,220001,0,1,24,25,
Dewey,U.S. Senate,James Lankford,REP,220001,4,32,205,241,
Dewey,U.S. Senate,Robert Murphy,LIB,220001,0,0,0,0,
Dewey,U.S. Senate,Mike Workman,DEM,220001,0,3,25,28,
Dewey,U.S. Senate,Mark Beard,IND,220001,0,0,0,0,
Dewey,U.S. Senate,Sean Braddy,IND,220001,1,0,2,3,
Dewey,U.S. House,Frank Lucas,REP,220001,5,32,201,238,03
Dewey,U.S. House,Frankie Robbins,DEM,220001,0,3,32,35,03
Dewey,President,Donald Trump,REP,220002,9,1,83,93,
Dewey,President,Gary Johnson,LIB,220002,0,0,2,2,
Dewey,President,Hillary Clinton,DEM,220002,0,0,7,7,
Dewey,U.S. Senate,James Lankford,REP,220002,8,1,84,93,
Dewey,U.S. Senate,Robert Murphy,LIB,220002,0,0,1,1,
Dewey,U.S. Senate,Mike Workman,DEM,220002,1,0,3,4,
Dewey,U.S. Senate,Mark Beard,IND,220002,0,0,1,1,
Dewey,U.S. Senate,Sean Braddy,IND,220002,0,0,1,1,
Dewey,U.S. House,Frank Lucas,REP,220002,9,1,87,97,03
Dewey,U.S. House,Frankie Robbins,DEM,220002,0,0,5,5,03
Dewey,President,Donald Trump,REP,220003,12,6,262,280,
Dewey,President,Gary Johnson,LIB,220003,1,0,4,5,
Dewey,President,Hillary Clinton,DEM,220003,1,1,29,31,
Dewey,U.S. Senate,James Lankford,REP,220003,14,6,263,283,
Dewey,U.S. Senate,Robert Murphy,LIB,220003,0,0,2,2,
Dewey,U.S. Senate,Mike Workman,DEM,220003,1,1,23,25,
Dewey,U.S. Senate,Mark Beard,IND,220003,0,0,6,6,
Dewey,U.S. Senate,Sean Braddy,IND,220003,0,0,4,4,
Dewey,U.S. House,Frank Lucas,REP,220003,13,6,265,284,03
Dewey,U.S. House,Frankie Robbins,DEM,220003,2,1,33,36,03
Dewey,President,Donald Trump,REP,220004,7,3,102,112,
Dewey,President,Gary Johnson,LIB,220004,0,0,4,4,
Dewey,President,Hillary Clinton,DEM,220004,0,1,16,17,
Dewey,U.S. Senate,James Lankford,REP,220004,7,4,106,117,
Dewey,U.S. Senate,Robert Murphy,LIB,220004,0,0,0,0,
Dewey,U.S. Senate,Mike Workman,DEM,220004,0,1,15,16,
Dewey,U.S. Senate,Mark Beard,IND,220004,0,0,1,1,
Dewey,U.S. Senate,Sean Braddy,IND,220004,0,0,0,0,
Dewey,U.S. House,Frank Lucas,REP,220004,7,3,102,112,03
Dewey,U.S. House,Frankie Robbins,DEM,220004,0,2,19,21,03
Dewey,President,Donald Trump,REP,220005,17,49,481,547,
Dewey,President,Gary Johnson,LIB,220005,2,0,31,33,
Dewey,President,Hillary Clinton,DEM,220005,3,3,44,50,
Dewey,U.S. Senate,James Lankford,REP,220005,17,50,489,556,
Dewey,U.S. Senate,Robert Murphy,LIB,220005,0,0,10,10,
Dewey,U.S. Senate,Mike Workman,DEM,220005,4,2,36,42,
Dewey,U.S. Senate,Mark Beard,IND,220005,0,0,6,6,
Dewey,U.S. Senate,Sean Braddy,IND,220005,1,0,11,12,
Dewey,U.S. House,Frank Lucas,REP,220005,20,47,503,570,03
Dewey,U.S. House,Frankie Robbins,DEM,220005,3,5,49,57,03
Dewey,President,Donald Trump,REP,220007,3,4,88,95,
Dewey,President,Gary Johnson,LIB,220007,0,0,0,0,
Dewey,President,Hillary Clinton,DEM,220007,0,0,7,7,
Dewey,U.S. Senate,James Lankford,REP,220007,3,4,84,91,
Dewey,U.S. Senate,Robert Murphy,LIB,220007,0,0,3,3,
Dewey,U.S. Senate,Mike Workman,DEM,220007,0,0,6,6,
Dewey,U.S. Senate,Mark Beard,IND,220007,0,0,0,0,
Dewey,U.S. Senate,Sean Braddy,IND,220007,0,0,1,1,
Dewey,U.S. House,Frank Lucas,REP,220007,3,4,88,95,03
Dewey,U.S. House,Frankie Robbins,DEM,220007,0,0,6,6,03
Dewey,President,Donald Trump,REP,220008,29,38,372,439,
Dewey,President,Gary Johnson,LIB,220008,0,0,6,6,
Dewey,President,Hillary Clinton,DEM,220008,6,4,55,65,
Dewey,U.S. Senate,James Lankford,REP,220008,27,37,379,443,
Dewey,U.S. Senate,Robert Murphy,LIB,220008,2,1,6,9,
Dewey,U.S. Senate,Mike Workman,DEM,220008,5,3,40,48,
Dewey,U.S. Senate,Mark Beard,IND,220008,0,0,4,4,
Dewey,U.S. Senate,Sean Braddy,IND,220008,2,0,3,5,
Dewey,U.S. House,Frank Lucas,REP,220008,32,38,385,455,03
Dewey,U.S. House,Frankie Robbins,DEM,220008,4,4,47,55,03
Dewey,President,Donald Trump,REP,220009,8,3,110,121,
Dewey,President,Gary Johnson,LIB,220009,1,1,3,5,
Dewey,President,Hillary Clinton,DEM,220009,4,0,8,12,
Dewey,U.S. Senate,James Lankford,REP,220009,6,4,109,119,
Dewey,U.S. Senate,Robert Murphy,LIB,220009,2,0,1,3,
Dewey,U.S. Senate,Mike Workman,DEM,220009,4,0,8,12,
Dewey,U.S. Senate,Mark Beard,IND,220009,1,0,0,1,
Dewey,U.S. Senate,Sean Braddy,IND,220009,0,0,2,2,
Dewey,U.S. House,Frank Lucas,REP,220009,8,4,108,120,03
Dewey,U.S. House,Frankie Robbins,DEM,220009,5,0,12,17,03
Dewey,President,Donald Trump,REP,220010,1,1,29,31,
Dewey,President,Gary Johnson,LIB,220010,0,0,2,2,
Dewey,President,Hillary Clinton,DEM,220010,0,0,8,8,
Dewey,U.S. Senate,James Lankford,REP,220010,0,1,35,36,
Dewey,U.S. Senate,Robert Murphy,LIB,220010,0,0,0,0,
Dewey,U.S. Senate,Mike Workman,DEM,220010,0,0,4,4,
Dewey,U.S. Senate,Mark Beard,IND,220010,0,0,0,0,
Dewey,U.S. Senate,Sean Braddy,IND,220010,1,0,0,1,
Dewey,U.S. House,Frank Lucas,REP,220010,1,1,32,34,03
Dewey,U.S. House,Frankie Robbins,DEM,220010,0,0,7,7,03
Ellis,President,Donald Trump,REP,230001,22,81,255,358,
Ellis,President,Gary Johnson,LIB,230001,5,1,15,21,
Ellis,President,Hillary Clinton,DEM,230001,8,16,32,56,
Ellis,U.S. Senate,James Lankford,REP,230001,28,79,261,368,
Ellis,U.S. Senate,Robert Murphy,LIB,230001,0,2,7,9,
Ellis,U.S. Senate,Mike Workman,DEM,230001,5,15,28,48,
Ellis,U.S. Senate,Mark Beard,IND,230001,1,1,3,5,
Ellis,U.S. Senate,Sean Braddy,IND,230001,0,0,5,5,
Ellis,U.S. House,Frank Lucas,REP,230001,28,79,262,369,03
Ellis,U.S. House,Frankie Robbins,DEM,230001,7,19,42,68,03
Ellis,State House,Casey Murdock,REP,230001,27,82,273,382,61
Ellis,State House,Ashlee Renee Ortiz,DEM,230001,6,16,29,51,61
Ellis,President,Donald Trump,REP,230003,11,36,502,549,
Ellis,President,Gary Johnson,LIB,230003,0,1,13,14,
Ellis,President,Hillary Clinton,DEM,230003,7,2,27,36,
Ellis,U.S. Senate,James Lankford,REP,230003,15,39,492,546,
Ellis,U.S. Senate,Robert Murphy,LIB,230003,0,0,9,9,
Ellis,U.S. Senate,Mike Workman,DEM,230003,3,0,24,27,
Ellis,U.S. Senate,Mark Beard,IND,230003,0,0,8,8,
Ellis,U.S. Senate,Sean Braddy,IND,230003,0,1,7,8,
Ellis,U.S. House,Frank Lucas,REP,230003,12,35,493,540,03
Ellis,U.S. House,Frankie Robbins,DEM,230003,7,3,42,52,03
Ellis,State House,Casey Murdock,REP,230003,13,34,500,547,61
Ellis,State House,Ashlee Renee Ortiz,DEM,230003,6,4,35,45,61
Ellis,President,Donald Trump,REP,230004,9,2,73,84,
Ellis,President,Gary Johnson,LIB,230004,0,1,5,6,
Ellis,President,Hillary Clinton,DEM,230004,3,0,9,12,
Ellis,U.S. Senate,James Lankford,REP,230004,9,3,76,88,
Ellis,U.S. Senate,Robert Murphy,LIB,230004,0,0,3,3,
Ellis,U.S. Senate,Mike Workman,DEM,230004,1,0,5,6,
Ellis,U.S. Senate,Mark Beard,IND,230004,0,0,1,1,
Ellis,U.S. Senate,Sean Braddy,IND,230004,1,0,2,3,
Ellis,U.S. House,Frank Lucas,REP,230004,10,3,76,89,03
Ellis,U.S. House,Frankie Robbins,DEM,230004,1,0,11,12,03
Ellis,State House,Casey Murdock,REP,230004,9,3,79,91,61
Ellis,State House,Ashlee Renee Ortiz,DEM,230004,2,0,8,10,61
Ellis,President,Donald Trump,REP,230006,3,4,38,45,
Ellis,President,Gary Johnson,LIB,230006,0,0,0,0,
Ellis,President,Hillary Clinton,DEM,230006,3,0,3,6,
Ellis,U.S. Senate,James Lankford,REP,230006,3,4,38,45,
Ellis,U.S. Senate,Robert Murphy,LIB,230006,0,0,0,0,
Ellis,U.S. Senate,Mike Workman,DEM,230006,3,0,2,5,
Ellis,U.S. Senate,Mark Beard,IND,230006,0,0,0,0,
Ellis,U.S. Senate,Sean Braddy,IND,230006,0,0,1,1,
Ellis,U.S. House,Frank Lucas,REP,230006,3,4,37,44,03
Ellis,U.S. House,Frankie Robbins,DEM,230006,3,0,4,7,03
Ellis,State House,Casey Murdock,REP,230006,2,4,39,45,61
Ellis,State House,Ashlee Renee Ortiz,DEM,230006,4,0,2,6,61
Ellis,President,Donald Trump,REP,230007,9,15,229,253,
Ellis,President,Gary Johnson,LIB,230007,1,0,8,9,
Ellis,President,Hillary Clinton,DEM,230007,0,4,13,17,
Ellis,U.S. Senate,James Lankford,REP,230007,8,15,226,249,
Ellis,U.S. Senate,Robert Murphy,LIB,230007,1,0,5,6,
Ellis,U.S. Senate,Mike Workman,DEM,230007,1,4,14,19,
Ellis,U.S. Senate,Mark Beard,IND,230007,0,1,2,3,
Ellis,U.S. Senate,Sean Braddy,IND,230007,0,0,4,4,
Ellis,U.S. House,Frank Lucas,REP,230007,9,17,234,260,03
Ellis,U.S. House,Frankie Robbins,DEM,230007,1,3,16,20,03
Ellis,State House,Casey Murdock,REP,230007,9,16,230,255,61
Ellis,State House,Ashlee Renee Ortiz,DEM,230007,1,4,19,24,61
Ellis,President,Donald Trump,REP,230008,12,11,216,239,
Ellis,President,Gary Johnson,LIB,230008,1,0,8,9,
Ellis,President,Hillary Clinton,DEM,230008,1,0,14,15,
Ellis,U.S. Senate,James Lankford,REP,230008,11,11,211,233,
Ellis,U.S. Senate,Robert Murphy,LIB,230008,1,0,6,7,
Ellis,U.S. Senate,Mike Workman,DEM,230008,2,1,17,20,
Ellis,U.S. Senate,Mark Beard,IND,230008,0,0,2,2,
Ellis,U.S. Senate,Sean Braddy,IND,230008,0,0,1,1,
Ellis,U.S. House,Frank Lucas,REP,230008,11,11,216,238,03
Ellis,U.S. House,Frankie Robbins,DEM,230008,3,1,25,29,03
Ellis,State House,Casey Murdock,REP,230008,12,12,217,241,61
Ellis,State House,Ashlee Renee Ortiz,DEM,230008,2,0,19,21,61
Ellis,President,Donald Trump,REP,230009,1,12,70,83,
Ellis,President,Gary Johnson,LIB,230009,0,0,2,2,
Ellis,President,Hillary Clinton,DEM,230009,1,0,12,13,
Ellis,U.S. Senate,James Lankford,REP,230009,2,12,72,86,
Ellis,U.S. Senate,Robert Murphy,LIB,230009,0,0,0,0,
Ellis,U.S. Senate,Mike Workman,DEM,230009,0,0,10,10,
Ellis,U.S. Senate,Mark Beard,IND,230009,0,0,1,1,
Ellis,U.S. Senate,Sean Braddy,IND,230009,0,0,1,1,
Ellis,U.S. House,Frank Lucas,REP,230009,2,11,72,85,03
Ellis,U.S. House,Frankie Robbins,DEM,230009,0,1,10,11,03
Ellis,State House,Casey Murdock,REP,230009,2,11,71,84,61
Ellis,State House,Ashlee Renee Ortiz,DEM,230009,0,0,10,10,61
Garfield,President,Donald Trump,REP,240101,28,24,203,255,
Garfield,President,Gary Johnson,LIB,240101,2,2,18,22,
Garfield,President,Hillary Clinton,DEM,240101,6,25,119,150,
Garfield,U.S. Senate,James Lankford,REP,240101,30,29,198,257,
Garfield,U.S. Senate,Robert Murphy,LIB,240101,0,2,11,13,
Garfield,U.S. Senate,Mike Workman,DEM,240101,4,19,106,129,
Garfield,U.S. Senate,Mark Beard,IND,240101,0,0,9,9,
Garfield,U.S. Senate,Sean Braddy,IND,240101,2,2,12,16,
Garfield,U.S. House,Frank Lucas,REP,240101,30,25,211,266,03
Garfield,U.S. House,Frankie Robbins,DEM,240101,6,26,124,156,03
Garfield,State Senate,Roland Pederson,REP,240101,31,23,174,228,19
Garfield,State Senate,Rhonda Harlow,DEM,240101,4,24,123,151,19
Garfield,State Senate,Whitney Hall,IND,240101,1,4,39,44,19
Garfield,State House,Chad Caldwell,REP,240101,30,28,202,260,40
Garfield,State House,Pierce Jones,DEM,240101,5,23,132,160,40
Garfield,President,Donald Trump,REP,240102,17,38,292,347,
Garfield,President,Gary Johnson,LIB,240102,4,4,48,56,
Garfield,President,Hillary Clinton,DEM,240102,3,21,189,213,
Garfield,U.S. Senate,James Lankford,REP,240102,16,35,295,346,
Garfield,U.S. Senate,Robert Murphy,LIB,240102,3,1,21,25,
Garfield,U.S. Senate,Mike Workman,DEM,240102,3,19,158,180,
Garfield,U.S. Senate,Mark Beard,IND,240102,1,0,18,19,
Garfield,U.S. Senate,Sean Braddy,IND,240102,1,6,29,36,
Garfield,U.S. House,Frank Lucas,REP,240102,19,41,321,381,03
Garfield,U.S. House,Frankie Robbins,DEM,240102,5,22,199,226,03
Garfield,State Senate,Roland Pederson,REP,240102,17,31,253,301,19
Garfield,State Senate,Rhonda Harlow,DEM,240102,6,28,193,227,19
Garfield,State Senate,Whitney Hall,IND,240102,1,4,77,82,19
Garfield,State House,Chad Caldwell,REP,240102,17,37,312,366,40
Garfield,State House,Pierce Jones,DEM,240102,7,25,209,241,40
Garfield,President,Donald Trump,REP,240103,25,44,424,493,
Garfield,President,Gary Johnson,LIB,240103,3,6,51,60,
Garfield,President,Hillary Clinton,DEM,240103,12,25,198,235,
Garfield,U.S. Senate,James Lankford,REP,240103,31,46,411,488,
Garfield,U.S. Senate,Robert Murphy,LIB,240103,3,4,38,45,
Garfield,U.S. Senate,Mike Workman,DEM,240103,6,17,166,189,
Garfield,U.S. Senate,Mark Beard,IND,240103,1,2,19,22,
Garfield,U.S. Senate,Sean Braddy,IND,240103,1,5,34,40,
Garfield,U.S. House,Frank Lucas,REP,240103,33,51,449,533,03
Garfield,U.S. House,Frankie Robbins,DEM,240103,9,23,219,251,03
Garfield,State Senate,Roland Pederson,REP,240103,28,41,346,415,19
Garfield,State Senate,Rhonda Harlow,DEM,240103,9,25,219,253,19
Garfield,State Senate,Whitney Hall,IND,240103,5,8,103,116,19
Garfield,State House,Chad Caldwell,REP,240103,32,48,426,506,40
Garfield,State House,Pierce Jones,DEM,240103,9,25,239,273,40
Garfield,President,Donald Trump,REP,240104,21,55,405,481,
Garfield,President,Gary Johnson,LIB,240104,0,2,63,65,
Garfield,President,Hillary Clinton,DEM,240104,15,25,198,238,
Garfield,U.S. Senate,James Lankford,REP,240104,25,52,436,513,
Garfield,U.S. Senate,Robert Murphy,LIB,240104,0,4,26,30,
Garfield,U.S. Senate,Mike Workman,DEM,240104,10,18,163,191,
Garfield,U.S. Senate,Mark Beard,IND,240104,1,4,18,23,
Garfield,U.S. Senate,Sean Braddy,IND,240104,0,3,21,24,
Garfield,U.S. House,Frank Lucas,REP,240104,25,58,456,539,03
Garfield,U.S. House,Frankie Robbins,DEM,240104,11,22,207,240,03
Garfield,State Senate,Roland Pederson,REP,240104,19,46,331,396,19
Garfield,State Senate,Rhonda Harlow,DEM,240104,12,20,219,251,19
Garfield,State Senate,Whitney Hall,IND,240104,4,14,114,132,19
Garfield,State House,Chad Caldwell,REP,240104,24,54,419,497,40
Garfield,State House,Pierce Jones,DEM,240104,11,24,241,276,40
Garfield,President,Donald Trump,REP,240105,8,47,331,386,
Garfield,President,Gary Johnson,LIB,240105,0,5,41,46,
Garfield,President,Hillary Clinton,DEM,240105,4,25,99,128,
Garfield,U.S. Senate,James Lankford,REP,240105,7,49,335,391,
Garfield,U.S. Senate,Robert Murphy,LIB,240105,2,6,23,31,
Garfield,U.S. Senate,Mike Workman,DEM,240105,3,21,83,107,
Garfield,U.S. Senate,Mark Beard,IND,240105,0,0,15,15,
Garfield,U.S. Senate,Sean Braddy,IND,240105,0,1,18,19,
Garfield,U.S. House,Frank Lucas,REP,240105,7,55,359,421,03
Garfield,U.S. House,Frankie Robbins,DEM,240105,5,22,113,140,03
Garfield,State Senate,Roland Pederson,REP,240105,6,36,283,325,19
Garfield,State Senate,Rhonda Harlow,DEM,240105,5,27,121,153,19
Garfield,State Senate,Whitney Hall,IND,240105,1,14,70,85,19
Garfield,President,Donald Trump,REP,240106,5,19,334,358,
Garfield,President,Gary Johnson,LIB,240106,0,0,15,15,
Garfield,President,Hillary Clinton,DEM,240106,1,5,42,48,
Garfield,U.S. Senate,James Lankford,REP,240106,5,22,346,373,
Garfield,U.S. Senate,Robert Murphy,LIB,240106,0,0,5,5,
Garfield,U.S. Senate,Mike Workman,DEM,240106,0,2,30,32,
Garfield,U.S. Senate,Mark Beard,IND,240106,0,0,9,9,
Garfield,U.S. Senate,Sean Braddy,IND,240106,1,0,6,7,
Garfield,U.S. House,Frank Lucas,REP,240106,6,21,350,377,03
Garfield,U.S. House,Frankie Robbins,DEM,240106,0,2,43,45,03
Garfield,State Senate,Roland Pederson,REP,240106,6,18,306,330,19
Garfield,State Senate,Rhonda Harlow,DEM,240106,0,3,49,52,19
Garfield,State Senate,Whitney Hall,IND,240106,0,2,37,39,19
Garfield,President,Donald Trump,REP,240107,1,4,70,75,
Garfield,President,Gary Johnson,LIB,240107,1,0,2,3,
Garfield,President,Hillary Clinton,DEM,240107,0,1,14,15,
Garfield,U.S. Senate,James Lankford,REP,240107,2,4,73,79,
Garfield,U.S. Senate,Robert Murphy,LIB,240107,0,0,1,1,
Garfield,U.S. Senate,Mike Workman,DEM,240107,0,1,12,13,
Garfield,U.S. Senate,Mark Beard,IND,240107,0,0,0,0,
Garfield,U.S. Senate,Sean Braddy,IND,240107,0,0,0,0,
Garfield,U.S. House,Frank Lucas,REP,240107,2,3,76,81,03
Garfield,U.S. House,Frankie Robbins,DEM,240107,0,2,10,12,03
Garfield,State Senate,Roland Pederson,REP,240107,2,4,64,70,19
Garfield,State Senate,Rhonda Harlow,DEM,240107,0,1,15,16,19
Garfield,State Senate,Whitney Hall,IND,240107,0,0,6,6,19
Garfield,President,Donald Trump,REP,240108,5,11,83,99,
Garfield,President,Gary Johnson,LIB,240108,0,1,5,6,
Garfield,President,Hillary Clinton,DEM,240108,2,3,11,16,
Garfield,U.S. Senate,James Lankford,REP,240108,5,11,81,97,
Garfield,U.S. Senate,Robert Murphy,LIB,240108,0,1,1,2,
Garfield,U.S. Senate,Mike Workman,DEM,240108,4,1,11,16,
Garfield,U.S. Senate,Mark Beard,IND,240108,0,0,1,1,
Garfield,U.S. Senate,Sean Braddy,IND,240108,0,0,3,3,
Garfield,U.S. House,Frank Lucas,REP,240108,5,13,89,107,03
Garfield,U.S. House,Frankie Robbins,DEM,240108,4,1,8,13,03
Garfield,State Senate,Roland Pederson,REP,240108,7,9,70,86,19
Garfield,State Senate,Rhonda Harlow,DEM,240108,2,3,18,23,19
Garfield,State Senate,Whitney Hall,IND,240108,0,2,11,13,19
Garfield,President,Donald Trump,REP,240109,9,16,209,234,
Garfield,President,Gary Johnson,LIB,240109,0,0,6,6,
Garfield,President,Hillary Clinton,DEM,240109,1,3,31,35,
Garfield,U.S. Senate,James Lankford,REP,240109,8,15,212,235,
Garfield,U.S. Senate,Robert Murphy,LIB,240109,0,1,6,7,
Garfield,U.S. Senate,Mike Workman,DEM,240109,2,2,19,23,
Garfield,U.S. Senate,Mark Beard,IND,240109,0,0,5,5,
Garfield,U.S. Senate,Sean Braddy,IND,240109,0,1,4,5,
Garfield,U.S. House,Frank Lucas,REP,240109,8,17,211,236,03
Garfield,U.S. House,Frankie Robbins,DEM,240109,2,2,32,36,03
Garfield,State Senate,Roland Pederson,REP,240109,8,15,178,201,19
Garfield,State Senate,Rhonda Harlow,DEM,240109,2,2,32,36,19
Garfield,State Senate,Whitney Hall,IND,240109,0,2,32,34,19
Garfield,President,Donald Trump,REP,240110,36,63,463,562,
Garfield,President,Gary Johnson,LIB,240110,12,9,40,61,
Garfield,President,Hillary Clinton,DEM,240110,16,24,89,129,
Garfield,U.S. Senate,James Lankford,REP,240110,48,68,471,587,
Garfield,U.S. Senate,Robert Murphy,LIB,240110,3,4,16,23,
Garfield,U.S. Senate,Mike Workman,DEM,240110,10,21,72,103,
Garfield,U.S. Senate,Mark Beard,IND,240110,1,3,13,17,
Garfield,U.S. Senate,Sean Braddy,IND,240110,3,1,18,22,
Garfield,U.S. House,Frank Lucas,REP,240110,49,69,481,599,03
Garfield,U.S. House,Frankie Robbins,DEM,240110,13,28,104,145,03
Garfield,State Senate,Roland Pederson,REP,240110,42,56,392,490,19
Garfield,State Senate,Rhonda Harlow,DEM,240110,6,24,110,140,19
Garfield,State Senate,Whitney Hall,IND,240110,10,17,83,110,19
Garfield,President,Donald Trump,REP,240201,48,132,670,850,
Garfield,President,Gary Johnson,LIB,240201,10,13,114,137,
Garfield,President,Hillary Clinton,DEM,240201,23,81,280,384,
Garfield,U.S. Senate,James Lankford,REP,240201,53,143,748,944,
Garfield,U.S. Senate,Robert Murphy,LIB,240201,2,8,43,53,
Garfield,U.S. Senate,Mike Workman,DEM,240201,13,64,216,293,
Garfield,U.S. Senate,Mark Beard,IND,240201,4,5,26,35,
Garfield,U.S. Senate,Sean Braddy,IND,240201,3,11,34,48,
Garfield,U.S. House,Frank Lucas,REP,240201,56,156,795,1007,03
Garfield,U.S. House,Frankie Robbins,DEM,240201,19,76,265,360,03
Garfield,State Senate,Roland Pederson,REP,240201,49,124,587,760,19
Garfield,State Senate,Rhonda Harlow,DEM,240201,15,68,276,359,19
Garfield,State Senate,Whitney Hall,IND,240201,9,42,207,258,19
Garfield,State House,Chad Caldwell,REP,240201,54,149,762,965,40
Garfield,State House,Pierce Jones,DEM,240201,18,80,300,398,40
Garfield,President,Donald Trump,REP,240202,79,202,641,922,
Garfield,President,Gary Johnson,LIB,240202,8,8,65,81,
Garfield,President,Hillary Clinton,DEM,240202,45,72,188,305,
Garfield,U.S. Senate,James Lankford,REP,240202,90,213,678,981,
Garfield,U.S. Senate,Robert Murphy,LIB,240202,3,5,30,38,
Garfield,U.S. Senate,Mike Workman,DEM,240202,38,58,146,242,
Garfield,U.S. Senate,Mark Beard,IND,240202,1,4,19,24,
Garfield,U.S. Senate,Sean Braddy,IND,240202,1,3,21,25,
Garfield,U.S. House,Frank Lucas,REP,240202,95,208,708,1011,03
Garfield,U.S. House,Frankie Robbins,DEM,240202,38,73,182,293,03
Garfield,State Senate,Roland Pederson,REP,240202,85,177,541,803,19
Garfield,State Senate,Rhonda Harlow,DEM,240202,40,73,211,324,19
Garfield,State Senate,Whitney Hall,IND,240202,6,30,140,176,19
Garfield,State House,Chad Caldwell,REP,240202,94,205,694,993,40
Garfield,State House,Pierce Jones,DEM,240202,35,74,196,305,40
Garfield,President,Donald Trump,REP,240203,17,65,324,406,
Garfield,President,Gary Johnson,LIB,240203,4,7,30,41,
Garfield,President,Hillary Clinton,DEM,240203,15,19,88,122,
Garfield,U.S. Senate,James Lankford,REP,240203,23,71,316,410,
Garfield,U.S. Senate,Robert Murphy,LIB,240203,0,1,13,14,
Garfield,U.S. Senate,Mike Workman,DEM,240203,11,13,79,103,
Garfield,U.S. Senate,Mark Beard,IND,240203,1,2,16,19,
Garfield,U.S. Senate,Sean Braddy,IND,240203,2,5,17,24,
Garfield,U.S. House,Frank Lucas,REP,240203,23,70,339,432,03
Garfield,U.S. House,Frankie Robbins,DEM,240203,13,22,99,134,03
Garfield,State Senate,Roland Pederson,REP,240203,21,55,269,345,19
Garfield,State Senate,Rhonda Harlow,DEM,240203,13,27,107,147,19
Garfield,State Senate,Whitney Hall,IND,240203,3,10,64,77,19
Garfield,State House,Chad Caldwell,REP,240203,23,68,326,417,40
Garfield,State House,Pierce Jones,DEM,240203,12,23,111,146,40
Garfield,President,Donald Trump,REP,240204,51,218,842,1111,
Garfield,President,Gary Johnson,LIB,240204,4,10,72,86,
Garfield,President,Hillary Clinton,DEM,240204,22,57,232,311,
Garfield,U.S. Senate,James Lankford,REP,240204,58,234,899,1191,
Garfield,U.S. Senate,Robert Murphy,LIB,240204,1,7,34,42,
Garfield,U.S. Senate,Mike Workman,DEM,240204,13,42,159,214,
Garfield,U.S. Senate,Mark Beard,IND,240204,3,0,20,23,
Garfield,U.S. Senate,Sean Braddy,IND,240204,2,1,29,32,
Garfield,U.S. House,Frank Lucas,REP,240204,57,235,916,1208,03
Garfield,U.S. House,Frankie Robbins,DEM,240204,20,47,221,288,03
Garfield,State Senate,Roland Pederson,REP,240204,50,190,730,970,19
Garfield,State Senate,Rhonda Harlow,DEM,240204,15,59,257,331,19
Garfield,State Senate,Whitney Hall,IND,240204,9,34,158,201,19
Garfield,State House,Chad Caldwell,REP,240204,53,223,858,1134,40
Garfield,State House,Pierce Jones,DEM,240204,21,56,269,346,40
Garfield,President,Donald Trump,REP,240206,9,51,481,541,
Garfield,President,Gary Johnson,LIB,240206,1,5,45,51,
Garfield,President,Hillary Clinton,DEM,240206,9,20,139,168,
Garfield,U.S. Senate,James Lankford,REP,240206,9,54,510,573,
Garfield,U.S. Senate,Robert Murphy,LIB,240206,0,2,13,15,
Garfield,U.S. Senate,Mike Workman,DEM,240206,8,14,110,132,
Garfield,U.S. Senate,Mark Beard,IND,240206,1,2,16,19,
Garfield,U.S. Senate,Sean Braddy,IND,240206,1,4,17,22,
Garfield,U.S. House,Frank Lucas,REP,240206,10,56,530,596,03
Garfield,U.S. House,Frankie Robbins,DEM,240206,9,20,133,162,03
Garfield,State Senate,Roland Pederson,REP,240206,11,41,422,474,19
Garfield,State Senate,Rhonda Harlow,DEM,240206,8,22,165,195,19
Garfield,State Senate,Whitney Hall,IND,240206,0,12,80,92,19
Garfield,State House,Chad Caldwell,REP,240206,11,53,500,564,40
Garfield,State House,Pierce Jones,DEM,240206,8,23,161,192,40
Garfield,President,Donald Trump,REP,240207,22,40,488,550,
Garfield,President,Gary Johnson,LIB,240207,2,2,29,33,
Garfield,President,Hillary Clinton,DEM,240207,6,22,76,104,
Garfield,U.S. Senate,James Lankford,REP,240207,24,45,499,568,
Garfield,U.S. Senate,Robert Murphy,LIB,240207,0,0,10,10,
Garfield,U.S. Senate,Mike Workman,DEM,240207,2,15,61,78,
Garfield,U.S. Senate,Mark Beard,IND,240207,1,2,7,10,
Garfield,U.S. Senate,Sean Braddy,IND,240207,3,3,16,22,
Garfield,U.S. House,Frank Lucas,REP,240207,27,44,502,573,03
Garfield,U.S. House,Frankie Robbins,DEM,240207,3,21,89,113,03
Garfield,State Senate,Roland Pederson,REP,240207,24,40,441,505,19
Garfield,State Senate,Rhonda Harlow,DEM,240207,2,19,80,101,19
Garfield,State Senate,Whitney Hall,IND,240207,4,6,69,79,19
Garfield,State House,Chad Caldwell,REP,240207,28,41,482,551,40
Garfield,State House,Pierce Jones,DEM,240207,2,24,100,126,40
Garfield,President,Donald Trump,REP,240208,6,8,110,124,
Garfield,President,Gary Johnson,LIB,240208,0,0,3,3,
Garfield,President,Hillary Clinton,DEM,240208,0,0,11,11,
Garfield,U.S. Senate,James Lankford,REP,240208,6,8,112,126,
Garfield,U.S. Senate,Robert Murphy,LIB,240208,0,0,4,4,
Garfield,U.S. Senate,Mike Workman,DEM,240208,0,0,6,6,
Garfield,U.S. Senate,Mark Beard,IND,240208,0,0,0,0,
Garfield,U.S. Senate,Sean Braddy,IND,240208,0,0,2,2,
Garfield,U.S. House,Frank Lucas,REP,240208,6,8,115,129,03
Garfield,U.S. House,Frankie Robbins,DEM,240208,0,0,9,9,03
Garfield,State Senate,Roland Pederson,REP,240208,5,7,105,117,19
Garfield,State Senate,Rhonda Harlow,DEM,240208,0,1,9,10,19
Garfield,State Senate,Whitney Hall,IND,240208,1,0,10,11,19
Garfield,President,Donald Trump,REP,240210,9,11,329,349,
Garfield,President,Gary Johnson,LIB,240210,2,1,20,23,
Garfield,President,Hillary Clinton,DEM,240210,3,2,56,61,
Garfield,U.S. Senate,James Lankford,REP,240210,9,12,335,356,
Garfield,U.S. Senate,Robert Murphy,LIB,240210,0,1,11,12,
Garfield,U.S. Senate,Mike Workman,DEM,240210,3,1,44,48,
Garfield,U.S. Senate,Mark Beard,IND,240210,1,0,6,7,
Garfield,U.S. Senate,Sean Braddy,IND,240210,1,0,7,8,
Garfield,U.S. House,Frank Lucas,REP,240210,9,12,340,361,03
Garfield,U.S. House,Frankie Robbins,DEM,240210,5,2,60,67,03
Garfield,State Senate,Roland Pederson,REP,240210,8,9,286,303,19
Garfield,State Senate,Rhonda Harlow,DEM,240210,3,2,68,73,19
Garfield,State Senate,Whitney Hall,IND,240210,3,2,46,51,19
Garfield,President,Donald Trump,REP,240211,23,50,443,516,
Garfield,President,Gary Johnson,LIB,240211,4,0,15,19,
Garfield,President,Hillary Clinton,DEM,240211,6,3,44,53,
Garfield,U.S. Senate,James Lankford,REP,240211,29,48,432,509,
Garfield,U.S. Senate,Robert Murphy,LIB,240211,1,1,9,11,
Garfield,U.S. Senate,Mike Workman,DEM,240211,2,3,45,50,
Garfield,U.S. Senate,Mark Beard,IND,240211,0,0,6,6,
Garfield,U.S. Senate,Sean Braddy,IND,240211,2,1,10,13,
Garfield,U.S. House,Frank Lucas,REP,240211,27,49,445,521,03
Garfield,U.S. House,Frankie Robbins,DEM,240211,7,4,55,66,03
Garfield,State Senate,Roland Pederson,REP,240211,27,47,385,459,19
Garfield,State Senate,Rhonda Harlow,DEM,240211,6,3,54,63,19
Garfield,State Senate,Whitney Hall,IND,240211,2,2,61,65,19
Garfield,President,Donald Trump,REP,240212,11,12,322,345,
Garfield,President,Gary Johnson,LIB,240212,1,1,18,20,
Garfield,President,Hillary Clinton,DEM,240212,5,1,28,34,
Garfield,U.S. Senate,James Lankford,REP,240212,12,14,330,356,
Garfield,U.S. Senate,Robert Murphy,LIB,240212,0,0,8,8,
Garfield,U.S. Senate,Mike Workman,DEM,240212,7,0,21,28,
Garfield,U.S. Senate,Mark Beard,IND,240212,0,0,5,5,
Garfield,U.S. Senate,Sean Braddy,IND,240212,0,0,6,6,
Garfield,U.S. House,Frank Lucas,REP,240212,11,14,326,351,03
Garfield,U.S. House,Frankie Robbins,DEM,240212,8,0,41,49,03
Garfield,State Senate,Roland Pederson,REP,240212,13,13,288,314,19
Garfield,State Senate,Rhonda Harlow,DEM,240212,4,0,37,41,19
Garfield,State Senate,Whitney Hall,IND,240212,2,1,37,40,19
Garfield,President,Donald Trump,REP,240301,21,79,314,414,
Garfield,President,Gary Johnson,LIB,240301,4,3,38,45,
Garfield,President,Hillary Clinton,DEM,240301,5,29,114,148,
Garfield,U.S. Senate,James Lankford,REP,240301,22,86,356,464,
Garfield,U.S. Senate,Robert Murphy,LIB,240301,1,1,9,11,
Garfield,U.S. Senate,Mike Workman,DEM,240301,6,23,84,113,
Garfield,U.S. Senate,Mark Beard,IND,240301,0,1,5,6,
Garfield,U.S. Senate,Sean Braddy,IND,240301,1,3,11,15,
Garfield,U.S. House,Frank Lucas,REP,240301,21,85,368,474,03
Garfield,U.S. House,Frankie Robbins,DEM,240301,8,29,98,135,03
Garfield,State Senate,Roland Pederson,REP,240301,19,64,300,383,19
Garfield,State Senate,Rhonda Harlow,DEM,240301,7,30,118,155,19
Garfield,State Senate,Whitney Hall,IND,240301,4,18,47,69,19
Garfield,State House,Chad Caldwell,REP,240301,20,79,352,451,40
Garfield,State House,Pierce Jones,DEM,240301,8,33,108,149,40
Garfield,President,Donald Trump,REP,240302,91,302,915,1308,
Garfield,President,Gary Johnson,LIB,240302,8,22,87,117,
Garfield,President,Hillary Clinton,DEM,240302,14,111,257,382,
Garfield,U.S. Senate,James Lankford,REP,240302,89,336,968,1393,
Garfield,U.S. Senate,Robert Murphy,LIB,240302,3,9,41,53,
Garfield,U.S. Senate,Mike Workman,DEM,240302,17,83,179,279,
Garfield,U.S. Senate,Mark Beard,IND,240302,3,2,25,30,
Garfield,U.S. Senate,Sean Braddy,IND,240302,1,6,32,39,
Garfield,U.S. House,Frank Lucas,REP,240302,93,331,1003,1427,03
Garfield,U.S. House,Frankie Robbins,DEM,240302,18,103,240,361,03
Garfield,State Senate,Roland Pederson,REP,240302,79,274,802,1155,19
Garfield,State Senate,Rhonda Harlow,DEM,240302,24,118,275,417,19
Garfield,State Senate,Whitney Hall,IND,240302,6,42,167,215,19
Garfield,President,Donald Trump,REP,240304,85,290,800,1175,
Garfield,President,Gary Johnson,LIB,240304,15,15,57,87,
Garfield,President,Hillary Clinton,DEM,240304,35,87,177,299,
Garfield,U.S. Senate,James Lankford,REP,240304,106,321,850,1277,
Garfield,U.S. Senate,Robert Murphy,LIB,240304,8,4,23,35,
Garfield,U.S. Senate,Mike Workman,DEM,240304,24,62,128,214,
Garfield,U.S. Senate,Mark Beard,IND,240304,0,0,14,14,
Garfield,U.S. Senate,Sean Braddy,IND,240304,1,8,19,28,
Garfield,U.S. House,Frank Lucas,REP,240304,109,317,863,1289,03
Garfield,U.S. House,Frankie Robbins,DEM,240304,30,78,169,277,03
Garfield,State Senate,Roland Pederson,REP,240304,99,255,689,1043,19
Garfield,State Senate,Rhonda Harlow,DEM,240304,28,98,204,330,19
Garfield,State Senate,Whitney Hall,IND,240304,9,42,140,191,19
Garfield,President,Donald Trump,REP,240305,77,218,695,990,
Garfield,President,Gary Johnson,LIB,240305,6,9,38,53,
Garfield,President,Hillary Clinton,DEM,240305,35,61,129,225,
Garfield,U.S. Senate,James Lankford,REP,240305,92,237,737,1066,
Garfield,U.S. Senate,Robert Murphy,LIB,240305,0,3,22,25,
Garfield,U.S. Senate,Mike Workman,DEM,240305,27,44,83,154,
Garfield,U.S. Senate,Mark Beard,IND,240305,0,1,11,12,
Garfield,U.S. Senate,Sean Braddy,IND,240305,2,4,14,20,
Garfield,U.S. House,Frank Lucas,REP,240305,89,229,755,1073,03
Garfield,U.S. House,Frankie Robbins,DEM,240305,33,60,113,206,03
Garfield,State Senate,Roland Pederson,REP,240305,90,194,650,934,19
Garfield,State Senate,Rhonda Harlow,DEM,240305,22,62,113,197,19
Garfield,State Senate,Whitney Hall,IND,240305,8,36,106,150,19
Garfield,State House,Chad Caldwell,REP,240305,88,225,723,1036,40
Garfield,State House,Pierce Jones,DEM,240305,32,62,141,235,40
Garfield,President,Donald Trump,REP,240306,30,94,377,501,
Garfield,President,Gary Johnson,LIB,240306,3,2,24,29,
Garfield,President,Hillary Clinton,DEM,240306,14,22,107,143,
Garfield,U.S. Senate,James Lankford,REP,240306,28,102,395,525,
Garfield,U.S. Senate,Robert Murphy,LIB,240306,3,2,6,11,
Garfield,U.S. Senate,Mike Workman,DEM,240306,14,15,90,119,
Garfield,U.S. Senate,Mark Beard,IND,240306,0,2,5,7,
Garfield,U.S. Senate,Sean Braddy,IND,240306,1,0,10,11,
Garfield,U.S. House,Frank Lucas,REP,240306,30,103,395,528,03
Garfield,U.S. House,Frankie Robbins,DEM,240306,16,15,111,142,03
Garfield,State Senate,Roland Pederson,REP,240306,26,88,342,456,19
Garfield,State Senate,Rhonda Harlow,DEM,240306,13,19,114,146,19
Garfield,State Senate,Whitney Hall,IND,240306,5,12,50,67,19
Garfield,State House,Chad Caldwell,REP,240306,25,97,398,520,40
Garfield,State House,Pierce Jones,DEM,240306,19,23,104,146,40
Garfield,President,Donald Trump,REP,240307,25,23,193,241,
Garfield,President,Gary Johnson,LIB,240307,2,3,11,16,
Garfield,President,Hillary Clinton,DEM,240307,8,5,34,47,
Garfield,U.S. Senate,James Lankford,REP,240307,26,27,204,257,
Garfield,U.S. Senate,Robert Murphy,LIB,240307,0,1,2,3,
Garfield,U.S. Senate,Mike Workman,DEM,240307,6,3,23,32,
Garfield,U.S. Senate,Mark Beard,IND,240307,2,0,2,4,
Garfield,U.S. Senate,Sean Braddy,IND,240307,0,0,4,4,
Garfield,U.S. House,Frank Lucas,REP,240307,27,27,204,258,03
Garfield,U.S. House,Frankie Robbins,DEM,240307,6,4,31,41,03
Garfield,State Senate,Roland Pederson,REP,240307,24,25,166,215,19
Garfield,State Senate,Rhonda Harlow,DEM,240307,8,4,38,50,19
Garfield,State Senate,Whitney Hall,IND,240307,2,2,29,33,19
Garfield,State House,Chad Caldwell,REP,240307,26,25,199,250,40
Garfield,State House,Pierce Jones,DEM,240307,8,6,30,44,40
Garfield,President,Donald Trump,REP,240308,53,79,474,606,
Garfield,President,Gary Johnson,LIB,240308,5,6,17,28,
Garfield,President,Hillary Clinton,DEM,240308,11,20,67,98,
Garfield,U.S. Senate,James Lankford,REP,240308,53,84,485,622,
Garfield,U.S. Senate,Robert Murphy,LIB,240308,1,1,10,12,
Garfield,U.S. Senate,Mike Workman,DEM,240308,10,18,41,69,
Garfield,U.S. Senate,Mark Beard,IND,240308,2,0,8,10,
Garfield,U.S. Senate,Sean Braddy,IND,240308,2,1,9,12,
Garfield,U.S. House,Frank Lucas,REP,240308,56,85,488,629,03
Garfield,U.S. House,Frankie Robbins,DEM,240308,14,18,63,95,03
Garfield,State Senate,Roland Pederson,REP,240308,51,79,404,534,19
Garfield,State Senate,Rhonda Harlow,DEM,240308,14,21,82,117,19
Garfield,State Senate,Whitney Hall,IND,240308,4,3,67,74,19
Garfield,President,Donald Trump,REP,240309,16,25,436,477,
Garfield,President,Gary Johnson,LIB,240309,2,1,13,16,
Garfield,President,Hillary Clinton,DEM,240309,7,5,51,63,
Garfield,U.S. Senate,James Lankford,REP,240309,16,24,436,476,
Garfield,U.S. Senate,Robert Murphy,LIB,240309,2,1,12,15,
Garfield,U.S. Senate,Mike Workman,DEM,240309,5,6,35,46,
Garfield,U.S. Senate,Mark Beard,IND,240309,0,0,6,6,
Garfield,U.S. Senate,Sean Braddy,IND,240309,1,0,12,13,
Garfield,U.S. House,Frank Lucas,REP,240309,16,23,443,482,03
Garfield,U.S. House,Frankie Robbins,DEM,240309,8,7,56,71,03
Garfield,State Senate,Roland Pederson,REP,240309,14,21,376,411,19
Garfield,State Senate,Rhonda Harlow,DEM,240309,6,7,59,72,19
Garfield,State Senate,Whitney Hall,IND,240309,4,3,63,70,19
Garfield,President,Donald Trump,REP,240310,25,50,420,495,
Garfield,President,Gary Johnson,LIB,240310,3,2,21,26,
Garfield,President,Hillary Clinton,DEM,240310,8,13,74,95,
Garfield,U.S. Senate,James Lankford,REP,240310,27,53,433,513,
Garfield,U.S. Senate,Robert Murphy,LIB,240310,1,0,11,12,
Garfield,U.S. Senate,Mike Workman,DEM,240310,7,10,54,71,
Garfield,U.S. Senate,Mark Beard,IND,240310,0,1,9,10,
Garfield,U.S. Senate,Sean Braddy,IND,240310,0,2,10,12,
Garfield,U.S. House,Frank Lucas,REP,240310,28,50,424,502,03
Garfield,U.S. House,Frankie Robbins,DEM,240310,7,16,86,109,03
Garfield,State Senate,Roland Pederson,REP,240310,28,51,389,468,19
Garfield,State Senate,Rhonda Harlow,DEM,240310,7,14,75,96,19
Garfield,State Senate,Whitney Hall,IND,240310,0,1,50,51,19
Garfield,President,Donald Trump,REP,240311,22,83,693,798,
Garfield,President,Gary Johnson,LIB,240311,3,11,39,53,
Garfield,President,Hillary Clinton,DEM,240311,4,22,111,137,
Garfield,U.S. Senate,James Lankford,REP,240311,23,85,695,803,
Garfield,U.S. Senate,Robert Murphy,LIB,240311,2,2,11,15,
Garfield,U.S. Senate,Mike Workman,DEM,240311,4,20,103,127,
Garfield,U.S. Senate,Mark Beard,IND,240311,0,3,13,16,
Garfield,U.S. Senate,Sean Braddy,IND,240311,1,3,17,21,
Garfield,U.S. House,Frank Lucas,REP,240311,25,91,702,818,03
Garfield,U.S. House,Frankie Robbins,DEM,240311,5,22,135,162,03
Garfield,State Senate,Roland Pederson,REP,240311,21,70,604,695,19
Garfield,State Senate,Rhonda Harlow,DEM,240311,5,32,147,184,19
Garfield,State Senate,Whitney Hall,IND,240311,4,12,85,101,19
Garvin,President,Donald Trump,REP,250001,11,15,374,400,
Garvin,President,Gary Johnson,LIB,250001,0,1,23,24,
Garvin,President,Hillary Clinton,DEM,250001,0,2,56,58,
Garvin,U.S. Senate,James Lankford,REP,250001,11,15,364,390,
Garvin,U.S. Senate,Robert Murphy,LIB,250001,0,1,9,10,
Garvin,U.S. Senate,Mike Workman,DEM,250001,0,2,47,49,
Garvin,U.S. Senate,Mark Beard,IND,250001,0,0,12,12,
Garvin,U.S. Senate,Sean Braddy,IND,250001,0,0,13,13,
Garvin,U.S. House,Tom Cole,REP,250001,11,14,373,398,04
Garvin,U.S. House,Sevier White,LIB,250001,0,2,11,13,04
Garvin,U.S. House,Christina Owen,DEM,250001,0,2,63,65,04
Garvin,State Senate,Paul Scott,REP,250001,11,16,348,375,43
Garvin,State Senate,Leah Pollan,DEM,250001,0,2,88,90,43
Garvin,State House,Tim Downing,REP,250001,11,15,324,350,42
Garvin,State House,Liz George,DEM,250001,0,3,116,119,42
Garvin,President,Donald Trump,REP,250002,16,16,472,504,
Garvin,President,Gary Johnson,LIB,250002,1,0,27,28,
Garvin,President,Hillary Clinton,DEM,250002,2,2,68,72,
Garvin,U.S. Senate,James Lankford,REP,250002,17,14,477,508,
Garvin,U.S. Senate,Robert Murphy,LIB,250002,0,0,8,8,
Garvin,U.S. Senate,Mike Workman,DEM,250002,0,2,61,63,
Garvin,U.S. Senate,Mark Beard,IND,250002,0,1,14,15,
Garvin,U.S. Senate,Sean Braddy,IND,250002,1,0,7,8,
Garvin,U.S. House,Tom Cole,REP,250002,17,14,460,491,04
Garvin,U.S. House,Sevier White,LIB,250002,0,0,21,21,04
Garvin,U.S. House,Christina Owen,DEM,250002,2,3,80,85,04
Garvin,State Senate,Paul Scott,REP,250002,13,14,428,455,43
Garvin,State Senate,Leah Pollan,DEM,250002,3,3,131,137,43
Garvin,State House,Tim Downing,REP,250002,15,15,384,414,42
Garvin,State House,Liz George,DEM,250002,4,2,178,184,42
Garvin,President,Donald Trump,REP,250003,18,16,593,627,
Garvin,President,Gary Johnson,LIB,250003,0,0,18,18,
Garvin,President,Hillary Clinton,DEM,250003,0,1,69,70,
Garvin,U.S. Senate,James Lankford,REP,250003,17,16,580,613,
Garvin,U.S. Senate,Robert Murphy,LIB,250003,1,0,6,7,
Garvin,U.S. Senate,Mike Workman,DEM,250003,0,1,64,65,
Garvin,U.S. Senate,Mark Beard,IND,250003,0,0,11,11,
Garvin,U.S. Senate,Sean Braddy,IND,250003,0,0,13,13,
Garvin,U.S. House,Tom Cole,REP,250003,15,15,576,606,04
Garvin,U.S. House,Sevier White,LIB,250003,2,0,16,18,04
Garvin,U.S. House,Christina Owen,DEM,250003,1,1,81,83,04
Garvin,State Senate,Paul Scott,REP,250003,18,12,530,560,43
Garvin,State Senate,Leah Pollan,DEM,250003,0,4,135,139,43
Garvin,State House,Tim Downing,REP,250003,18,14,507,539,42
Garvin,State House,Liz George,DEM,250003,0,2,161,163,42
Garvin,President,Donald Trump,REP,250005,20,41,725,786,
Garvin,President,Gary Johnson,LIB,250005,2,1,23,26,
Garvin,President,Hillary Clinton,DEM,250005,4,7,61,72,
Garvin,U.S. Senate,James Lankford,REP,250005,19,39,698,756,
Garvin,U.S. Senate,Robert Murphy,LIB,250005,1,1,14,16,
Garvin,U.S. Senate,Mike Workman,DEM,250005,5,8,66,79,
Garvin,U.S. Senate,Mark Beard,IND,250005,0,1,7,8,
Garvin,U.S. Senate,Sean Braddy,IND,250005,0,0,21,21,
Garvin,U.S. House,Tom Cole,REP,250005,20,39,713,772,04
Garvin,U.S. House,Sevier White,LIB,250005,1,1,20,22,04
Garvin,U.S. House,Christina Owen,DEM,250005,4,9,72,85,04
Garvin,State Senate,Greg Mccortney,REP,250005,20,36,658,714,13
Garvin,State Senate,Eric Hall,DEM,250005,5,12,136,153,13
Garvin,State House,Tim Downing,REP,250005,21,35,636,692,42
Garvin,State House,Liz George,DEM,250005,4,13,163,180,42
Garvin,President,Donald Trump,REP,250006,13,24,238,275,
Garvin,President,Gary Johnson,LIB,250006,0,2,17,19,
Garvin,President,Hillary Clinton,DEM,250006,2,7,72,81,
Garvin,U.S. Senate,James Lankford,REP,250006,12,23,218,253,
Garvin,U.S. Senate,Robert Murphy,LIB,250006,0,2,7,9,
Garvin,U.S. Senate,Mike Workman,DEM,250006,2,6,74,82,
Garvin,U.S. Senate,Mark Beard,IND,250006,0,0,8,8,
Garvin,U.S. Senate,Sean Braddy,IND,250006,0,2,15,17,
Garvin,U.S. House,Tom Cole,REP,250006,12,25,224,261,04
Garvin,U.S. House,Sevier White,LIB,250006,0,1,12,13,04
Garvin,U.S. House,Christina Owen,DEM,250006,2,7,87,96,04
Garvin,State Senate,Greg Mccortney,REP,250006,12,24,192,228,13
Garvin,State Senate,Eric Hall,DEM,250006,2,9,128,139,13
Garvin,State House,Tim Downing,REP,250006,12,26,216,254,42
Garvin,State House,Liz George,DEM,250006,2,7,107,116,42
Garvin,President,Donald Trump,REP,250007,10,83,261,354,
Garvin,President,Gary Johnson,LIB,250007,0,1,11,12,
Garvin,President,Hillary Clinton,DEM,250007,11,26,59,96,
Garvin,U.S. Senate,James Lankford,REP,250007,13,85,268,366,
Garvin,U.S. Senate,Robert Murphy,LIB,250007,0,0,4,4,
Garvin,U.S. Senate,Mike Workman,DEM,250007,8,22,49,79,
Garvin,U.S. Senate,Mark Beard,IND,250007,0,2,7,9,
Garvin,U.S. Senate,Sean Braddy,IND,250007,0,1,6,7,
Garvin,U.S. House,Tom Cole,REP,250007,10,87,270,367,04
Garvin,U.S. House,Sevier White,LIB,250007,0,0,6,6,04
Garvin,U.S. House,Christina Owen,DEM,250007,10,23,58,91,04
Garvin,State Senate,Greg Mccortney,REP,250007,13,80,239,332,13
Garvin,State Senate,Eric Hall,DEM,250007,8,30,93,131,13
Garvin,State House,Tim Downing,REP,250007,11,85,248,344,42
Garvin,State House,Liz George,DEM,250007,10,26,84,120,42
Garvin,President,Donald Trump,REP,250008,17,86,280,383,
Garvin,President,Gary Johnson,LIB,250008,1,8,18,27,
Garvin,President,Hillary Clinton,DEM,250008,4,23,95,122,
Garvin,U.S. Senate,James Lankford,REP,250008,16,86,296,398,
Garvin,U.S. Senate,Robert Murphy,LIB,250008,0,2,10,12,
Garvin,U.S. Senate,Mike Workman,DEM,250008,6,24,71,101,
Garvin,U.S. Senate,Mark Beard,IND,250008,0,1,3,4,
Garvin,U.S. Senate,Sean Braddy,IND,250008,0,3,9,12,
Garvin,U.S. House,Tom Cole,REP,250008,16,84,291,391,04
Garvin,U.S. House,Sevier White,LIB,250008,1,4,13,18,04
Garvin,U.S. House,Christina Owen,DEM,250008,5,29,84,118,04
Garvin,State Senate,Greg Mccortney,REP,250008,18,87,265,370,13
Garvin,State Senate,Eric Hall,DEM,250008,3,30,118,151,13
Garvin,State House,Tim Downing,REP,250008,16,86,280,382,42
Garvin,State House,Liz George,DEM,250008,4,30,109,143,42
Garvin,President,Donald Trump,REP,250009,16,74,649,739,
Garvin,President,Gary Johnson,LIB,250009,2,1,26,29,
Garvin,President,Hillary Clinton,DEM,250009,3,10,108,121,
Garvin,U.S. Senate,James Lankford,REP,250009,19,76,626,721,
Garvin,U.S. Senate,Robert Murphy,LIB,250009,1,2,13,16,
Garvin,U.S. Senate,Mike Workman,DEM,250009,1,6,107,114,
Garvin,U.S. Senate,Mark Beard,IND,250009,0,0,16,16,
Garvin,U.S. Senate,Sean Braddy,IND,250009,1,0,19,20,
Garvin,U.S. House,Tom Cole,REP,250009,18,75,633,726,04
Garvin,U.S. House,Sevier White,LIB,250009,1,1,23,25,04
Garvin,U.S. House,Christina Owen,DEM,250009,3,8,123,134,04
Garvin,State Senate,Greg Mccortney,REP,250009,19,69,565,653,13
Garvin,State Senate,Eric Hall,DEM,250009,3,13,207,223,13
Garvin,State House,Tim Downing,REP,250009,20,69,576,665,42
Garvin,State House,Liz George,DEM,250009,1,14,200,215,42
Garvin,President,Donald Trump,REP,250013,12,19,227,258,
Garvin,President,Gary Johnson,LIB,250013,1,0,8,9,
Garvin,President,Hillary Clinton,DEM,250013,0,1,60,61,
Garvin,U.S. Senate,James Lankford,REP,250013,13,17,222,252,
Garvin,U.S. Senate,Robert Murphy,LIB,250013,0,0,5,5,
Garvin,U.S. Senate,Mike Workman,DEM,250013,0,2,60,62,
Garvin,U.S. Senate,Mark Beard,IND,250013,0,0,4,4,
Garvin,U.S. Senate,Sean Braddy,IND,250013,0,1,4,5,
Garvin,U.S. House,Tom Cole,REP,250013,13,16,226,255,04
Garvin,U.S. House,Sevier White,LIB,250013,0,0,5,5,04
Garvin,U.S. House,Christina Owen,DEM,250013,0,3,65,68,04
Garvin,State Senate,Greg Mccortney,REP,250013,12,14,198,224,13
Garvin,State Senate,Eric Hall,DEM,250013,1,5,95,101,13
Garvin,President,Donald Trump,REP,250015,12,99,366,477,
Garvin,President,Gary Johnson,LIB,250015,1,9,22,32,
Garvin,President,Hillary Clinton,DEM,250015,5,33,95,133,
Garvin,U.S. Senate,James Lankford,REP,250015,16,104,370,490,
Garvin,U.S. Senate,Robert Murphy,LIB,250015,0,4,13,17,
Garvin,U.S. Senate,Mike Workman,DEM,250015,3,27,82,112,
Garvin,U.S. Senate,Mark Beard,IND,250015,0,4,11,15,
Garvin,U.S. Senate,Sean Braddy,IND,250015,0,2,8,10,
Garvin,U.S. House,Tom Cole,REP,250015,16,105,381,502,04
Garvin,U.S. House,Sevier White,LIB,250015,0,6,19,25,04
Garvin,U.S. House,Christina Owen,DEM,250015,3,30,83,116,04
Garvin,State Senate,Greg Mccortney,REP,250015,12,94,339,445,13
Garvin,State Senate,Eric Hall,DEM,250015,5,45,136,186,13
Garvin,State House,Tim Downing,REP,250015,10,97,360,467,42
Garvin,State House,Liz George,DEM,250015,6,42,117,165,42
Garvin,President,Donald Trump,REP,250016,18,60,425,503,
Garvin,President,Gary Johnson,LIB,250016,0,3,16,19,
Garvin,President,Hillary Clinton,DEM,250016,2,11,96,109,
Garvin,U.S. Senate,James Lankford,REP,250016,17,56,423,496,
Garvin,U.S. Senate,Robert Murphy,LIB,250016,0,1,10,11,
Garvin,U.S. Senate,Mike Workman,DEM,250016,1,12,84,97,
Garvin,U.S. Senate,Mark Beard,IND,250016,1,2,9,12,
Garvin,U.S. Senate,Sean Braddy,IND,250016,1,3,6,10,
Garvin,U.S. House,Tom Cole,REP,250016,18,58,429,505,04
Garvin,U.S. House,Sevier White,LIB,250016,0,4,10,14,04
Garvin,U.S. House,Christina Owen,DEM,250016,2,12,94,108,04
Garvin,State Senate,Greg Mccortney,REP,250016,17,49,383,449,13
Garvin,State Senate,Eric Hall,DEM,250016,3,24,139,166,13
Garvin,State House,Tim Downing,REP,250016,17,58,401,476,42
Garvin,State House,Liz George,DEM,250016,3,15,125,143,42
Garvin,President,Donald Trump,REP,250017,2,71,239,312,
Garvin,President,Gary Johnson,LIB,250017,3,6,23,32,
Garvin,President,Hillary Clinton,DEM,250017,7,34,105,146,
Garvin,U.S. Senate,James Lankford,REP,250017,5,74,235,314,
Garvin,U.S. Senate,Robert Murphy,LIB,250017,1,2,14,17,
Garvin,U.S. Senate,Mike Workman,DEM,250017,6,32,98,136,
Garvin,U.S. Senate,Mark Beard,IND,250017,0,1,11,12,
Garvin,U.S. Senate,Sean Braddy,IND,250017,0,1,6,7,
Garvin,U.S. House,Tom Cole,REP,250017,5,76,246,327,04
Garvin,U.S. House,Sevier White,LIB,250017,0,5,18,23,04
Garvin,U.S. House,Christina Owen,DEM,250017,6,29,103,138,04
Garvin,State Senate,Greg Mccortney,REP,250017,6,69,222,297,13
Garvin,State Senate,Eric Hall,DEM,250017,4,40,135,179,13
Garvin,State House,Tim Downing,REP,250017,5,67,239,311,42
Garvin,State House,Liz George,DEM,250017,5,41,120,166,42
Garvin,President,Donald Trump,REP,250018,31,202,607,840,
Garvin,President,Gary Johnson,LIB,250018,4,9,43,56,
Garvin,President,Hillary Clinton,DEM,250018,17,50,192,259,
Garvin,U.S. Senate,James Lankford,REP,250018,34,203,594,831,
Garvin,U.S. Senate,Robert Murphy,LIB,250018,2,5,26,33,
Garvin,U.S. Senate,Mike Workman,DEM,250018,17,44,172,233,
Garvin,U.S. Senate,Mark Beard,IND,250018,0,3,19,22,
Garvin,U.S. Senate,Sean Braddy,IND,250018,0,6,25,31,
Garvin,U.S. House,Tom Cole,REP,250018,35,202,611,848,04
Garvin,U.S. House,Sevier White,LIB,250018,1,6,37,44,04
Garvin,U.S. House,Christina Owen,DEM,250018,17,54,187,258,04
Garvin,State Senate,Greg Mccortney,REP,250018,35,186,552,773,13
Garvin,State Senate,Eric Hall,DEM,250018,19,71,280,370,13
Garvin,State House,Bobby Cleveland,REP,250018,34,180,560,774,20
Garvin,State House,Matt Failing,DEM,250018,20,77,265,362,20
Garvin,President,Donald Trump,REP,250020,24,48,627,699,
Garvin,President,Gary Johnson,LIB,250020,1,6,34,41,
Garvin,President,Hillary Clinton,DEM,250020,13,21,203,237,
Garvin,U.S. Senate,James Lankford,REP,250020,24,51,616,691,
Garvin,U.S. Senate,Robert Murphy,LIB,250020,0,2,22,24,
Garvin,U.S. Senate,Mike Workman,DEM,250020,10,20,174,204,
Garvin,U.S. Senate,Mark Beard,IND,250020,1,1,22,24,
Garvin,U.S. Senate,Sean Braddy,IND,250020,3,1,26,30,
Garvin,U.S. House,Tom Cole,REP,250020,27,54,646,727,04
Garvin,U.S. House,Sevier White,LIB,250020,0,4,27,31,04
Garvin,U.S. House,Christina Owen,DEM,250020,11,16,187,214,04
Garvin,State Senate,Greg Mccortney,REP,250020,27,46,577,650,13
Garvin,State Senate,Eric Hall,DEM,250020,10,28,274,312,13
Garvin,President,Donald Trump,REP,250021,0,1,10,11,
Garvin,President,Gary Johnson,LIB,250021,0,1,1,2,
Garvin,President,Hillary Clinton,DEM,250021,0,0,5,5,
Garvin,U.S. Senate,James Lankford,REP,250021,0,1,8,9,
Garvin,U.S. Senate,Robert Murphy,LIB,250021,0,1,2,3,
Garvin,U.S. Senate,Mike Workman,DEM,250021,0,0,6,6,
Garvin,U.S. Senate,Mark Beard,IND,250021,0,0,0,0,
Garvin,U.S. Senate,Sean Braddy,IND,250021,0,0,0,0,
Garvin,U.S. House,Tom Cole,REP,250021,0,1,9,10,04
Garvin,U.S. House,Sevier White,LIB,250021,0,1,2,3,04
Garvin,U.S. House,Christina Owen,DEM,250021,0,0,5,5,04
Garvin,State Senate,Greg Mccortney,REP,250021,0,2,9,11,13
Garvin,State Senate,Eric Hall,DEM,250021,0,0,7,7,13
Garvin,State House,Bobby Cleveland,REP,250021,0,1,10,11,20
Garvin,State House,Matt Failing,DEM,250021,0,1,6,7,20
Garvin,President,Donald Trump,REP,250024,12,43,543,598,
Garvin,President,Gary Johnson,LIB,250024,0,3,31,34,
Garvin,President,Hillary Clinton,DEM,250024,6,5,122,133,
Garvin,U.S. Senate,James Lankford,REP,250024,11,40,549,600,
Garvin,U.S. Senate,Robert Murphy,LIB,250024,0,4,12,16,
Garvin,U.S. Senate,Mike Workman,DEM,250024,6,7,115,128,
Garvin,U.S. Senate,Mark Beard,IND,250024,0,0,10,10,
Garvin,U.S. Senate,Sean Braddy,IND,250024,2,0,13,15,
Garvin,U.S. House,Tom Cole,REP,250024,11,39,570,620,04
Garvin,U.S. House,Sevier White,LIB,250024,2,6,15,23,04
Garvin,U.S. House,Christina Owen,DEM,250024,5,7,110,122,04
Garvin,State Senate,Greg Mccortney,REP,250024,11,36,500,547,13
Garvin,State Senate,Eric Hall,DEM,250024,8,13,186,207,13
Garvin,President,Donald Trump,REP,250025,21,46,420,487,
Garvin,President,Gary Johnson,LIB,250025,3,6,21,30,
Garvin,President,Hillary Clinton,DEM,250025,8,12,60,80,
Garvin,U.S. Senate,James Lankford,REP,250025,23,47,412,482,
Garvin,U.S. Senate,Robert Murphy,LIB,250025,2,3,13,18,
Garvin,U.S. Senate,Mike Workman,DEM,250025,6,9,59,74,
Garvin,U.S. Senate,Mark Beard,IND,250025,0,1,10,11,
Garvin,U.S. Senate,Sean Braddy,IND,250025,1,1,6,8,
Garvin,U.S. House,Tom Cole,REP,250025,23,49,430,502,04
Garvin,U.S. House,Sevier White,LIB,250025,2,3,13,18,04
Garvin,U.S. House,Christina Owen,DEM,250025,6,8,58,72,04
Garvin,State Senate,Greg Mccortney,REP,250025,25,44,374,443,13
Garvin,State Senate,Eric Hall,DEM,250025,7,15,117,139,13
Garvin,State House,Bobby Cleveland,REP,250025,27,46,381,454,20
Garvin,State House,Matt Failing,DEM,250025,7,12,103,122,20
Grady,President,Donald Trump,REP,260001,18,96,384,498,
Grady,President,Gary Johnson,LIB,260001,1,4,36,41,
Grady,President,Hillary Clinton,DEM,260001,14,21,118,153,
Grady,U.S. Senate,James Lankford,REP,260001,22,102,400,524,
Grady,U.S. Senate,Robert Murphy,LIB,260001,1,2,14,17,
Grady,U.S. Senate,Mike Workman,DEM,260001,10,16,100,126,
Grady,U.S. Senate,Mark Beard,IND,260001,0,1,12,13,
Grady,U.S. Senate,Sean Braddy,IND,260001,0,1,11,12,
Grady,U.S. House,Tom Cole,REP,260001,22,99,405,526,04
Grady,U.S. House,Sevier White,LIB,260001,2,2,25,29,04
Grady,U.S. House,Christina Owen,DEM,260001,9,20,107,136,04
Grady,State Senate,Lonnie Paxton,REP,260001,19,98,390,507,23
Grady,State Senate,Larry Wasson,DEM,260001,13,19,144,176,23
Grady,State House,Chris Verser,REP,260001,12,50,203,265,56
Grady,State House,David Perryman,DEM,260001,21,69,334,424,56
Grady,President,Donald Trump,REP,260002,35,126,522,683,
Grady,President,Gary Johnson,LIB,260002,2,4,46,52,
Grady,President,Hillary Clinton,DEM,260002,17,31,134,182,
Grady,U.S. Senate,James Lankford,REP,260002,43,131,558,732,
Grady,U.S. Senate,Robert Murphy,LIB,260002,1,3,12,16,
Grady,U.S. Senate,Mike Workman,DEM,260002,8,23,106,137,
Grady,U.S. Senate,Mark Beard,IND,260002,0,2,11,13,
Grady,U.S. Senate,Sean Braddy,IND,260002,1,1,6,8,
Grady,U.S. House,Tom Cole,REP,260002,41,131,560,732,04
Grady,U.S. House,Sevier White,LIB,260002,1,4,18,23,04
Grady,U.S. House,Christina Owen,DEM,260002,12,25,114,151,04
Grady,State Senate,Lonnie Paxton,REP,260002,32,123,492,647,23
Grady,State Senate,Larry Wasson,DEM,260002,21,37,193,251,23
Grady,State House,Chris Verser,REP,260002,14,68,255,337,56
Grady,State House,David Perryman,DEM,260002,38,92,443,573,56
Grady,President,Donald Trump,REP,260003,41,103,466,610,
Grady,President,Gary Johnson,LIB,260003,4,4,41,49,
Grady,President,Hillary Clinton,DEM,260003,15,24,169,208,
Grady,U.S. Senate,James Lankford,REP,260003,44,105,502,651,
Grady,U.S. Senate,Robert Murphy,LIB,260003,2,0,24,26,
Grady,U.S. Senate,Mike Workman,DEM,260003,11,24,118,153,
Grady,U.S. Senate,Mark Beard,IND,260003,3,1,13,17,
Grady,U.S. Senate,Sean Braddy,IND,260003,2,1,19,22,
Grady,U.S. House,Tom Cole,REP,260003,43,103,495,641,04
Grady,U.S. House,Sevier White,LIB,260003,5,3,30,38,04
Grady,U.S. House,Christina Owen,DEM,260003,14,25,147,186,04
Grady,State Senate,Lonnie Paxton,REP,260003,48,98,454,600,23
Grady,State Senate,Larry Wasson,DEM,260003,12,33,207,252,23
Grady,State House,Scott Biggs,REP,260003,40,102,489,631,51
Grady,State House,Charles Murdock,DEM,260003,19,28,169,216,51
Grady,President,Donald Trump,REP,260005,15,59,229,303,
Grady,President,Gary Johnson,LIB,260005,4,5,33,42,
Grady,President,Hillary Clinton,DEM,260005,12,38,169,219,
Grady,U.S. Senate,James Lankford,REP,260005,22,56,228,306,
Grady,U.S. Senate,Robert Murphy,LIB,260005,0,2,16,18,
Grady,U.S. Senate,Mike Workman,DEM,260005,9,36,143,188,
Grady,U.S. Senate,Mark Beard,IND,260005,0,4,25,29,
Grady,U.S. Senate,Sean Braddy,IND,260005,0,5,17,22,
Grady,U.S. House,Tom Cole,REP,260005,17,63,246,326,04
Grady,U.S. House,Sevier White,LIB,260005,1,3,18,22,04
Grady,U.S. House,Christina Owen,DEM,260005,12,37,165,214,04
Grady,State Senate,Lonnie Paxton,REP,260005,17,51,214,282,23
Grady,State Senate,Larry Wasson,DEM,260005,14,50,209,273,23
Grady,State House,Chris Verser,REP,260005,12,27,120,159,56
Grady,State House,David Perryman,DEM,260005,19,74,307,400,56
Grady,President,Donald Trump,REP,260006,26,75,360,461,
Grady,President,Gary Johnson,LIB,260006,2,8,32,42,
Grady,President,Hillary Clinton,DEM,260006,20,25,128,173,
Grady,U.S. Senate,James Lankford,REP,260006,36,75,357,468,
Grady,U.S. Senate,Robert Murphy,LIB,260006,0,2,11,13,
Grady,U.S. Senate,Mike Workman,DEM,260006,13,27,114,154,
Grady,U.S. Senate,Mark Beard,IND,260006,0,3,16,19,
Grady,U.S. Senate,Sean Braddy,IND,260006,3,1,13,17,
Grady,U.S. House,Tom Cole,REP,260006,36,75,355,466,04
Grady,U.S. House,Sevier White,LIB,260006,0,5,20,25,04
Grady,U.S. House,Christina Owen,DEM,260006,16,28,136,180,04
Grady,State Senate,Lonnie Paxton,REP,260006,34,71,318,423,23
Grady,State Senate,Larry Wasson,DEM,260006,17,37,189,243,23
Grady,State House,Chris Verser,REP,260006,22,48,202,272,56
Grady,State House,David Perryman,DEM,260006,30,59,309,398,56
Grady,President,Donald Trump,REP,260008,18,65,353,436,
Grady,President,Gary Johnson,LIB,260008,1,3,46,50,
Grady,President,Hillary Clinton,DEM,260008,17,24,181,222,
Grady,U.S. Senate,James Lankford,REP,260008,22,64,367,453,
Grady,U.S. Senate,Robert Murphy,LIB,260008,1,2,29,32,
Grady,U.S. Senate,Mike Workman,DEM,260008,10,23,151,184,
Grady,U.S. Senate,Mark Beard,IND,260008,0,1,14,15,
Grady,U.S. Senate,Sean Braddy,IND,260008,3,2,21,26,
Grady,U.S. House,Tom Cole,REP,260008,26,63,368,457,04
Grady,U.S. House,Sevier White,LIB,260008,1,2,36,39,04
Grady,U.S. House,Christina Owen,DEM,260008,9,27,174,210,04
Grady,State Senate,Lonnie Paxton,REP,260008,23,58,339,420,23
Grady,State Senate,Larry Wasson,DEM,260008,12,33,225,270,23
Grady,State House,Chris Verser,REP,260008,12,26,216,254,56
Grady,State House,David Perryman,DEM,260008,23,66,357,446,56
Grady,President,Donald Trump,REP,260009,42,133,409,584,
Grady,President,Gary Johnson,LIB,260009,5,5,39,49,
Grady,President,Hillary Clinton,DEM,260009,31,76,205,312,
Grady,U.S. Senate,James Lankford,REP,260009,49,141,430,620,
Grady,U.S. Senate,Robert Murphy,LIB,260009,1,4,16,21,
Grady,U.S. Senate,Mike Workman,DEM,260009,22,61,169,252,
Grady,U.S. Senate,Mark Beard,IND,260009,1,1,14,16,
Grady,U.S. Senate,Sean Braddy,IND,260009,3,4,23,30,
Grady,U.S. House,Tom Cole,REP,260009,52,143,441,636,04
Grady,U.S. House,Sevier White,LIB,260009,2,7,22,31,04
Grady,U.S. House,Christina Owen,DEM,260009,22,61,187,270,04
Grady,State Senate,Lonnie Paxton,REP,260009,42,133,378,553,23
Grady,State Senate,Larry Wasson,DEM,260009,33,77,263,373,23
Grady,State House,Chris Verser,REP,260009,24,76,221,321,56
Grady,State House,David Perryman,DEM,260009,52,133,431,616,56
Grady,President,Donald Trump,REP,260011,15,47,269,331,
Grady,President,Gary Johnson,LIB,260011,2,6,14,22,
Grady,President,Hillary Clinton,DEM,260011,2,13,49,64,
Grady,U.S. Senate,James Lankford,REP,260011,17,50,275,342,
Grady,U.S. Senate,Robert Murphy,LIB,260011,0,1,3,4,
Grady,U.S. Senate,Mike Workman,DEM,260011,2,12,43,57,
Grady,U.S. Senate,Mark Beard,IND,260011,0,0,8,8,
Grady,U.S. Senate,Sean Braddy,IND,260011,0,4,4,8,
Grady,U.S. House,Tom Cole,REP,260011,17,52,276,345,04
Grady,U.S. House,Sevier White,LIB,260011,0,4,10,14,04
Grady,U.S. House,Christina Owen,DEM,260011,2,11,46,59,04
Grady,State Senate,Lonnie Paxton,REP,260011,15,45,255,315,23
Grady,State Senate,Larry Wasson,DEM,260011,4,20,73,97,23
Grady,State House,Scott Biggs,REP,260011,15,53,258,326,51
Grady,State House,Charles Murdock,DEM,260011,4,11,71,86,51
Grady,President,Donald Trump,REP,260016,5,4,120,129,
Grady,President,Gary Johnson,LIB,260016,0,0,2,2,
Grady,President,Hillary Clinton,DEM,260016,1,0,21,22,
Grady,U.S. Senate,James Lankford,REP,260016,4,4,120,128,
Grady,U.S. Senate,Robert Murphy,LIB,260016,0,0,0,0,
Grady,U.S. Senate,Mike Workman,DEM,260016,1,0,15,16,
Grady,U.S. Senate,Mark Beard,IND,260016,1,0,4,5,
Grady,U.S. Senate,Sean Braddy,IND,260016,0,0,2,2,
Grady,U.S. House,Tom Cole,REP,260016,4,4,123,131,04
Grady,U.S. House,Sevier White,LIB,260016,0,0,0,0,04
Grady,U.S. House,Christina Owen,DEM,260016,2,0,18,20,04
Grady,State Senate,Paul Scott,REP,260016,4,4,104,112,43
Grady,State Senate,Leah Pollan,DEM,260016,2,0,36,38,43
Grady,State House,Scott Biggs,REP,260016,5,4,99,108,51
Grady,State House,Charles Murdock,DEM,260016,1,0,40,41,51
Grady,President,Donald Trump,REP,260017,6,17,203,226,
Grady,President,Gary Johnson,LIB,260017,0,0,11,11,
Grady,President,Hillary Clinton,DEM,260017,0,1,33,34,
Grady,U.S. Senate,James Lankford,REP,260017,7,17,196,220,
Grady,U.S. Senate,Robert Murphy,LIB,260017,0,0,6,6,
Grady,U.S. Senate,Mike Workman,DEM,260017,0,0,31,31,
Grady,U.S. Senate,Mark Beard,IND,260017,0,0,4,4,
Grady,U.S. Senate,Sean Braddy,IND,260017,0,0,9,9,
Grady,U.S. House,Tom Cole,REP,260017,7,17,197,221,04
Grady,U.S. House,Sevier White,LIB,260017,0,0,10,10,04
Grady,U.S. House,Christina Owen,DEM,260017,0,0,40,40,04
Grady,State Senate,Lonnie Paxton,REP,260017,6,14,189,209,23
Grady,State Senate,Larry Wasson,DEM,260017,1,4,55,60,23
Grady,State House,Chris Verser,REP,260017,5,10,117,132,56
Grady,State House,David Perryman,DEM,260017,2,8,129,139,56
Grady,President,Donald Trump,REP,260020,17,25,223,265,
Grady,President,Gary Johnson,LIB,260020,1,3,13,17,
Grady,President,Hillary Clinton,DEM,260020,3,9,40,52,
Grady,U.S. Senate,James Lankford,REP,260020,19,25,216,260,
Grady,U.S. Senate,Robert Murphy,LIB,260020,0,2,8,10,
Grady,U.S. Senate,Mike Workman,DEM,260020,2,11,36,49,
Grady,U.S. Senate,Mark Beard,IND,260020,0,0,11,11,
Grady,U.S. Senate,Sean Braddy,IND,260020,0,0,4,4,
Grady,U.S. House,Tom Cole,REP,260020,18,23,217,258,04
Grady,U.S. House,Sevier White,LIB,260020,0,2,6,8,04
Grady,U.S. House,Christina Owen,DEM,260020,2,12,50,64,04
Grady,State Senate,Lonnie Paxton,REP,260020,17,25,196,238,23
Grady,State Senate,Larry Wasson,DEM,260020,4,12,69,85,23
Grady,State House,Scott Biggs,REP,260020,17,23,186,226,51
Grady,State House,Charles Murdock,DEM,260020,4,15,85,104,51
Grady,President,Donald Trump,REP,260021,8,17,218,243,
Grady,President,Gary Johnson,LIB,260021,1,0,11,12,
Grady,President,Hillary Clinton,DEM,260021,2,1,32,35,
Grady,U.S. Senate,James Lankford,REP,260021,9,15,224,248,
Grady,U.S. Senate,Robert Murphy,LIB,260021,1,0,2,3,
Grady,U.S. Senate,Mike Workman,DEM,260021,1,3,27,31,
Grady,U.S. Senate,Mark Beard,IND,260021,0,0,3,3,
Grady,U.S. Senate,Sean Braddy,IND,260021,0,0,6,6,
Grady,U.S. House,Tom Cole,REP,260021,6,16,224,246,04
Grady,U.S. House,Sevier White,LIB,260021,4,0,7,11,04
Grady,U.S. House,Christina Owen,DEM,260021,1,2,32,35,04
Grady,State Senate,Lonnie Paxton,REP,260021,7,15,207,229,23
Grady,State Senate,Larry Wasson,DEM,260021,4,3,53,60,23
Grady,State House,Chris Verser,REP,260021,5,5,120,130,56
Grady,State House,David Perryman,DEM,260021,6,13,138,157,56
Grady,President,Donald Trump,REP,260023,5,11,119,135,
Grady,President,Gary Johnson,LIB,260023,0,1,5,6,
Grady,President,Hillary Clinton,DEM,260023,0,3,17,20,
Grady,U.S. Senate,James Lankford,REP,260023,4,10,121,135,
Grady,U.S. Senate,Robert Murphy,LIB,260023,0,1,2,3,
Grady,U.S. Senate,Mike Workman,DEM,260023,1,3,13,17,
Grady,U.S. Senate,Mark Beard,IND,260023,0,0,2,2,
Grady,U.S. Senate,Sean Braddy,IND,260023,0,1,2,3,
Grady,U.S. House,Tom Cole,REP,260023,4,11,122,137,04
Grady,U.S. House,Sevier White,LIB,260023,0,1,6,7,04
Grady,U.S. House,Christina Owen,DEM,260023,1,3,13,17,04
Grady,State Senate,Paul Scott,REP,260023,5,12,116,133,43
Grady,State Senate,Leah Pollan,DEM,260023,0,3,22,25,43
Grady,State House,Scott Biggs,REP,260023,4,13,117,134,51
Grady,State House,Charles Murdock,DEM,260023,1,2,22,25,51
Grady,President,Donald Trump,REP,260025,16,45,320,381,
Grady,President,Gary Johnson,LIB,260025,5,2,15,22,
Grady,President,Hillary Clinton,DEM,260025,7,8,69,84,
Grady,U.S. Senate,James Lankford,REP,260025,24,47,337,408,
Grady,U.S. Senate,Robert Murphy,LIB,260025,0,0,6,6,
Grady,U.S. Senate,Mike Workman,DEM,260025,4,6,51,61,
Grady,U.S. Senate,Mark Beard,IND,260025,0,1,2,3,
Grady,U.S. Senate,Sean Braddy,IND,260025,0,0,6,6,
Grady,U.S. House,Tom Cole,REP,260025,23,42,342,407,04
Grady,U.S. House,Sevier White,LIB,260025,0,3,10,13,04
Grady,U.S. House,Christina Owen,DEM,260025,5,9,52,66,04
Grady,State Senate,Lonnie Paxton,REP,260025,18,43,302,363,23
Grady,State Senate,Larry Wasson,DEM,260025,7,9,98,114,23
Grady,State House,Scott Biggs,REP,260025,21,44,316,381,51
Grady,State House,Charles Murdock,DEM,260025,6,9,77,92,51
Grady,President,Donald Trump,REP,260026,21,17,145,183,
Grady,President,Gary Johnson,LIB,260026,0,0,8,8,
Grady,President,Hillary Clinton,DEM,260026,2,2,28,32,
Grady,U.S. Senate,James Lankford,REP,260026,17,17,143,177,
Grady,U.S. Senate,Robert Murphy,LIB,260026,2,0,3,5,
Grady,U.S. Senate,Mike Workman,DEM,260026,3,2,26,31,
Grady,U.S. Senate,Mark Beard,IND,260026,1,0,7,8,
Grady,U.S. Senate,Sean Braddy,IND,260026,0,0,3,3,
Grady,U.S. House,Tom Cole,REP,260026,17,14,140,171,04
Grady,U.S. House,Sevier White,LIB,260026,4,3,7,14,04
Grady,U.S. House,Christina Owen,DEM,260026,2,2,35,39,04
Grady,State Senate,Paul Scott,REP,260026,16,17,136,169,43
Grady,State Senate,Leah Pollan,DEM,260026,6,2,46,54,43
Grady,State House,Scott Biggs,REP,260026,17,15,145,177,51
Grady,State House,Charles Murdock,DEM,260026,5,4,36,45,51
Grady,President,Donald Trump,REP,260027,13,63,249,325,
Grady,President,Gary Johnson,LIB,260027,2,1,12,15,
Grady,President,Hillary Clinton,DEM,260027,4,15,35,54,
Grady,U.S. Senate,James Lankford,REP,260027,12,66,245,323,
Grady,U.S. Senate,Robert Murphy,LIB,260027,0,2,4,6,
Grady,U.S. Senate,Mike Workman,DEM,260027,3,12,34,49,
Grady,U.S. Senate,Mark Beard,IND,260027,3,0,3,6,
Grady,U.S. Senate,Sean Braddy,IND,260027,2,2,5,9,
Grady,U.S. House,Tom Cole,REP,260027,16,66,241,323,04
Grady,U.S. House,Sevier White,LIB,260027,1,2,10,13,04
Grady,U.S. House,Christina Owen,DEM,260027,3,14,37,54,04
Grady,State Senate,Lonnie Paxton,REP,260027,15,66,227,308,23
Grady,State Senate,Larry Wasson,DEM,260027,5,16,58,79,23
Grady,State House,Chris Verser,REP,260027,9,38,146,193,56
Grady,State House,David Perryman,DEM,260027,10,44,142,196,56
Grady,President,Donald Trump,REP,260028,40,61,648,749,
Grady,President,Gary Johnson,LIB,260028,3,6,43,52,
Grady,President,Hillary Clinton,DEM,260028,9,19,111,139,
Grady,U.S. Senate,James Lankford,REP,260028,38,65,647,750,
Grady,U.S. Senate,Robert Murphy,LIB,260028,2,3,22,27,
Grady,U.S. Senate,Mike Workman,DEM,260028,10,13,93,116,
Grady,U.S. Senate,Mark Beard,IND,260028,1,2,13,16,
Grady,U.S. Senate,Sean Braddy,IND,260028,0,3,26,29,
Grady,U.S. House,Tom Cole,REP,260028,38,62,635,735,04
Grady,U.S. House,Sevier White,LIB,260028,4,5,43,52,04
Grady,U.S. House,Christina Owen,DEM,260028,10,20,121,151,04
Grady,State Senate,Lonnie Paxton,REP,260028,37,66,627,730,23
Grady,State Senate,Larry Wasson,DEM,260028,11,19,159,189,23
Grady,State House,Scott Biggs,REP,260028,36,61,618,715,51
Grady,State House,Charles Murdock,DEM,260028,11,23,172,206,51
Grady,President,Donald Trump,REP,260029,40,48,891,979,
Grady,President,Gary Johnson,LIB,260029,0,6,52,58,
Grady,President,Hillary Clinton,DEM,260029,10,12,150,172,
Grady,U.S. Senate,James Lankford,REP,260029,40,50,915,1005,
Grady,U.S. Senate,Robert Murphy,LIB,260029,2,3,28,33,
Grady,U.S. Senate,Mike Workman,DEM,260029,8,12,127,147,
Grady,U.S. Senate,Mark Beard,IND,260029,0,0,16,16,
Grady,U.S. Senate,Sean Braddy,IND,260029,0,2,12,14,
Grady,U.S. House,Tom Cole,REP,260029,40,49,906,995,04
Grady,U.S. House,Sevier White,LIB,260029,2,4,41,47,04
Grady,U.S. House,Christina Owen,DEM,260029,8,14,145,167,04
Grady,State Senate,Lonnie Paxton,REP,260029,42,50,914,1006,23
Grady,State Senate,Larry Wasson,DEM,260029,8,17,175,200,23
Grady,State House,Chris Verser,REP,260029,33,39,498,570,56
Grady,State House,David Perryman,DEM,260029,17,28,585,630,56
Grady,President,Donald Trump,REP,260031,10,18,369,397,
Grady,President,Gary Johnson,LIB,260031,1,1,20,22,
Grady,President,Hillary Clinton,DEM,260031,1,0,73,74,
Grady,U.S. Senate,James Lankford,REP,260031,11,17,374,402,
Grady,U.S. Senate,Robert Murphy,LIB,260031,0,1,6,7,
Grady,U.S. Senate,Mike Workman,DEM,260031,0,1,61,62,
Grady,U.S. Senate,Mark Beard,IND,260031,1,0,12,13,
Grady,U.S. Senate,Sean Braddy,IND,260031,0,0,5,5,
Grady,U.S. House,Tom Cole,REP,260031,11,17,368,396,04
Grady,U.S. House,Sevier White,LIB,260031,1,2,21,24,04
Grady,U.S. House,Christina Owen,DEM,260031,0,0,72,72,04
Grady,State Senate,Lonnie Paxton,REP,260031,11,18,344,373,23
Grady,State Senate,Larry Wasson,DEM,260031,1,1,106,108,23
Grady,State House,Scott Biggs,REP,260031,9,16,358,383,51
Grady,State House,Charles Murdock,DEM,260031,3,3,96,102,51
Grady,President,Donald Trump,REP,260032,35,123,560,718,
Grady,President,Gary Johnson,LIB,260032,0,0,28,28,
Grady,President,Hillary Clinton,DEM,260032,6,21,123,150,
Grady,U.S. Senate,James Lankford,REP,260032,38,122,571,731,
Grady,U.S. Senate,Robert Murphy,LIB,260032,0,1,11,12,
Grady,U.S. Senate,Mike Workman,DEM,260032,4,21,88,113,
Grady,U.S. Senate,Mark Beard,IND,260032,0,1,15,16,
Grady,U.S. Senate,Sean Braddy,IND,260032,0,2,18,20,
Grady,U.S. House,Tom Cole,REP,260032,37,115,582,734,04
Grady,U.S. House,Sevier White,LIB,260032,0,8,17,25,04
Grady,U.S. House,Christina Owen,DEM,260032,5,24,106,135,04
Grady,State Senate,Lonnie Paxton,REP,260032,36,112,527,675,23
Grady,State Senate,Larry Wasson,DEM,260032,6,32,173,211,23
Grady,State House,Scott Biggs,REP,260032,35,118,569,722,51
Grady,State House,Charles Murdock,DEM,260032,7,26,130,163,51
Grady,President,Donald Trump,REP,260033,4,20,184,208,
Grady,President,Gary Johnson,LIB,260033,1,0,7,8,
Grady,President,Hillary Clinton,DEM,260033,1,5,35,41,
Grady,U.S. Senate,James Lankford,REP,260033,5,21,181,207,
Grady,U.S. Senate,Robert Murphy,LIB,260033,0,0,4,4,
Grady,U.S. Senate,Mike Workman,DEM,260033,1,4,35,40,
Grady,U.S. Senate,Mark Beard,IND,260033,0,0,3,3,
Grady,U.S. Senate,Sean Braddy,IND,260033,0,0,3,3,
Grady,U.S. House,Tom Cole,REP,260033,5,21,179,205,04
Grady,U.S. House,Sevier White,LIB,260033,0,0,8,8,04
Grady,U.S. House,Christina Owen,DEM,260033,1,4,36,41,04
Grady,State Senate,Lonnie Paxton,REP,260033,4,18,167,189,23
Grady,State Senate,Larry Wasson,DEM,260033,2,7,58,67,23
Grady,State House,Chris Verser,REP,260033,2,11,98,111,56
Grady,State House,David Perryman,DEM,260033,4,14,123,141,56
Grady,President,Donald Trump,REP,260035,3,8,113,124,
Grady,President,Gary Johnson,LIB,260035,1,1,14,16,
Grady,President,Hillary Clinton,DEM,260035,2,4,14,20,
Grady,U.S. Senate,James Lankford,REP,260035,3,12,117,132,
Grady,U.S. Senate,Robert Murphy,LIB,260035,0,0,3,3,
Grady,U.S. Senate,Mike Workman,DEM,260035,2,1,17,20,
Grady,U.S. Senate,Mark Beard,IND,260035,0,0,1,1,
Grady,U.S. Senate,Sean Braddy,IND,260035,1,0,2,3,
Grady,U.S. House,Tom Cole,REP,260035,3,11,119,133,04
Grady,U.S. House,Sevier White,LIB,260035,1,0,3,4,04
Grady,U.S. House,Christina Owen,DEM,260035,2,2,19,23,04
Grady,State Senate,Lonnie Paxton,REP,260035,5,10,112,127,23
Grady,State Senate,Larry Wasson,DEM,260035,1,3,27,31,23
Grady,State House,Chris Verser,REP,260035,3,4,68,75,56
Grady,State House,David Perryman,DEM,260035,3,9,71,83,56
Grady,President,Donald Trump,REP,260036,43,55,954,1052,
Grady,President,Gary Johnson,LIB,260036,2,0,39,41,
Grady,President,Hillary Clinton,DEM,260036,15,8,184,207,
Grady,U.S. Senate,James Lankford,REP,260036,39,51,925,1015,
Grady,U.S. Senate,Robert Murphy,LIB,260036,1,4,18,23,
Grady,U.S. Senate,Mike Workman,DEM,260036,15,7,165,187,
Grady,U.S. Senate,Mark Beard,IND,260036,2,0,42,44,
Grady,U.S. Senate,Sean Braddy,IND,260036,1,0,17,18,
Grady,U.S. House,Tom Cole,REP,260036,40,51,954,1045,04
Grady,U.S. House,Sevier White,LIB,260036,0,2,35,37,04
Grady,U.S. House,Christina Owen,DEM,260036,19,9,179,207,04
Grady,State Senate,Paul Scott,REP,260036,42,51,895,988,43
Grady,State Senate,Leah Pollan,DEM,260036,18,10,259,287,43
Grady,State House,Scooter Park,REP,260036,31,50,598,679,65
Grady,State House,Rick Gilleland,DEM,260036,28,11,564,603,65
Grady,President,Donald Trump,REP,260037,207,172,1413,1792,
Grady,President,Gary Johnson,LIB,260037,17,6,81,104,
Grady,President,Hillary Clinton,DEM,260037,50,26,241,317,
Grady,U.S. Senate,James Lankford,REP,260037,223,181,1445,1849,
Grady,U.S. Senate,Robert Murphy,LIB,260037,6,4,37,47,
Grady,U.S. Senate,Mike Workman,DEM,260037,38,19,187,244,
Grady,U.S. Senate,Mark Beard,IND,260037,2,1,27,30,
Grady,U.S. Senate,Sean Braddy,IND,260037,6,2,38,46,
Grady,U.S. House,Tom Cole,REP,260037,216,172,1417,1805,04
Grady,U.S. House,Sevier White,LIB,260037,14,11,79,104,04
Grady,U.S. House,Christina Owen,DEM,260037,44,24,232,300,04
Grady,State Senate,Lonnie Paxton,REP,260037,221,174,1427,1822,23
Grady,State Senate,Larry Wasson,DEM,260037,49,30,288,367,23
Grady,State House,Scott Biggs,REP,260037,225,168,1402,1795,51
Grady,State House,Charles Murdock,DEM,260037,48,32,300,380,51
Grady,President,Donald Trump,REP,260038,100,122,1198,1420,
Grady,President,Gary Johnson,LIB,260038,2,1,71,74,
Grady,President,Hillary Clinton,DEM,260038,29,10,218,257,
Grady,U.S. Senate,James Lankford,REP,260038,100,127,1188,1415,
Grady,U.S. Senate,Robert Murphy,LIB,260038,3,1,37,41,
Grady,U.S. Senate,Mike Workman,DEM,260038,26,8,185,219,
Grady,U.S. Senate,Mark Beard,IND,260038,1,0,33,34,
Grady,U.S. Senate,Sean Braddy,IND,260038,3,0,36,39,
Grady,U.S. House,Tom Cole,REP,260038,103,124,1178,1405,04
Grady,U.S. House,Sevier White,LIB,260038,6,2,74,82,04
Grady,U.S. House,Christina Owen,DEM,260038,24,9,225,258,04
Grady,State Senate,Lonnie Paxton,REP,260038,98,117,1190,1405,23
Grady,State Senate,Larry Wasson,DEM,260038,35,18,279,332,23
Grady,State House,Scott Biggs,REP,260038,101,122,1182,1405,51
Grady,State House,Charles Murdock,DEM,260038,31,11,281,323,51
Grady,President,Donald Trump,REP,260039,42,71,907,1020,
Grady,President,Gary Johnson,LIB,260039,2,4,60,66,
Grady,President,Hillary Clinton,DEM,260039,6,13,133,152,
Grady,U.S. Senate,James Lankford,REP,260039,42,70,925,1037,
Grady,U.S. Senate,Robert Murphy,LIB,260039,1,5,25,31,
Grady,U.S. Senate,Mike Workman,DEM,260039,8,11,122,141,
Grady,U.S. Senate,Mark Beard,IND,260039,1,2,14,17,
Grady,U.S. Senate,Sean Braddy,IND,260039,0,1,19,20,
Grady,U.S. House,Tom Cole,REP,260039,42,67,918,1027,04
Grady,U.S. House,Sevier White,LIB,260039,2,7,41,50,04
Grady,U.S. House,Christina Owen,DEM,260039,8,14,139,161,04
Grady,State Senate,Lonnie Paxton,REP,260039,40,75,892,1007,23
Grady,State Senate,Larry Wasson,DEM,260039,11,14,186,211,23
Grady,State House,Scott Biggs,REP,260039,43,71,878,992,51
Grady,State House,Charles Murdock,DEM,260039,8,17,200,225,51
Grady,President,Donald Trump,REP,260040,178,110,1265,1553,
Grady,President,Gary Johnson,LIB,260040,13,7,70,90,
Grady,President,Hillary Clinton,DEM,260040,35,13,180,228,
Grady,U.S. Senate,James Lankford,REP,260040,191,111,1263,1565,
Grady,U.S. Senate,Robert Murphy,LIB,260040,4,5,43,52,
Grady,U.S. Senate,Mike Workman,DEM,260040,24,9,155,188,
Grady,U.S. Senate,Mark Beard,IND,260040,2,1,25,28,
Grady,U.S. Senate,Sean Braddy,IND,260040,5,2,27,34,
Grady,U.S. House,Tom Cole,REP,260040,192,111,1269,1572,04
Grady,U.S. House,Sevier White,LIB,260040,7,5,60,72,04
Grady,U.S. House,Christina Owen,DEM,260040,28,13,187,228,04
Grady,State Senate,Lonnie Paxton,REP,260040,195,111,1298,1604,23
Grady,State Senate,Larry Wasson,DEM,260040,30,18,205,253,23
Grady,State House,Leslie Kathryn Osborn,REP,260040,187,110,1213,1510,47
Grady,State House,O.A. Cargill,DEM,260040,37,18,281,336,47
Grady,President,Donald Trump,REP,260041,164,109,1238,1511,
Grady,President,Gary Johnson,LIB,260041,10,6,73,89,
Grady,President,Hillary Clinton,DEM,260041,41,18,200,259,
Grady,U.S. Senate,James Lankford,REP,260041,179,112,1273,1564,
Grady,U.S. Senate,Robert Murphy,LIB,260041,3,2,36,41,
Grady,U.S. Senate,Mike Workman,DEM,260041,28,13,164,205,
Grady,U.S. Senate,Mark Beard,IND,260041,5,2,17,24,
Grady,U.S. Senate,Sean Braddy,IND,260041,1,3,20,24,
Grady,U.S. House,Tom Cole,REP,260041,166,107,1240,1513,04
Grady,U.S. House,Sevier White,LIB,260041,10,5,63,78,04
Grady,U.S. House,Christina Owen,DEM,260041,36,20,201,257,04
Grady,State Senate,Lonnie Paxton,REP,260041,170,111,1295,1576,23
Grady,State Senate,Larry Wasson,DEM,260041,37,20,205,262,23
Grady,State House,Leslie Kathryn Osborn,REP,260041,178,106,1241,1525,47
Grady,State House,O.A. Cargill,DEM,260041,30,23,256,309,47
Grant,President,Donald Trump,REP,270011,2,0,105,107,
Grant,President,Gary Johnson,LIB,270011,0,0,3,3,
Grant,President,Hillary Clinton,DEM,270011,1,1,21,23,
Grant,U.S. Senate,James Lankford,REP,270011,2,1,96,99,
Grant,U.S. Senate,Robert Murphy,LIB,270011,0,0,7,7,
Grant,U.S. Senate,Mike Workman,DEM,270011,1,0,16,17,
Grant,U.S. Senate,Mark Beard,IND,270011,0,0,3,3,
Grant,U.S. Senate,Sean Braddy,IND,270011,0,0,5,5,
Grant,U.S. House,Frank Lucas,REP,270011,2,1,104,107,03
Grant,U.S. House,Frankie Robbins,DEM,270011,1,0,24,25,03
Grant,State Senate,Roland Pederson,REP,270011,2,1,94,97,19
Grant,State Senate,Rhonda Harlow,DEM,270011,1,0,20,21,19
Grant,State Senate,Whitney Hall,IND,270011,0,0,13,13,19
Grant,President,Donald Trump,REP,270017,18,10,230,258,
Grant,President,Gary Johnson,LIB,270017,1,0,7,8,
Grant,President,Hillary Clinton,DEM,270017,1,0,23,24,
Grant,U.S. Senate,James Lankford,REP,270017,20,10,231,261,
Grant,U.S. Senate,Robert Murphy,LIB,270017,0,0,4,4,
Grant,U.S. Senate,Mike Workman,DEM,270017,0,0,18,18,
Grant,U.S. Senate,Mark Beard,IND,270017,0,0,3,3,
Grant,U.S. Senate,Sean Braddy,IND,270017,1,0,2,3,
Grant,U.S. House,Frank Lucas,REP,270017,20,10,222,252,03
Grant,U.S. House,Frankie Robbins,DEM,270017,0,0,37,37,03
Grant,State Senate,Roland Pederson,REP,270017,19,10,228,257,19
Grant,State Senate,Rhonda Harlow,DEM,270017,2,0,21,23,19
Grant,State Senate,Whitney Hall,IND,270017,0,0,10,10,19
Grant,President,Donald Trump,REP,270023,26,21,421,468,
Grant,President,Gary Johnson,LIB,270023,1,0,25,26,
Grant,President,Hillary Clinton,DEM,270023,4,4,68,76,
Grant,U.S. Senate,James Lankford,REP,270023,25,25,432,482,
Grant,U.S. Senate,Robert Murphy,LIB,270023,1,0,10,11,
Grant,U.S. Senate,Mike Workman,DEM,270023,4,1,52,57,
Grant,U.S. Senate,Mark Beard,IND,270023,1,0,10,11,
Grant,U.S. Senate,Sean Braddy,IND,270023,0,0,8,8,
Grant,U.S. House,Frank Lucas,REP,270023,24,22,434,480,03
Grant,U.S. House,Frankie Robbins,DEM,270023,5,4,78,87,03
Grant,State Senate,Roland Pederson,REP,270023,26,22,405,453,19
Grant,State Senate,Rhonda Harlow,DEM,270023,2,3,64,69,19
Grant,State Senate,Whitney Hall,IND,270023,3,1,44,48,19
Grant,President,Donald Trump,REP,270025,20,7,210,237,
Grant,President,Gary Johnson,LIB,270025,2,0,13,15,
Grant,President,Hillary Clinton,DEM,270025,5,3,46,54,
Grant,U.S. Senate,James Lankford,REP,270025,17,7,218,242,
Grant,U.S. Senate,Robert Murphy,LIB,270025,1,1,7,9,
Grant,U.S. Senate,Mike Workman,DEM,270025,5,1,31,37,
Grant,U.S. Senate,Mark Beard,IND,270025,2,0,4,6,
Grant,U.S. Senate,Sean Braddy,IND,270025,3,1,3,7,
Grant,U.S. House,Frank Lucas,REP,270025,18,5,225,248,03
Grant,U.S. House,Frankie Robbins,DEM,270025,10,5,40,55,03
Grant,State Senate,Roland Pederson,REP,270025,19,7,212,238,19
Grant,State Senate,Rhonda Harlow,DEM,270025,5,0,32,37,19
Grant,State Senate,Whitney Hall,IND,270025,4,3,23,30,19
Grant,President,Donald Trump,REP,270026,4,4,218,226,
Grant,President,Gary Johnson,LIB,270026,0,0,10,10,
Grant,President,Hillary Clinton,DEM,270026,1,4,21,26,
Grant,U.S. Senate,James Lankford,REP,270026,4,4,223,231,
Grant,U.S. Senate,Robert Murphy,LIB,270026,0,1,5,6,
Grant,U.S. Senate,Mike Workman,DEM,270026,1,3,14,18,
Grant,U.S. Senate,Mark Beard,IND,270026,0,0,5,5,
Grant,U.S. Senate,Sean Braddy,IND,270026,0,0,2,2,
Grant,U.S. House,Frank Lucas,REP,270026,4,4,211,219,03
Grant,U.S. House,Frankie Robbins,DEM,270026,1,4,39,44,03
Grant,State Senate,Roland Pederson,REP,270026,4,3,207,214,19
Grant,State Senate,Rhonda Harlow,DEM,270026,1,5,28,34,19
Grant,State Senate,Whitney Hall,IND,270026,0,0,14,14,19
Grant,President,Donald Trump,REP,270029,4,28,152,184,
Grant,President,Gary Johnson,LIB,270029,1,2,5,8,
Grant,President,Hillary Clinton,DEM,270029,5,4,23,32,
Grant,U.S. Senate,James Lankford,REP,270029,4,32,159,195,
Grant,U.S. Senate,Robert Murphy,LIB,270029,0,0,1,1,
Grant,U.S. Senate,Mike Workman,DEM,270029,5,0,13,18,
Grant,U.S. Senate,Mark Beard,IND,270029,0,1,3,4,
Grant,U.S. Senate,Sean Braddy,IND,270029,0,0,2,2,
Grant,U.S. House,Frank Lucas,REP,270029,6,30,145,181,03
Grant,U.S. House,Frankie Robbins,DEM,270029,4,4,35,43,03
Grant,State Senate,Roland Pederson,REP,270029,6,25,146,177,19
Grant,State Senate,Rhonda Harlow,DEM,270029,3,5,15,23,19
Grant,State Senate,Whitney Hall,IND,270029,0,4,18,22,19
Grant,President,Donald Trump,REP,270030,28,45,274,347,
Grant,President,Gary Johnson,LIB,270030,1,3,12,16,
Grant,President,Hillary Clinton,DEM,270030,1,12,40,53,
Grant,U.S. Senate,James Lankford,REP,270030,28,45,280,353,
Grant,U.S. Senate,Robert Murphy,LIB,270030,0,1,8,9,
Grant,U.S. Senate,Mike Workman,DEM,270030,2,12,26,40,
Grant,U.S. Senate,Mark Beard,IND,270030,0,1,6,7,
Grant,U.S. Senate,Sean Braddy,IND,270030,0,0,6,6,
Grant,U.S. House,Frank Lucas,REP,270030,24,43,245,312,03
Grant,U.S. House,Frankie Robbins,DEM,270030,6,16,78,100,03
Grant,State Senate,Roland Pederson,REP,270030,27,42,253,322,19
Grant,State Senate,Rhonda Harlow,DEM,270030,2,8,41,51,19
Grant,State Senate,Whitney Hall,IND,270030,1,8,32,41,19
Greer,President,Donald Trump,REP,280101,18,73,251,342,
Greer,President,Gary Johnson,LIB,280101,0,0,19,19,
Greer,President,Hillary Clinton,DEM,280101,3,15,63,81,
Greer,U.S. Senate,James Lankford,REP,280101,19,66,241,326,
Greer,U.S. Senate,Robert Murphy,LIB,280101,0,2,12,14,
Greer,U.S. Senate,Mike Workman,DEM,280101,2,11,67,80,
Greer,U.S. Senate,Mark Beard,IND,280101,0,5,3,8,
Greer,U.S. Senate,Sean Braddy,IND,280101,0,4,6,10,
Greer,U.S. House,Frank Lucas,REP,280101,20,71,246,337,03
Greer,U.S. House,Frankie Robbins,DEM,280101,1,16,76,93,03
Greer,President,Donald Trump,REP,280102,23,76,306,405,
Greer,President,Gary Johnson,LIB,280102,1,7,17,25,
Greer,President,Hillary Clinton,DEM,280102,2,15,90,107,
Greer,U.S. Senate,James Lankford,REP,280102,22,79,308,409,
Greer,U.S. Senate,Robert Murphy,LIB,280102,0,2,8,10,
Greer,U.S. Senate,Mike Workman,DEM,280102,3,12,85,100,
Greer,U.S. Senate,Mark Beard,IND,280102,0,3,6,9,
Greer,U.S. Senate,Sean Braddy,IND,280102,1,0,0,1,
Greer,U.S. House,Frank Lucas,REP,280102,22,82,314,418,03
Greer,U.S. House,Frankie Robbins,DEM,280102,4,14,86,104,03
Greer,President,Donald Trump,REP,280103,0,8,19,27,
Greer,President,Gary Johnson,LIB,280103,0,0,2,2,
Greer,President,Hillary Clinton,DEM,280103,1,0,1,2,
Greer,U.S. Senate,James Lankford,REP,280103,0,6,18,24,
Greer,U.S. Senate,Robert Murphy,LIB,280103,0,0,0,0,
Greer,U.S. Senate,Mike Workman,DEM,280103,1,1,4,6,
Greer,U.S. Senate,Mark Beard,IND,280103,0,0,0,0,
Greer,U.S. Senate,Sean Braddy,IND,280103,0,0,0,0,
Greer,U.S. House,Frank Lucas,REP,280103,0,7,18,25,03
Greer,U.S. House,Frankie Robbins,DEM,280103,1,0,4,5,03
Greer,President,Donald Trump,REP,280105,2,10,72,84,
Greer,President,Gary Johnson,LIB,280105,1,0,3,4,
Greer,President,Hillary Clinton,DEM,280105,2,0,15,17,
Greer,U.S. Senate,James Lankford,REP,280105,2,8,76,86,
Greer,U.S. Senate,Robert Murphy,LIB,280105,0,0,2,2,
Greer,U.S. Senate,Mike Workman,DEM,280105,3,1,8,12,
Greer,U.S. Senate,Mark Beard,IND,280105,0,1,2,3,
Greer,U.S. Senate,Sean Braddy,IND,280105,0,0,2,2,
Greer,U.S. House,Frank Lucas,REP,280105,3,9,80,92,03
Greer,U.S. House,Frankie Robbins,DEM,280105,2,1,10,13,03
Greer,State House,Todd Russ,REP,280105,3,6,72,81,55
Greer,State House,Wayne Walters,DEM,280105,2,4,19,25,55
Greer,President,Donald Trump,REP,280106,5,8,67,80,
Greer,President,Gary Johnson,LIB,280106,0,0,2,2,
Greer,President,Hillary Clinton,DEM,280106,0,3,5,8,
Greer,U.S. Senate,James Lankford,REP,280106,5,8,67,80,
Greer,U.S. Senate,Robert Murphy,LIB,280106,0,0,0,0,
Greer,U.S. Senate,Mike Workman,DEM,280106,0,2,4,6,
Greer,U.S. Senate,Mark Beard,IND,280106,0,0,2,2,
Greer,U.S. Senate,Sean Braddy,IND,280106,0,0,1,1,
Greer,U.S. House,Frank Lucas,REP,280106,5,8,67,80,03
Greer,U.S. House,Frankie Robbins,DEM,280106,0,2,7,9,03
Greer,President,Donald Trump,REP,280202,11,20,321,352,
Greer,President,Gary Johnson,LIB,280202,1,1,21,23,
Greer,President,Hillary Clinton,DEM,280202,1,6,54,61,
Greer,U.S. Senate,James Lankford,REP,280202,11,23,311,345,
Greer,U.S. Senate,Robert Murphy,LIB,280202,1,0,13,14,
Greer,U.S. Senate,Mike Workman,DEM,280202,2,4,55,61,
Greer,U.S. Senate,Mark Beard,IND,280202,0,0,6,6,
Greer,U.S. Senate,Sean Braddy,IND,280202,0,0,6,6,
Greer,U.S. House,Frank Lucas,REP,280202,11,19,327,357,03
Greer,U.S. House,Frankie Robbins,DEM,280202,2,8,67,77,03
Greer,President,Donald Trump,REP,280203,8,14,127,149,
Greer,President,Gary Johnson,LIB,280203,0,1,10,11,
Greer,President,Hillary Clinton,DEM,280203,2,1,33,36,
Greer,U.S. Senate,James Lankford,REP,280203,9,14,129,152,
Greer,U.S. Senate,Robert Murphy,LIB,280203,0,0,4,4,
Greer,U.S. Senate,Mike Workman,DEM,280203,1,1,32,34,
Greer,U.S. Senate,Mark Beard,IND,280203,0,1,0,1,
Greer,U.S. Senate,Sean Braddy,IND,280203,0,0,3,3,
Greer,U.S. House,Frank Lucas,REP,280203,9,14,130,153,03
Greer,U.S. House,Frankie Robbins,DEM,280203,1,2,37,40,03
Greer,State House,Todd Russ,REP,280203,8,7,89,104,55
Greer,State House,Wayne Walters,DEM,280203,2,9,77,88,55
Greer,President,Donald Trump,REP,280302,1,4,38,43,
Greer,President,Gary Johnson,LIB,280302,0,2,3,5,
Greer,President,Hillary Clinton,DEM,280302,0,1,10,11,
Greer,U.S. Senate,James Lankford,REP,280302,2,5,37,44,
Greer,U.S. Senate,Robert Murphy,LIB,280302,0,0,0,0,
Greer,U.S. Senate,Mike Workman,DEM,280302,3,2,13,18,
Greer,U.S. Senate,Mark Beard,IND,280302,0,0,1,1,
Greer,U.S. Senate,Sean Braddy,IND,280302,0,0,0,0,
Greer,U.S. House,Frank Lucas,REP,280302,5,5,39,49,03
Greer,U.S. House,Frankie Robbins,DEM,280302,0,2,12,14,03
Greer,State House,Todd Russ,REP,280302,1,3,21,25,55
Greer,State House,Wayne Walters,DEM,280302,3,4,31,38,55
Harmon,President,Donald Trump,REP,290101,3,4,27,34,
Harmon,President,Gary Johnson,LIB,290101,0,1,3,4,
Harmon,President,Hillary Clinton,DEM,290101,1,2,13,16,
Harmon,U.S. Senate,James Lankford,REP,290101,3,6,26,35,
Harmon,U.S. Senate,Robert Murphy,LIB,290101,1,0,1,2,
Harmon,U.S. Senate,Mike Workman,DEM,290101,0,1,11,12,
Harmon,U.S. Senate,Mark Beard,IND,290101,0,0,3,3,
Harmon,U.S. Senate,Sean Braddy,IND,290101,0,0,1,1,
Harmon,U.S. House,Frank Lucas,REP,290101,2,6,27,35,03
Harmon,U.S. House,Frankie Robbins,DEM,290101,1,1,13,15,03
Harmon,President,Donald Trump,REP,290102,3,40,216,259,
Harmon,President,Gary Johnson,LIB,290102,0,1,7,8,
Harmon,President,Hillary Clinton,DEM,290102,2,11,57,70,
Harmon,U.S. Senate,James Lankford,REP,290102,3,45,213,261,
Harmon,U.S. Senate,Robert Murphy,LIB,290102,1,0,5,6,
Harmon,U.S. Senate,Mike Workman,DEM,290102,1,6,50,57,
Harmon,U.S. Senate,Mark Beard,IND,290102,0,0,4,4,
Harmon,U.S. Senate,Sean Braddy,IND,290102,0,0,3,3,
Harmon,U.S. House,Frank Lucas,REP,290102,4,44,215,263,03
Harmon,U.S. House,Frankie Robbins,DEM,290102,1,4,57,62,03
Harmon,President,Donald Trump,REP,290201,3,21,132,156,
Harmon,President,Gary Johnson,LIB,290201,0,3,10,13,
Harmon,President,Hillary Clinton,DEM,290201,6,11,50,67,
Harmon,U.S. Senate,James Lankford,REP,290201,4,22,135,161,
Harmon,U.S. Senate,Robert Murphy,LIB,290201,0,1,4,5,
Harmon,U.S. Senate,Mike Workman,DEM,290201,5,11,41,57,
Harmon,U.S. Senate,Mark Beard,IND,290201,0,0,3,3,
Harmon,U.S. Senate,Sean Braddy,IND,290201,0,0,2,2,
Harmon,U.S. House,Frank Lucas,REP,290201,4,24,140,168,03
Harmon,U.S. House,Frankie Robbins,DEM,290201,5,11,45,61,03
Harmon,President,Donald Trump,REP,290203,2,11,7,20,
Harmon,President,Gary Johnson,LIB,290203,0,0,0,0,
Harmon,President,Hillary Clinton,DEM,290203,1,2,4,7,
Harmon,U.S. Senate,James Lankford,REP,290203,2,13,8,23,
Harmon,U.S. Senate,Robert Murphy,LIB,290203,0,0,0,0,
Harmon,U.S. Senate,Mike Workman,DEM,290203,1,0,2,3,
Harmon,U.S. Senate,Mark Beard,IND,290203,0,0,0,0,
Harmon,U.S. Senate,Sean Braddy,IND,290203,0,0,0,0,
Harmon,U.S. House,Frank Lucas,REP,290203,3,13,9,25,03
Harmon,U.S. House,Frankie Robbins,DEM,290203,0,0,1,1,03
Harmon,President,Donald Trump,REP,290204,0,3,18,21,
Harmon,President,Gary Johnson,LIB,290204,0,0,0,0,
Harmon,President,Hillary Clinton,DEM,290204,0,1,3,4,
Harmon,U.S. Senate,James Lankford,REP,290204,0,4,17,21,
Harmon,U.S. Senate,Robert Murphy,LIB,290204,0,0,0,0,
Harmon,U.S. Senate,Mike Workman,DEM,290204,0,0,4,4,
Harmon,U.S. Senate,Mark Beard,IND,290204,0,0,0,0,
Harmon,U.S. Senate,Sean Braddy,IND,290204,0,0,0,0,
Harmon,U.S. House,Frank Lucas,REP,290204,0,4,18,22,03
Harmon,U.S. House,Frankie Robbins,DEM,290204,0,0,3,3,03
Harmon,President,Donald Trump,REP,290301,7,20,88,115,
Harmon,President,Gary Johnson,LIB,290301,0,1,5,6,
Harmon,President,Hillary Clinton,DEM,290301,1,5,36,42,
Harmon,U.S. Senate,James Lankford,REP,290301,8,20,92,120,
Harmon,U.S. Senate,Robert Murphy,LIB,290301,0,1,2,3,
Harmon,U.S. Senate,Mike Workman,DEM,290301,1,4,33,38,
Harmon,U.S. Senate,Mark Beard,IND,290301,0,0,1,1,
Harmon,U.S. Senate,Sean Braddy,IND,290301,0,0,0,0,
Harmon,U.S. House,Frank Lucas,REP,290301,8,18,93,119,03
Harmon,U.S. House,Frankie Robbins,DEM,290301,1,7,35,43,03
Harmon,President,Donald Trump,REP,290302,2,10,98,110,
Harmon,President,Gary Johnson,LIB,290302,1,0,5,6,
Harmon,President,Hillary Clinton,DEM,290302,0,0,19,19,
Harmon,U.S. Senate,James Lankford,REP,290302,3,9,103,115,
Harmon,U.S. Senate,Robert Murphy,LIB,290302,0,0,1,1,
Harmon,U.S. Senate,Mike Workman,DEM,290302,0,0,15,15,
Harmon,U.S. Senate,Mark Beard,IND,290302,0,0,1,1,
Harmon,U.S. Senate,Sean Braddy,IND,290302,0,0,1,1,
Harmon,U.S. House,Frank Lucas,REP,290302,3,10,103,116,03
Harmon,U.S. House,Frankie Robbins,DEM,290302,0,0,18,18,03
Harper,President,Donald Trump,REP,300201,27,20,479,526,
Harper,President,Gary Johnson,LIB,300201,0,0,21,21,
Harper,President,Hillary Clinton,DEM,300201,3,2,35,40,
Harper,U.S. Senate,James Lankford,REP,300201,32,20,481,533,
Harper,U.S. Senate,Robert Murphy,LIB,300201,0,0,15,15,
Harper,U.S. Senate,Mike Workman,DEM,300201,2,1,29,32,
Harper,U.S. Senate,Mark Beard,IND,300201,0,1,5,6,
Harper,U.S. Senate,Sean Braddy,IND,300201,0,1,6,7,
Harper,U.S. House,Frank Lucas,REP,300201,31,20,488,539,03
Harper,U.S. House,Frankie Robbins,DEM,300201,2,3,43,48,03
Harper,State House,Casey Murdock,REP,300201,30,21,480,531,61
Harper,State House,Ashlee Renee Ortiz,DEM,300201,1,2,50,53,61
Harper,President,Donald Trump,REP,300203,5,9,99,113,
Harper,President,Gary Johnson,LIB,300203,1,0,4,5,
Harper,President,Hillary Clinton,DEM,300203,2,0,8,10,
Harper,U.S. Senate,James Lankford,REP,300203,7,9,102,118,
Harper,U.S. Senate,Robert Murphy,LIB,300203,0,0,1,1,
Harper,U.S. Senate,Mike Workman,DEM,300203,1,0,4,5,
Harper,U.S. Senate,Mark Beard,IND,300203,0,0,1,1,
Harper,U.S. Senate,Sean Braddy,IND,300203,0,0,4,4,
Harper,U.S. House,Frank Lucas,REP,300203,7,6,104,117,03
Harper,U.S. House,Frankie Robbins,DEM,300203,1,2,8,11,03
Harper,State House,Casey Murdock,REP,300203,6,6,103,115,61
Harper,State House,Ashlee Renee Ortiz,DEM,300203,2,2,9,13,61
Harper,President,Donald Trump,REP,300301,9,36,182,227,
Harper,President,Gary Johnson,LIB,300301,2,0,5,7,
Harper,President,Hillary Clinton,DEM,300301,1,2,33,36,
Harper,U.S. Senate,James Lankford,REP,300301,12,36,191,239,
Harper,U.S. Senate,Robert Murphy,LIB,300301,1,0,5,6,
Harper,U.S. Senate,Mike Workman,DEM,300301,1,2,23,26,
Harper,U.S. Senate,Mark Beard,IND,300301,0,0,3,3,
Harper,U.S. Senate,Sean Braddy,IND,300301,0,0,0,0,
Harper,U.S. House,Frank Lucas,REP,300301,12,36,190,238,03
Harper,U.S. House,Frankie Robbins,DEM,300301,2,2,28,32,03
Harper,State House,Casey Murdock,REP,300301,13,35,190,238,61
Harper,State House,Ashlee Renee Ortiz,DEM,300301,1,3,32,36,61
Harper,President,Donald Trump,REP,300302,2,2,50,54,
Harper,President,Gary Johnson,LIB,300302,0,0,1,1,
Harper,President,Hillary Clinton,DEM,300302,0,1,3,4,
Harper,U.S. Senate,James Lankford,REP,300302,2,2,49,53,
Harper,U.S. Senate,Robert Murphy,LIB,300302,0,0,1,1,
Harper,U.S. Senate,Mike Workman,DEM,300302,0,1,2,3,
Harper,U.S. Senate,Mark Beard,IND,300302,0,0,1,1,
Harper,U.S. Senate,Sean Braddy,IND,300302,0,0,1,1,
Harper,U.S. House,Frank Lucas,REP,300302,2,2,51,55,03
Harper,U.S. House,Frankie Robbins,DEM,300302,0,1,2,3,03
Harper,State House,Casey Murdock,REP,300302,2,2,50,54,61
Harper,State House,Ashlee Renee Ortiz,DEM,300302,0,1,3,4,61
Harper,President,Donald Trump,REP,300303,6,12,88,106,
Harper,President,Gary Johnson,LIB,300303,0,0,0,0,
Harper,President,Hillary Clinton,DEM,300303,0,2,8,10,
Harper,U.S. Senate,James Lankford,REP,300303,6,11,95,112,
Harper,U.S. Senate,Robert Murphy,LIB,300303,0,1,0,1,
Harper,U.S. Senate,Mike Workman,DEM,300303,0,1,2,3,
Harper,U.S. Senate,Mark Beard,IND,300303,0,1,0,1,
Harper,U.S. Senate,Sean Braddy,IND,300303,0,0,0,0,
Harper,U.S. House,Frank Lucas,REP,300303,6,13,92,111,03
Harper,U.S. House,Frankie Robbins,DEM,300303,0,1,5,6,03
Harper,State House,Casey Murdock,REP,300303,6,12,89,107,61
Harper,State House,Ashlee Renee Ortiz,DEM,300303,0,2,8,10,61
Harper,President,Donald Trump,REP,300402,8,48,236,292,
Harper,President,Gary Johnson,LIB,300402,1,2,10,13,
Harper,President,Hillary Clinton,DEM,300402,3,4,27,34,
Harper,U.S. Senate,James Lankford,REP,300402,10,44,245,299,
Harper,U.S. Senate,Robert Murphy,LIB,300402,1,4,1,6,
Harper,U.S. Senate,Mike Workman,DEM,300402,1,6,21,28,
Harper,U.S. Senate,Mark Beard,IND,300402,0,0,1,1,
Harper,U.S. Senate,Sean Braddy,IND,300402,0,0,3,3,
Harper,U.S. House,Frank Lucas,REP,300402,8,43,244,295,03
Harper,U.S. House,Frankie Robbins,DEM,300402,3,11,28,42,03
Harper,State House,Casey Murdock,REP,300402,11,48,243,302,61
Harper,State House,Ashlee Renee Ortiz,DEM,300402,0,5,29,34,61
Haskell,President,Donald Trump,REP,310007,5,10,210,225,
Haskell,President,Gary Johnson,LIB,310007,0,0,8,8,
Haskell,President,Hillary Clinton,DEM,310007,2,4,33,39,
Haskell,U.S. Senate,James Lankford,REP,310007,5,10,189,204,
Haskell,U.S. Senate,Robert Murphy,LIB,310007,0,0,2,2,
Haskell,U.S. Senate,Mike Workman,DEM,310007,2,4,50,56,
Haskell,U.S. Senate,Mark Beard,IND,310007,0,0,2,2,
Haskell,U.S. Senate,Sean Braddy,IND,310007,0,0,7,7,
Haskell,U.S. House,Markwayne Mullin,REP,310007,5,10,189,204,02
Haskell,U.S. House,Joshua Harris-Till,DEM,310007,2,4,44,50,02
Haskell,U.S. House,John Mccarthy,IND,310007,0,0,16,16,02
Haskell,State Senate,Larry Boggs,REP,310007,4,9,184,197,7
Haskell,State Senate,Joel Kerns,DEM,310007,3,5,67,75,7
Haskell,State House,Don Herrold,REP,310007,1,6,86,93,15
Haskell,State House,Ed Cannaday,DEM,310007,6,8,162,176,15
Haskell,President,Donald Trump,REP,310009,1,10,75,86,
Haskell,President,Gary Johnson,LIB,310009,0,1,3,4,
Haskell,President,Hillary Clinton,DEM,310009,1,0,22,23,
Haskell,U.S. Senate,James Lankford,REP,310009,1,7,69,77,
Haskell,U.S. Senate,Robert Murphy,LIB,310009,0,0,3,3,
Haskell,U.S. Senate,Mike Workman,DEM,310009,1,4,22,27,
Haskell,U.S. Senate,Mark Beard,IND,310009,0,0,1,1,
Haskell,U.S. Senate,Sean Braddy,IND,310009,0,0,1,1,
Haskell,U.S. House,Markwayne Mullin,REP,310009,1,9,71,81,02
Haskell,U.S. House,Joshua Harris-Till,DEM,310009,1,3,25,29,02
Haskell,U.S. House,John Mccarthy,IND,310009,0,0,1,1,02
Haskell,State Senate,Larry Boggs,REP,310009,1,8,69,78,7
Haskell,State Senate,Joel Kerns,DEM,310009,1,4,30,35,7
Haskell,State House,Don Herrold,REP,310009,1,4,29,34,15
Haskell,State House,Ed Cannaday,DEM,310009,1,8,69,78,15
Haskell,President,Donald Trump,REP,310011,7,24,107,138,
Haskell,President,Gary Johnson,LIB,310011,0,2,1,3,
Haskell,President,Hillary Clinton,DEM,310011,1,5,22,28,
Haskell,U.S. Senate,James Lankford,REP,310011,7,17,99,123,
Haskell,U.S. Senate,Robert Murphy,LIB,310011,0,1,1,2,
Haskell,U.S. Senate,Mike Workman,DEM,310011,1,8,29,38,
Haskell,U.S. Senate,Mark Beard,IND,310011,0,2,1,3,
Haskell,U.S. Senate,Sean Braddy,IND,310011,0,1,0,1,
Haskell,U.S. House,Markwayne Mullin,REP,310011,6,24,95,125,02
Haskell,U.S. House,Joshua Harris-Till,DEM,310011,1,5,33,39,02
Haskell,U.S. House,John Mccarthy,IND,310011,1,0,2,3,02
Haskell,State Senate,Larry Boggs,REP,310011,5,19,84,108,7
Haskell,State Senate,Joel Kerns,DEM,310011,3,10,45,58,7
Haskell,State House,Don Herrold,REP,310011,3,8,56,67,15
Haskell,State House,Ed Cannaday,DEM,310011,5,23,75,103,15
Haskell,President,Donald Trump,REP,310015,15,50,235,300,
Haskell,President,Gary Johnson,LIB,310015,2,3,12,17,
Haskell,President,Hillary Clinton,DEM,310015,8,9,46,63,
Haskell,U.S. Senate,James Lankford,REP,310015,11,44,210,265,
Haskell,U.S. Senate,Robert Murphy,LIB,310015,0,1,5,6,
Haskell,U.S. Senate,Mike Workman,DEM,310015,15,19,61,95,
Haskell,U.S. Senate,Mark Beard,IND,310015,0,0,7,7,
Haskell,U.S. Senate,Sean Braddy,IND,310015,0,0,6,6,
Haskell,U.S. House,Markwayne Mullin,REP,310015,15,42,210,267,02
Haskell,U.S. House,Joshua Harris-Till,DEM,310015,10,18,63,91,02
Haskell,U.S. House,John Mccarthy,IND,310015,1,2,14,17,02
Haskell,State Senate,Larry Boggs,REP,310015,10,33,173,216,7
Haskell,State Senate,Joel Kerns,DEM,310015,16,31,120,167,7
Haskell,State House,Don Herrold,REP,310015,5,12,64,81,15
Haskell,State House,Ed Cannaday,DEM,310015,21,52,229,302,15
Haskell,President,Donald Trump,REP,310016,9,83,207,299,
Haskell,President,Gary Johnson,LIB,310016,1,3,6,10,
Haskell,President,Hillary Clinton,DEM,310016,8,23,50,81,
Haskell,U.S. Senate,James Lankford,REP,310016,9,78,193,280,
Haskell,U.S. Senate,Robert Murphy,LIB,310016,0,0,5,5,
Haskell,U.S. Senate,Mike Workman,DEM,310016,8,27,51,86,
Haskell,U.S. Senate,Mark Beard,IND,310016,1,0,7,8,
Haskell,U.S. Senate,Sean Braddy,IND,310016,0,1,3,4,
Haskell,U.S. House,Markwayne Mullin,REP,310016,10,77,191,278,02
Haskell,U.S. House,Joshua Harris-Till,DEM,310016,6,25,52,83,02
Haskell,U.S. House,John Mccarthy,IND,310016,2,4,17,23,02
Haskell,State Senate,Larry Boggs,REP,310016,7,75,170,252,7
Haskell,State Senate,Joel Kerns,DEM,310016,11,31,94,136,7
Haskell,State House,Don Herrold,REP,310016,2,39,71,112,15
Haskell,State House,Ed Cannaday,DEM,310016,16,69,193,278,15
Haskell,President,Donald Trump,REP,310019,14,32,332,378,
Haskell,President,Gary Johnson,LIB,310019,0,0,16,16,
Haskell,President,Hillary Clinton,DEM,310019,4,16,78,98,
Haskell,U.S. Senate,James Lankford,REP,310019,12,28,311,351,
Haskell,U.S. Senate,Robert Murphy,LIB,310019,0,0,2,2,
Haskell,U.S. Senate,Mike Workman,DEM,310019,6,16,93,115,
Haskell,U.S. Senate,Mark Beard,IND,310019,0,2,3,5,
Haskell,U.S. Senate,Sean Braddy,IND,310019,0,1,9,10,
Haskell,U.S. House,Markwayne Mullin,REP,310019,12,27,324,363,02
Haskell,U.S. House,Joshua Harris-Till,DEM,310019,6,18,77,101,02
Haskell,U.S. House,John Mccarthy,IND,310019,0,2,17,19,02
Haskell,State Senate,Larry Boggs,REP,310019,10,29,251,290,7
Haskell,State Senate,Joel Kerns,DEM,310019,8,19,162,189,7
Haskell,State House,Don Herrold,REP,310019,5,11,117,133,15
Haskell,State House,Ed Cannaday,DEM,310019,13,37,297,347,15
Haskell,President,Donald Trump,REP,310023,11,41,358,410,
Haskell,President,Gary Johnson,LIB,310023,0,2,12,14,
Haskell,President,Hillary Clinton,DEM,310023,2,8,114,124,
Haskell,U.S. Senate,James Lankford,REP,310023,12,40,346,398,
Haskell,U.S. Senate,Robert Murphy,LIB,310023,0,0,8,8,
Haskell,U.S. Senate,Mike Workman,DEM,310023,2,9,118,129,
Haskell,U.S. Senate,Mark Beard,IND,310023,0,1,4,5,
Haskell,U.S. Senate,Sean Braddy,IND,310023,0,1,6,7,
Haskell,U.S. House,Markwayne Mullin,REP,310023,13,39,346,398,02
Haskell,U.S. House,Joshua Harris-Till,DEM,310023,1,9,113,123,02
Haskell,U.S. House,John Mccarthy,IND,310023,0,3,22,25,02
Haskell,State Senate,Larry Boggs,REP,310023,7,37,300,344,7
Haskell,State Senate,Joel Kerns,DEM,310023,4,14,180,198,7
Haskell,State House,Don Herrold,REP,310023,4,29,188,221,15
Haskell,State House,Ed Cannaday,DEM,310023,8,22,292,322,15
Haskell,President,Donald Trump,REP,310027,25,129,401,555,
Haskell,President,Gary Johnson,LIB,310027,5,0,10,15,
Haskell,President,Hillary Clinton,DEM,310027,9,35,62,106,
Haskell,U.S. Senate,James Lankford,REP,310027,20,125,354,499,
Haskell,U.S. Senate,Robert Murphy,LIB,310027,3,1,10,14,
Haskell,U.S. Senate,Mike Workman,DEM,310027,13,35,82,130,
Haskell,U.S. Senate,Mark Beard,IND,310027,0,0,5,5,
Haskell,U.S. Senate,Sean Braddy,IND,310027,3,1,6,10,
Haskell,U.S. House,Markwayne Mullin,REP,310027,21,125,366,512,02
Haskell,U.S. House,Joshua Harris-Till,DEM,310027,11,35,83,129,02
Haskell,U.S. House,John Mccarthy,IND,310027,8,3,15,26,02
Haskell,State Senate,Larry Boggs,REP,310027,22,101,296,419,7
Haskell,State Senate,Joel Kerns,DEM,310027,16,62,170,248,7
Haskell,State House,Don Herrold,REP,310027,10,36,120,166,15
Haskell,State House,Ed Cannaday,DEM,310027,29,130,348,507,15
Haskell,President,Donald Trump,REP,310030,14,57,260,331,
Haskell,President,Gary Johnson,LIB,310030,3,2,12,17,
Haskell,President,Hillary Clinton,DEM,310030,11,15,55,81,
Haskell,U.S. Senate,James Lankford,REP,310030,15,50,249,314,
Haskell,U.S. Senate,Robert Murphy,LIB,310030,0,1,2,3,
Haskell,U.S. Senate,Mike Workman,DEM,310030,10,18,66,94,
Haskell,U.S. Senate,Mark Beard,IND,310030,2,2,1,5,
Haskell,U.S. Senate,Sean Braddy,IND,310030,1,1,5,7,
Haskell,U.S. House,Markwayne Mullin,REP,310030,18,55,253,326,02
Haskell,U.S. House,Joshua Harris-Till,DEM,310030,8,15,62,85,02
Haskell,U.S. House,John Mccarthy,IND,310030,2,3,8,13,02
Haskell,State Senate,Larry Boggs,REP,310030,15,45,206,266,7
Haskell,State Senate,Joel Kerns,DEM,310030,13,28,121,162,7
Haskell,State House,Don Herrold,REP,310030,7,23,85,115,15
Haskell,State House,Ed Cannaday,DEM,310030,21,52,242,315,15
Haskell,President,Donald Trump,REP,310031,19,57,541,617,
Haskell,President,Gary Johnson,LIB,310031,2,3,30,35,
Haskell,President,Hillary Clinton,DEM,310031,16,14,123,153,
Haskell,U.S. Senate,James Lankford,REP,310031,14,52,456,522,
Haskell,U.S. Senate,Robert Murphy,LIB,310031,1,0,19,20,
Haskell,U.S. Senate,Mike Workman,DEM,310031,19,19,169,207,
Haskell,U.S. Senate,Mark Beard,IND,310031,0,2,10,12,
Haskell,U.S. Senate,Sean Braddy,IND,310031,0,1,22,23,
Haskell,U.S. House,Markwayne Mullin,REP,310031,15,53,466,534,02
Haskell,U.S. House,Joshua Harris-Till,DEM,310031,19,18,169,206,02
Haskell,U.S. House,John Mccarthy,IND,310031,1,3,42,46,02
Haskell,State Senate,Larry Boggs,REP,310031,11,48,408,467,7
Haskell,State Senate,Joel Kerns,DEM,310031,24,26,276,326,7
Haskell,State House,Don Herrold,REP,310031,7,29,218,254,15
Haskell,State House,Ed Cannaday,DEM,310031,27,45,466,538,15
Haskell,President,Donald Trump,REP,310032,3,34,325,362,
Haskell,President,Gary Johnson,LIB,310032,1,1,14,16,
Haskell,President,Hillary Clinton,DEM,310032,3,8,75,86,
Haskell,U.S. Senate,James Lankford,REP,310032,3,31,301,335,
Haskell,U.S. Senate,Robert Murphy,LIB,310032,0,0,5,5,
Haskell,U.S. Senate,Mike Workman,DEM,310032,4,10,103,117,
Haskell,U.S. Senate,Mark Beard,IND,310032,0,1,3,4,
Haskell,U.S. Senate,Sean Braddy,IND,310032,0,0,4,4,
Haskell,U.S. House,Markwayne Mullin,REP,310032,3,28,309,340,02
Haskell,U.S. House,Joshua Harris-Till,DEM,310032,3,14,91,108,02
Haskell,U.S. House,John Mccarthy,IND,310032,0,0,13,13,02
Haskell,State Senate,Larry Boggs,REP,310032,4,22,263,289,7
Haskell,State Senate,Joel Kerns,DEM,310032,2,21,154,177,7
Haskell,State House,Don Herrold,REP,310032,3,14,159,176,15
Haskell,State House,Ed Cannaday,DEM,310032,3,28,252,283,15
Hughes,President,Donald Trump,REP,320010,0,0,0,0,
Hughes,President,Gary Johnson,LIB,320010,0,0,0,0,
Hughes,President,Hillary Clinton,DEM,320010,0,0,0,0,
Hughes,U.S. Senate,James Lankford,REP,320010,0,0,0,0,
Hughes,U.S. Senate,Robert Murphy,LIB,320010,0,0,0,0,
Hughes,U.S. Senate,Mike Workman,DEM,320010,0,0,0,0,
Hughes,U.S. Senate,Mark Beard,IND,320010,0,0,0,0,
Hughes,U.S. Senate,Sean Braddy,IND,320010,0,0,0,0,
Hughes,U.S. House,Markwayne Mullin,REP,320010,0,0,0,0,02
Hughes,U.S. House,Joshua Harris-Till,DEM,320010,0,0,0,0,02
Hughes,U.S. House,John Mccarthy,IND,320010,0,0,0,0,02
Hughes,State Senate,Larry Boggs,REP,320010,0,0,0,0,7
Hughes,State Senate,Joel Kerns,DEM,320010,0,0,0,0,7
Hughes,President,Donald Trump,REP,320011,23,79,292,394,
Hughes,President,Gary Johnson,LIB,320011,0,2,19,21,
Hughes,President,Hillary Clinton,DEM,320011,8,17,84,109,
Hughes,U.S. Senate,James Lankford,REP,320011,24,75,307,406,
Hughes,U.S. Senate,Robert Murphy,LIB,320011,0,1,6,7,
Hughes,U.S. Senate,Mike Workman,DEM,320011,6,20,72,98,
Hughes,U.S. Senate,Mark Beard,IND,320011,1,1,3,5,
Hughes,U.S. Senate,Sean Braddy,IND,320011,1,1,6,8,
Hughes,U.S. House,Markwayne Mullin,REP,320011,20,66,255,341,02
Hughes,U.S. House,Joshua Harris-Till,DEM,320011,7,25,88,120,02
Hughes,U.S. House,John Mccarthy,IND,320011,5,5,41,51,02
Hughes,State Senate,Greg Mccortney,REP,320011,23,61,245,329,13
Hughes,State Senate,Eric Hall,DEM,320011,8,35,138,181,13
Hughes,President,Donald Trump,REP,320012,15,43,201,259,
Hughes,President,Gary Johnson,LIB,320012,0,1,10,11,
Hughes,President,Hillary Clinton,DEM,320012,9,11,63,83,
Hughes,U.S. Senate,James Lankford,REP,320012,12,43,208,263,
Hughes,U.S. Senate,Robert Murphy,LIB,320012,1,0,5,6,
Hughes,U.S. Senate,Mike Workman,DEM,320012,11,8,57,76,
Hughes,U.S. Senate,Mark Beard,IND,320012,1,2,2,5,
Hughes,U.S. Senate,Sean Braddy,IND,320012,0,1,2,3,
Hughes,U.S. House,Markwayne Mullin,REP,320012,10,36,159,205,02
Hughes,U.S. House,Joshua Harris-Till,DEM,320012,10,10,77,97,02
Hughes,U.S. House,John Mccarthy,IND,320012,3,7,33,43,02
Hughes,State Senate,Greg Mccortney,REP,320012,11,34,160,205,13
Hughes,State Senate,Eric Hall,DEM,320012,11,19,107,137,13
Hughes,President,Donald Trump,REP,320016,4,13,92,109,
Hughes,President,Gary Johnson,LIB,320016,1,0,13,14,
Hughes,President,Hillary Clinton,DEM,320016,2,4,24,30,
Hughes,U.S. Senate,James Lankford,REP,320016,4,15,102,121,
Hughes,U.S. Senate,Robert Murphy,LIB,320016,1,0,4,5,
Hughes,U.S. Senate,Mike Workman,DEM,320016,1,2,21,24,
Hughes,U.S. Senate,Mark Beard,IND,320016,0,0,0,0,
Hughes,U.S. Senate,Sean Braddy,IND,320016,0,0,2,2,
Hughes,U.S. House,Markwayne Mullin,REP,320016,5,11,84,100,02
Hughes,U.S. House,Joshua Harris-Till,DEM,320016,1,3,26,30,02
Hughes,U.S. House,John Mccarthy,IND,320016,0,1,14,15,02
Hughes,State Senate,Larry Boggs,REP,320016,4,11,84,99,7
Hughes,State Senate,Joel Kerns,DEM,320016,2,4,43,49,7
Hughes,President,Donald Trump,REP,320018,11,21,169,201,
Hughes,President,Gary Johnson,LIB,320018,0,1,5,6,
Hughes,President,Hillary Clinton,DEM,320018,0,4,34,38,
Hughes,U.S. Senate,James Lankford,REP,320018,11,17,172,200,
Hughes,U.S. Senate,Robert Murphy,LIB,320018,0,1,2,3,
Hughes,U.S. Senate,Mike Workman,DEM,320018,0,7,32,39,
Hughes,U.S. Senate,Mark Beard,IND,320018,0,0,1,1,
Hughes,U.S. Senate,Sean Braddy,IND,320018,0,0,4,4,
Hughes,U.S. House,Markwayne Mullin,REP,320018,9,19,147,175,02
Hughes,U.S. House,Joshua Harris-Till,DEM,320018,2,6,43,51,02
Hughes,U.S. House,John Mccarthy,IND,320018,0,0,12,12,02
Hughes,State Senate,Larry Boggs,REP,320018,9,16,135,160,7
Hughes,State Senate,Joel Kerns,DEM,320018,2,9,70,81,7
Hughes,President,Donald Trump,REP,320019,5,9,66,80,
Hughes,President,Gary Johnson,LIB,320019,0,0,2,2,
Hughes,President,Hillary Clinton,DEM,320019,1,6,9,16,
Hughes,U.S. Senate,James Lankford,REP,320019,5,11,67,83,
Hughes,U.S. Senate,Robert Murphy,LIB,320019,0,0,0,0,
Hughes,U.S. Senate,Mike Workman,DEM,320019,1,3,9,13,
Hughes,U.S. Senate,Mark Beard,IND,320019,0,1,1,2,
Hughes,U.S. Senate,Sean Braddy,IND,320019,0,0,0,0,
Hughes,U.S. House,Markwayne Mullin,REP,320019,5,11,56,72,02
Hughes,U.S. House,Joshua Harris-Till,DEM,320019,1,3,10,14,02
Hughes,U.S. House,John Mccarthy,IND,320019,0,1,8,9,02
Hughes,State Senate,Greg Mccortney,REP,320019,5,9,53,67,13
Hughes,State Senate,Eric Hall,DEM,320019,1,6,19,26,13
Hughes,President,Donald Trump,REP,320020,26,30,450,506,
Hughes,President,Gary Johnson,LIB,320020,0,2,29,31,
Hughes,President,Hillary Clinton,DEM,320020,13,8,154,175,
Hughes,U.S. Senate,James Lankford,REP,320020,29,26,453,508,
Hughes,U.S. Senate,Robert Murphy,LIB,320020,0,0,11,11,
Hughes,U.S. Senate,Mike Workman,DEM,320020,6,10,149,165,
Hughes,U.S. Senate,Mark Beard,IND,320020,2,0,9,11,
Hughes,U.S. Senate,Sean Braddy,IND,320020,3,4,8,15,
Hughes,U.S. House,Markwayne Mullin,REP,320020,24,24,390,438,02
Hughes,U.S. House,Joshua Harris-Till,DEM,320020,12,11,177,200,02
Hughes,U.S. House,John Mccarthy,IND,320020,4,5,54,63,02
Hughes,State Senate,Larry Boggs,REP,320020,28,21,384,433,7
Hughes,State Senate,Joel Kerns,DEM,320020,11,19,237,267,7
Hughes,President,Donald Trump,REP,320021,3,15,165,183,
Hughes,President,Gary Johnson,LIB,320021,0,0,14,14,
Hughes,President,Hillary Clinton,DEM,320021,8,11,45,64,
Hughes,U.S. Senate,James Lankford,REP,320021,4,15,162,181,
Hughes,U.S. Senate,Robert Murphy,LIB,320021,0,0,6,6,
Hughes,U.S. Senate,Mike Workman,DEM,320021,5,9,41,55,
Hughes,U.S. Senate,Mark Beard,IND,320021,0,0,4,4,
Hughes,U.S. Senate,Sean Braddy,IND,320021,2,1,9,12,
Hughes,U.S. House,Markwayne Mullin,REP,320021,4,14,138,156,02
Hughes,U.S. House,Joshua Harris-Till,DEM,320021,7,10,56,73,02
Hughes,U.S. House,John Mccarthy,IND,320021,0,1,24,25,02
Hughes,State Senate,Greg Mccortney,REP,320021,4,12,131,147,13
Hughes,State Senate,Eric Hall,DEM,320021,7,13,84,104,13
Hughes,President,Donald Trump,REP,320022,6,13,177,196,
Hughes,President,Gary Johnson,LIB,320022,0,0,13,13,
Hughes,President,Hillary Clinton,DEM,320022,2,2,69,73,
Hughes,U.S. Senate,James Lankford,REP,320022,6,11,167,184,
Hughes,U.S. Senate,Robert Murphy,LIB,320022,0,0,9,9,
Hughes,U.S. Senate,Mike Workman,DEM,320022,2,1,71,74,
Hughes,U.S. Senate,Mark Beard,IND,320022,0,0,4,4,
Hughes,U.S. Senate,Sean Braddy,IND,320022,0,1,2,3,
Hughes,U.S. House,Markwayne Mullin,REP,320022,6,10,164,180,02
Hughes,U.S. House,Joshua Harris-Till,DEM,320022,2,3,67,72,02
Hughes,U.S. House,John Mccarthy,IND,320022,0,1,20,21,02
Hughes,State Senate,Larry Boggs,REP,320022,6,6,147,159,7
Hughes,State Senate,Joel Kerns,DEM,320022,2,8,105,115,7
Hughes,President,Donald Trump,REP,320023,6,9,98,113,
Hughes,President,Gary Johnson,LIB,320023,0,0,3,3,
Hughes,President,Hillary Clinton,DEM,320023,2,2,27,31,
Hughes,U.S. Senate,James Lankford,REP,320023,8,8,103,119,
Hughes,U.S. Senate,Robert Murphy,LIB,320023,0,1,0,1,
Hughes,U.S. Senate,Mike Workman,DEM,320023,0,2,19,21,
Hughes,U.S. Senate,Mark Beard,IND,320023,0,0,0,0,
Hughes,U.S. Senate,Sean Braddy,IND,320023,0,0,6,6,
Hughes,U.S. House,Markwayne Mullin,REP,320023,6,8,79,93,02
Hughes,U.S. House,Joshua Harris-Till,DEM,320023,2,2,28,32,02
Hughes,U.S. House,John Mccarthy,IND,320023,0,1,18,19,02
Hughes,State Senate,Larry Boggs,REP,320023,5,8,81,94,7
Hughes,State Senate,Joel Kerns,DEM,320023,3,3,46,52,7
Hughes,President,Donald Trump,REP,320030,6,5,136,147,
Hughes,President,Gary Johnson,LIB,320030,0,1,1,2,
Hughes,President,Hillary Clinton,DEM,320030,1,0,31,32,
Hughes,U.S. Senate,James Lankford,REP,320030,6,4,130,140,
Hughes,U.S. Senate,Robert Murphy,LIB,320030,0,1,2,3,
Hughes,U.S. Senate,Mike Workman,DEM,320030,1,1,30,32,
Hughes,U.S. Senate,Mark Beard,IND,320030,0,0,4,4,
Hughes,U.S. Senate,Sean Braddy,IND,320030,0,0,4,4,
Hughes,U.S. House,Markwayne Mullin,REP,320030,6,2,104,112,02
Hughes,U.S. House,Joshua Harris-Till,DEM,320030,1,1,48,50,02
Hughes,U.S. House,John Mccarthy,IND,320030,0,3,18,21,02
Hughes,State Senate,Greg Mccortney,REP,320030,6,5,103,114,13
Hughes,State Senate,Eric Hall,DEM,320030,1,1,67,69,13
Hughes,President,Donald Trump,REP,320031,9,10,185,204,
Hughes,President,Gary Johnson,LIB,320031,0,0,9,9,
Hughes,President,Hillary Clinton,DEM,320031,7,0,30,37,
Hughes,U.S. Senate,James Lankford,REP,320031,8,10,189,207,
Hughes,U.S. Senate,Robert Murphy,LIB,320031,0,0,3,3,
Hughes,U.S. Senate,Mike Workman,DEM,320031,5,0,30,35,
Hughes,U.S. Senate,Mark Beard,IND,320031,0,0,2,2,
Hughes,U.S. Senate,Sean Braddy,IND,320031,2,0,3,5,
Hughes,U.S. House,Markwayne Mullin,REP,320031,8,8,165,181,02
Hughes,U.S. House,Joshua Harris-Till,DEM,320031,7,2,33,42,02
Hughes,U.S. House,John Mccarthy,IND,320031,0,0,26,26,02
Hughes,State Senate,Larry Boggs,REP,320031,8,7,145,160,7
Hughes,State Senate,Joel Kerns,DEM,320031,7,3,81,91,7
Hughes,President,Donald Trump,REP,320032,9,1,145,155,
Hughes,President,Gary Johnson,LIB,320032,0,0,11,11,
Hughes,President,Hillary Clinton,DEM,320032,1,0,64,65,
Hughes,U.S. Senate,James Lankford,REP,320032,8,1,140,149,
Hughes,U.S. Senate,Robert Murphy,LIB,320032,1,0,4,5,
Hughes,U.S. Senate,Mike Workman,DEM,320032,1,0,63,64,
Hughes,U.S. Senate,Mark Beard,IND,320032,0,0,5,5,
Hughes,U.S. Senate,Sean Braddy,IND,320032,0,0,2,2,
Hughes,U.S. House,Markwayne Mullin,REP,320032,7,1,124,132,02
Hughes,U.S. House,Joshua Harris-Till,DEM,320032,1,0,72,73,02
Hughes,U.S. House,John Mccarthy,IND,320032,2,0,14,16,02
Hughes,State Senate,Larry Boggs,REP,320032,8,1,104,113,7
Hughes,State Senate,Joel Kerns,DEM,320032,2,0,113,115,7
Hughes,President,Donald Trump,REP,320033,8,8,208,224,
Hughes,President,Gary Johnson,LIB,320033,0,0,9,9,
Hughes,President,Hillary Clinton,DEM,320033,3,3,29,35,
Hughes,U.S. Senate,James Lankford,REP,320033,7,8,196,211,
Hughes,U.S. Senate,Robert Murphy,LIB,320033,0,0,4,4,
Hughes,U.S. Senate,Mike Workman,DEM,320033,3,3,26,32,
Hughes,U.S. Senate,Mark Beard,IND,320033,0,0,7,7,
Hughes,U.S. Senate,Sean Braddy,IND,320033,0,0,5,5,
Hughes,U.S. House,Markwayne Mullin,REP,320033,7,8,173,188,02
Hughes,U.S. House,Joshua Harris-Till,DEM,320033,3,3,41,47,02
Hughes,U.S. House,John Mccarthy,IND,320033,0,0,24,24,02
Hughes,State Senate,Larry Boggs,REP,320033,5,7,179,191,7
Hughes,State Senate,Joel Kerns,DEM,320033,6,4,65,75,7
Hughes,President,Donald Trump,REP,320034,4,2,130,136,
Hughes,President,Gary Johnson,LIB,320034,0,0,5,5,
Hughes,President,Hillary Clinton,DEM,320034,0,5,19,24,
Hughes,U.S. Senate,James Lankford,REP,320034,4,2,125,131,
Hughes,U.S. Senate,Robert Murphy,LIB,320034,0,0,4,4,
Hughes,U.S. Senate,Mike Workman,DEM,320034,0,5,21,26,
Hughes,U.S. Senate,Mark Beard,IND,320034,0,0,4,4,
Hughes,U.S. Senate,Sean Braddy,IND,320034,0,0,1,1,
Hughes,U.S. House,Markwayne Mullin,REP,320034,3,3,109,115,02
Hughes,U.S. House,Joshua Harris-Till,DEM,320034,0,4,32,36,02
Hughes,U.S. House,John Mccarthy,IND,320034,1,0,8,9,02
Hughes,State Senate,Larry Boggs,REP,320034,4,2,112,118,7
Hughes,State Senate,Joel Kerns,DEM,320034,0,5,39,44,7
Hughes,President,Donald Trump,REP,320035,17,64,400,481,
Hughes,President,Gary Johnson,LIB,320035,0,3,23,26,
Hughes,President,Hillary Clinton,DEM,320035,9,21,119,149,
Hughes,U.S. Senate,James Lankford,REP,320035,18,65,393,476,
Hughes,U.S. Senate,Robert Murphy,LIB,320035,1,1,12,14,
Hughes,U.S. Senate,Mike Workman,DEM,320035,7,20,108,135,
Hughes,U.S. Senate,Mark Beard,IND,320035,0,1,13,14,
Hughes,U.S. Senate,Sean Braddy,IND,320035,0,2,12,14,
Hughes,U.S. House,Markwayne Mullin,REP,320035,17,56,328,401,02
Hughes,U.S. House,Joshua Harris-Till,DEM,320035,9,24,136,169,02
Hughes,U.S. House,John Mccarthy,IND,320035,0,8,67,75,02
Hughes,State Senate,Greg Mccortney,REP,320035,17,54,332,403,13
Hughes,State Senate,Eric Hall,DEM,320035,9,34,198,241,13
Jackson,President,Donald Trump,REP,330001,70,281,750,1101,
Jackson,President,Gary Johnson,LIB,330001,14,14,41,69,
Jackson,President,Hillary Clinton,DEM,330001,24,69,127,220,
Jackson,U.S. Senate,James Lankford,REP,330001,85,296,758,1139,
Jackson,U.S. Senate,Robert Murphy,LIB,330001,4,6,28,38,
Jackson,U.S. Senate,Mike Workman,DEM,330001,18,56,104,178,
Jackson,U.S. Senate,Mark Beard,IND,330001,1,4,13,18,
Jackson,U.S. Senate,Sean Braddy,IND,330001,1,5,11,17,
Jackson,U.S. House,Frank Lucas,REP,330001,87,291,763,1141,03
Jackson,U.S. House,Frankie Robbins,DEM,330001,21,67,133,221,03
Jackson,President,Donald Trump,REP,330002,26,128,220,374,
Jackson,President,Gary Johnson,LIB,330002,5,6,13,24,
Jackson,President,Hillary Clinton,DEM,330002,10,26,34,70,
Jackson,U.S. Senate,James Lankford,REP,330002,35,139,227,401,
Jackson,U.S. Senate,Robert Murphy,LIB,330002,0,1,5,6,
Jackson,U.S. Senate,Mike Workman,DEM,330002,6,16,29,51,
Jackson,U.S. Senate,Mark Beard,IND,330002,0,0,1,1,
Jackson,U.S. Senate,Sean Braddy,IND,330002,1,3,7,11,
Jackson,U.S. House,Frank Lucas,REP,330002,32,136,225,393,03
Jackson,U.S. House,Frankie Robbins,DEM,330002,9,21,42,72,03
Jackson,President,Donald Trump,REP,330003,14,72,247,333,
Jackson,President,Gary Johnson,LIB,330003,0,4,24,28,
Jackson,President,Hillary Clinton,DEM,330003,6,34,163,203,
Jackson,U.S. Senate,James Lankford,REP,330003,14,78,248,340,
Jackson,U.S. Senate,Robert Murphy,LIB,330003,0,1,20,21,
Jackson,U.S. Senate,Mike Workman,DEM,330003,6,24,135,165,
Jackson,U.S. Senate,Mark Beard,IND,330003,0,2,7,9,
Jackson,U.S. Senate,Sean Braddy,IND,330003,0,3,14,17,
Jackson,U.S. House,Frank Lucas,REP,330003,14,78,262,354,03
Jackson,U.S. House,Frankie Robbins,DEM,330003,6,28,163,197,03
Jackson,President,Donald Trump,REP,330006,29,197,561,787,
Jackson,President,Gary Johnson,LIB,330006,3,7,45,55,
Jackson,President,Hillary Clinton,DEM,330006,12,48,128,188,
Jackson,U.S. Senate,James Lankford,REP,330006,30,207,566,803,
Jackson,U.S. Senate,Robert Murphy,LIB,330006,0,3,25,28,
Jackson,U.S. Senate,Mike Workman,DEM,330006,12,32,121,165,
Jackson,U.S. Senate,Mark Beard,IND,330006,0,1,10,11,
Jackson,U.S. Senate,Sean Braddy,IND,330006,3,8,9,20,
Jackson,U.S. House,Frank Lucas,REP,330006,33,209,583,825,03
Jackson,U.S. House,Frankie Robbins,DEM,330006,12,44,147,203,03
Jackson,President,Donald Trump,REP,330007,8,64,324,396,
Jackson,President,Gary Johnson,LIB,330007,0,3,28,31,
Jackson,President,Hillary Clinton,DEM,330007,6,23,130,159,
Jackson,U.S. Senate,James Lankford,REP,330007,8,63,333,404,
Jackson,U.S. Senate,Robert Murphy,LIB,330007,0,1,20,21,
Jackson,U.S. Senate,Mike Workman,DEM,330007,6,21,111,138,
Jackson,U.S. Senate,Mark Beard,IND,330007,0,1,2,3,
Jackson,U.S. Senate,Sean Braddy,IND,330007,0,2,11,13,
Jackson,U.S. House,Frank Lucas,REP,330007,8,65,336,409,03
Jackson,U.S. House,Frankie Robbins,DEM,330007,6,25,131,162,03
Jackson,President,Donald Trump,REP,330010,6,72,201,279,
Jackson,President,Gary Johnson,LIB,330010,4,7,14,25,
Jackson,President,Hillary Clinton,DEM,330010,5,13,149,167,
Jackson,U.S. Senate,James Lankford,REP,330010,7,72,202,281,
Jackson,U.S. Senate,Robert Murphy,LIB,330010,2,2,8,12,
Jackson,U.S. Senate,Mike Workman,DEM,330010,5,15,117,137,
Jackson,U.S. Senate,Mark Beard,IND,330010,0,1,15,16,
Jackson,U.S. Senate,Sean Braddy,IND,330010,1,1,14,16,
Jackson,U.S. House,Frank Lucas,REP,330010,11,70,215,296,03
Jackson,U.S. House,Frankie Robbins,DEM,330010,4,21,139,164,03
Jackson,President,Donald Trump,REP,330014,35,130,499,664,
Jackson,President,Gary Johnson,LIB,330014,4,6,30,40,
Jackson,President,Hillary Clinton,DEM,330014,14,35,181,230,
Jackson,U.S. Senate,James Lankford,REP,330014,36,134,500,670,
Jackson,U.S. Senate,Robert Murphy,LIB,330014,3,3,24,30,
Jackson,U.S. Senate,Mike Workman,DEM,330014,12,27,148,187,
Jackson,U.S. Senate,Mark Beard,IND,330014,1,0,18,19,
Jackson,U.S. Senate,Sean Braddy,IND,330014,0,4,15,19,
Jackson,U.S. House,Frank Lucas,REP,330014,40,141,527,708,03
Jackson,U.S. House,Frankie Robbins,DEM,330014,13,27,176,216,03
Jackson,President,Donald Trump,REP,330016,5,39,340,384,
Jackson,President,Gary Johnson,LIB,330016,0,2,15,17,
Jackson,President,Hillary Clinton,DEM,330016,1,4,49,54,
Jackson,U.S. Senate,James Lankford,REP,330016,5,37,342,384,
Jackson,U.S. Senate,Robert Murphy,LIB,330016,0,2,11,13,
Jackson,U.S. Senate,Mike Workman,DEM,330016,1,4,39,44,
Jackson,U.S. Senate,Mark Beard,IND,330016,0,0,4,4,
Jackson,U.S. Senate,Sean Braddy,IND,330016,0,1,6,7,
Jackson,U.S. House,Frank Lucas,REP,330016,5,38,346,389,03
Jackson,U.S. House,Frankie Robbins,DEM,330016,1,6,46,53,03
Jackson,President,Donald Trump,REP,330017,9,18,229,256,
Jackson,President,Gary Johnson,LIB,330017,0,0,13,13,
Jackson,President,Hillary Clinton,DEM,330017,3,3,25,31,
Jackson,U.S. Senate,James Lankford,REP,330017,11,18,233,262,
Jackson,U.S. Senate,Robert Murphy,LIB,330017,0,0,11,11,
Jackson,U.S. Senate,Mike Workman,DEM,330017,1,3,19,23,
Jackson,U.S. Senate,Mark Beard,IND,330017,0,0,3,3,
Jackson,U.S. Senate,Sean Braddy,IND,330017,0,0,1,1,
Jackson,U.S. House,Frank Lucas,REP,330017,12,19,241,272,03
Jackson,U.S. House,Frankie Robbins,DEM,330017,0,2,24,26,03
Jackson,President,Donald Trump,REP,330018,3,4,160,167,
Jackson,President,Gary Johnson,LIB,330018,1,0,4,5,
Jackson,President,Hillary Clinton,DEM,330018,1,0,18,19,
Jackson,U.S. Senate,James Lankford,REP,330018,4,3,148,155,
Jackson,U.S. Senate,Robert Murphy,LIB,330018,0,0,4,4,
Jackson,U.S. Senate,Mike Workman,DEM,330018,1,0,17,18,
Jackson,U.S. Senate,Mark Beard,IND,330018,0,0,4,4,
Jackson,U.S. Senate,Sean Braddy,IND,330018,0,1,4,5,
Jackson,U.S. House,Frank Lucas,REP,330018,4,4,158,166,03
Jackson,U.S. House,Frankie Robbins,DEM,330018,1,0,22,23,03
Jackson,President,Donald Trump,REP,330019,3,14,95,112,
Jackson,President,Gary Johnson,LIB,330019,0,0,5,5,
Jackson,President,Hillary Clinton,DEM,330019,0,5,11,16,
Jackson,U.S. Senate,James Lankford,REP,330019,3,15,99,117,
Jackson,U.S. Senate,Robert Murphy,LIB,330019,0,1,3,4,
Jackson,U.S. Senate,Mike Workman,DEM,330019,0,4,10,14,
Jackson,U.S. Senate,Mark Beard,IND,330019,0,0,1,1,
Jackson,U.S. Senate,Sean Braddy,IND,330019,0,0,1,1,
Jackson,U.S. House,Frank Lucas,REP,330019,2,16,104,122,03
Jackson,U.S. House,Frankie Robbins,DEM,330019,1,4,9,14,03
Jackson,President,Donald Trump,REP,330020,23,95,451,569,
Jackson,President,Gary Johnson,LIB,330020,1,7,14,22,
Jackson,President,Hillary Clinton,DEM,330020,2,14,27,43,
Jackson,U.S. Senate,James Lankford,REP,330020,26,98,436,560,
Jackson,U.S. Senate,Robert Murphy,LIB,330020,0,3,9,12,
Jackson,U.S. Senate,Mike Workman,DEM,330020,0,12,37,49,
Jackson,U.S. Senate,Mark Beard,IND,330020,0,3,5,8,
Jackson,U.S. Senate,Sean Braddy,IND,330020,1,0,2,3,
Jackson,U.S. House,Frank Lucas,REP,330020,26,99,432,557,03
Jackson,U.S. House,Frankie Robbins,DEM,330020,1,17,52,70,03
Jackson,President,Donald Trump,REP,330021,2,15,73,90,
Jackson,President,Gary Johnson,LIB,330021,0,0,6,6,
Jackson,President,Hillary Clinton,DEM,330021,1,0,16,17,
Jackson,U.S. Senate,James Lankford,REP,330021,3,15,75,93,
Jackson,U.S. Senate,Robert Murphy,LIB,330021,0,0,2,2,
Jackson,U.S. Senate,Mike Workman,DEM,330021,0,0,14,14,
Jackson,U.S. Senate,Mark Beard,IND,330021,0,0,3,3,
Jackson,U.S. Senate,Sean Braddy,IND,330021,0,0,0,0,
Jackson,U.S. House,Frank Lucas,REP,330021,3,15,75,93,03
Jackson,U.S. House,Frankie Robbins,DEM,330021,0,0,18,18,03
Jackson,President,Donald Trump,REP,330023,10,71,217,298,
Jackson,President,Gary Johnson,LIB,330023,2,0,12,14,
Jackson,President,Hillary Clinton,DEM,330023,2,15,14,31,
Jackson,U.S. Senate,James Lankford,REP,330023,11,74,215,300,
Jackson,U.S. Senate,Robert Murphy,LIB,330023,1,1,5,7,
Jackson,U.S. Senate,Mike Workman,DEM,330023,2,9,11,22,
Jackson,U.S. Senate,Mark Beard,IND,330023,0,0,3,3,
Jackson,U.S. Senate,Sean Braddy,IND,330023,0,0,7,7,
Jackson,U.S. House,Frank Lucas,REP,330023,12,72,219,303,03
Jackson,U.S. House,Frankie Robbins,DEM,330023,2,12,16,30,03
Jackson,President,Donald Trump,REP,330024,3,10,146,159,
Jackson,President,Gary Johnson,LIB,330024,0,0,10,10,
Jackson,President,Hillary Clinton,DEM,330024,1,3,21,25,
Jackson,U.S. Senate,James Lankford,REP,330024,3,9,143,155,
Jackson,U.S. Senate,Robert Murphy,LIB,330024,0,0,6,6,
Jackson,U.S. Senate,Mike Workman,DEM,330024,0,3,21,24,
Jackson,U.S. Senate,Mark Beard,IND,330024,0,1,0,1,
Jackson,U.S. Senate,Sean Braddy,IND,330024,0,0,7,7,
Jackson,U.S. House,Frank Lucas,REP,330024,3,8,151,162,03
Jackson,U.S. House,Frankie Robbins,DEM,330024,0,5,27,32,03
Jefferson,President,Donald Trump,REP,340001,7,89,203,299,
Jefferson,President,Gary Johnson,LIB,340001,0,4,10,14,
Jefferson,President,Hillary Clinton,DEM,340001,3,12,46,61,
Jefferson,U.S. Senate,James Lankford,REP,340001,8,77,190,275,
Jefferson,U.S. Senate,Robert Murphy,LIB,340001,1,1,4,6,
Jefferson,U.S. Senate,Mike Workman,DEM,340001,1,20,44,65,
Jefferson,U.S. Senate,Mark Beard,IND,340001,0,0,7,7,
Jefferson,U.S. Senate,Sean Braddy,IND,340001,0,2,3,5,
Jefferson,U.S. House,Tom Cole,REP,340001,9,83,208,300,04
Jefferson,U.S. House,Sevier White,LIB,340001,0,0,10,10,04
Jefferson,U.S. House,Christina Owen,DEM,340001,1,19,34,54,04
Jefferson,State Senate,Chris Kidd,REP,340001,10,100,229,339,31
Jefferson,State Senate,Perry Brinegar,DEM,340001,0,7,32,39,31
Jefferson,State House,Marcus Mcentire,REP,340001,8,69,188,265,50
Jefferson,State House,Melissa Tilley,DEM,340001,2,31,68,101,50
Jefferson,President,Donald Trump,REP,340002,19,79,156,254,
Jefferson,President,Gary Johnson,LIB,340002,0,1,11,12,
Jefferson,President,Hillary Clinton,DEM,340002,1,12,19,32,
Jefferson,U.S. Senate,James Lankford,REP,340002,18,67,146,231,
Jefferson,U.S. Senate,Robert Murphy,LIB,340002,0,0,5,5,
Jefferson,U.S. Senate,Mike Workman,DEM,340002,1,11,20,32,
Jefferson,U.S. Senate,Mark Beard,IND,340002,0,2,4,6,
Jefferson,U.S. Senate,Sean Braddy,IND,340002,0,5,5,10,
Jefferson,U.S. House,Tom Cole,REP,340002,18,79,160,257,04
Jefferson,U.S. House,Sevier White,LIB,340002,0,1,5,6,04
Jefferson,U.S. House,Christina Owen,DEM,340002,1,7,20,28,04
Jefferson,State Senate,Chris Kidd,REP,340002,19,86,184,289,31
Jefferson,State Senate,Perry Brinegar,DEM,340002,1,5,4,10,31
Jefferson,State House,Marcus Mcentire,REP,340002,18,71,142,231,50
Jefferson,State House,Melissa Tilley,DEM,340002,1,16,38,55,50
Jefferson,President,Donald Trump,REP,340003,5,23,80,108,
Jefferson,President,Gary Johnson,LIB,340003,0,0,1,1,
Jefferson,President,Hillary Clinton,DEM,340003,0,8,6,14,
Jefferson,U.S. Senate,James Lankford,REP,340003,5,23,75,103,
Jefferson,U.S. Senate,Robert Murphy,LIB,340003,0,0,0,0,
Jefferson,U.S. Senate,Mike Workman,DEM,340003,0,9,7,16,
Jefferson,U.S. Senate,Mark Beard,IND,340003,0,0,1,1,
Jefferson,U.S. Senate,Sean Braddy,IND,340003,0,0,1,1,
Jefferson,U.S. House,Tom Cole,REP,340003,4,23,78,105,04
Jefferson,U.S. House,Sevier White,LIB,340003,0,0,1,1,04
Jefferson,U.S. House,Christina Owen,DEM,340003,1,9,7,17,04
Jefferson,State Senate,Chris Kidd,REP,340003,5,24,77,106,31
Jefferson,State Senate,Perry Brinegar,DEM,340003,0,8,10,18,31
Jefferson,State House,Marcus Mcentire,REP,340003,4,21,67,92,50
Jefferson,State House,Melissa Tilley,DEM,340003,1,11,17,29,50
Jefferson,President,Donald Trump,REP,340004,1,15,67,83,
Jefferson,President,Gary Johnson,LIB,340004,1,0,2,3,
Jefferson,President,Hillary Clinton,DEM,340004,0,4,13,17,
Jefferson,U.S. Senate,James Lankford,REP,340004,1,14,59,74,
Jefferson,U.S. Senate,Robert Murphy,LIB,340004,0,0,2,2,
Jefferson,U.S. Senate,Mike Workman,DEM,340004,1,3,16,20,
Jefferson,U.S. Senate,Mark Beard,IND,340004,0,1,0,1,
Jefferson,U.S. Senate,Sean Braddy,IND,340004,0,0,2,2,
Jefferson,U.S. House,Tom Cole,REP,340004,1,14,64,79,04
Jefferson,U.S. House,Sevier White,LIB,340004,0,0,1,1,04
Jefferson,U.S. House,Christina Owen,DEM,340004,1,5,15,21,04
Jefferson,State Senate,Chris Kidd,REP,340004,2,17,74,93,31
Jefferson,State Senate,Perry Brinegar,DEM,340004,0,2,7,9,31
Jefferson,State House,Marcus Mcentire,REP,340004,1,9,54,64,50
Jefferson,State House,Melissa Tilley,DEM,340004,1,10,26,37,50
Jefferson,President,Donald Trump,REP,340005,1,10,51,62,
Jefferson,President,Gary Johnson,LIB,340005,2,4,0,6,
Jefferson,President,Hillary Clinton,DEM,340005,0,2,18,20,
Jefferson,U.S. Senate,James Lankford,REP,340005,1,11,44,56,
Jefferson,U.S. Senate,Robert Murphy,LIB,340005,1,1,1,3,
Jefferson,U.S. Senate,Mike Workman,DEM,340005,1,3,22,26,
Jefferson,U.S. Senate,Mark Beard,IND,340005,0,0,0,0,
Jefferson,U.S. Senate,Sean Braddy,IND,340005,0,1,2,3,
Jefferson,U.S. House,Tom Cole,REP,340005,2,14,53,69,04
Jefferson,U.S. House,Sevier White,LIB,340005,1,0,0,1,04
Jefferson,U.S. House,Christina Owen,DEM,340005,0,2,16,18,04
Jefferson,State Senate,Chris Kidd,REP,340005,1,15,56,72,31
Jefferson,State Senate,Perry Brinegar,DEM,340005,1,1,13,15,31
Jefferson,State House,Marcus Mcentire,REP,340005,1,7,40,48,50
Jefferson,State House,Melissa Tilley,DEM,340005,1,9,29,39,50
Jefferson,President,Donald Trump,REP,340006,4,34,260,298,
Jefferson,President,Gary Johnson,LIB,340006,0,2,12,14,
Jefferson,President,Hillary Clinton,DEM,340006,4,5,61,70,
Jefferson,U.S. Senate,James Lankford,REP,340006,3,29,229,261,
Jefferson,U.S. Senate,Robert Murphy,LIB,340006,0,1,8,9,
Jefferson,U.S. Senate,Mike Workman,DEM,340006,4,9,74,87,
Jefferson,U.S. Senate,Mark Beard,IND,340006,1,0,8,9,
Jefferson,U.S. Senate,Sean Braddy,IND,340006,0,1,4,5,
Jefferson,U.S. House,Tom Cole,REP,340006,4,34,264,302,04
Jefferson,U.S. House,Sevier White,LIB,340006,1,0,3,4,04
Jefferson,U.S. House,Christina Owen,DEM,340006,3,7,60,70,04
Jefferson,State Senate,Chris Kidd,REP,340006,4,39,270,313,31
Jefferson,State Senate,Perry Brinegar,DEM,340006,4,2,63,69,31
Jefferson,State House,Marcus Mcentire,REP,340006,3,25,212,240,50
Jefferson,State House,Melissa Tilley,DEM,340006,5,11,107,123,50
Jefferson,President,Donald Trump,REP,340007,2,5,113,120,
Jefferson,President,Gary Johnson,LIB,340007,0,0,12,12,
Jefferson,President,Hillary Clinton,DEM,340007,0,6,45,51,
Jefferson,U.S. Senate,James Lankford,REP,340007,2,4,92,98,
Jefferson,U.S. Senate,Robert Murphy,LIB,340007,0,2,6,8,
Jefferson,U.S. Senate,Mike Workman,DEM,340007,0,4,53,57,
Jefferson,U.S. Senate,Mark Beard,IND,340007,0,1,3,4,
Jefferson,U.S. Senate,Sean Braddy,IND,340007,0,0,7,7,
Jefferson,U.S. House,Tom Cole,REP,340007,2,8,112,122,04
Jefferson,U.S. House,Sevier White,LIB,340007,0,0,8,8,04
Jefferson,U.S. House,Christina Owen,DEM,340007,0,3,43,46,04
Jefferson,State Senate,Chris Kidd,REP,340007,2,9,132,143,31
Jefferson,State Senate,Perry Brinegar,DEM,340007,0,2,35,37,31
Jefferson,State House,Marcus Mcentire,REP,340007,2,7,83,92,50
Jefferson,State House,Melissa Tilley,DEM,340007,0,3,73,76,50
Jefferson,President,Donald Trump,REP,340008,1,12,31,44,
Jefferson,President,Gary Johnson,LIB,340008,0,0,0,0,
Jefferson,President,Hillary Clinton,DEM,340008,1,1,3,5,
Jefferson,U.S. Senate,James Lankford,REP,340008,1,10,29,40,
Jefferson,U.S. Senate,Robert Murphy,LIB,340008,0,0,1,1,
Jefferson,U.S. Senate,Mike Workman,DEM,340008,1,3,3,7,
Jefferson,U.S. Senate,Mark Beard,IND,340008,0,0,0,0,
Jefferson,U.S. Senate,Sean Braddy,IND,340008,0,0,1,1,
Jefferson,U.S. House,Tom Cole,REP,340008,1,8,28,37,04
Jefferson,U.S. House,Sevier White,LIB,340008,0,1,1,2,04
Jefferson,U.S. House,Christina Owen,DEM,340008,1,3,5,9,04
Jefferson,State Senate,Chris Kidd,REP,340008,2,13,33,48,31
Jefferson,State Senate,Perry Brinegar,DEM,340008,0,0,1,1,31
Jefferson,State House,Marcus Mcentire,REP,340008,1,11,29,41,50
Jefferson,State House,Melissa Tilley,DEM,340008,1,2,5,8,50
Jefferson,President,Donald Trump,REP,340009,19,41,549,609,
Jefferson,President,Gary Johnson,LIB,340009,1,1,10,12,
Jefferson,President,Hillary Clinton,DEM,340009,9,6,73,88,
Jefferson,U.S. Senate,James Lankford,REP,340009,17,37,487,541,
Jefferson,U.S. Senate,Robert Murphy,LIB,340009,2,0,10,12,
Jefferson,U.S. Senate,Mike Workman,DEM,340009,8,8,101,117,
Jefferson,U.S. Senate,Mark Beard,IND,340009,2,1,15,18,
Jefferson,U.S. Senate,Sean Braddy,IND,340009,0,2,16,18,
Jefferson,U.S. House,Tom Cole,REP,340009,19,37,521,577,04
Jefferson,U.S. House,Sevier White,LIB,340009,1,1,9,11,04
Jefferson,U.S. House,Christina Owen,DEM,340009,9,10,102,121,04
Jefferson,State Senate,Chris Kidd,REP,340009,21,41,542,604,31
Jefferson,State Senate,Perry Brinegar,DEM,340009,8,7,87,102,31
Jefferson,State House,Marcus Mcentire,REP,340009,16,38,457,511,50
Jefferson,State House,Melissa Tilley,DEM,340009,11,9,167,187,50
Jefferson,President,Donald Trump,REP,340010,1,1,31,33,
Jefferson,President,Gary Johnson,LIB,340010,0,0,1,1,
Jefferson,President,Hillary Clinton,DEM,340010,0,0,7,7,
Jefferson,U.S. Senate,James Lankford,REP,340010,1,1,30,32,
Jefferson,U.S. Senate,Robert Murphy,LIB,340010,0,0,0,0,
Jefferson,U.S. Senate,Mike Workman,DEM,340010,0,0,7,7,
Jefferson,U.S. Senate,Mark Beard,IND,340010,0,0,1,1,
Jefferson,U.S. Senate,Sean Braddy,IND,340010,0,0,1,1,
Jefferson,U.S. House,Tom Cole,REP,340010,1,1,32,34,04
Jefferson,U.S. House,Sevier White,LIB,340010,0,0,0,0,04
Jefferson,U.S. House,Christina Owen,DEM,340010,0,0,7,7,04
Jefferson,State Senate,Chris Kidd,REP,340010,1,1,33,35,31
Jefferson,State Senate,Perry Brinegar,DEM,340010,0,0,5,5,31
Jefferson,State House,Marcus Mcentire,REP,340010,1,1,29,31,50
Jefferson,State House,Melissa Tilley,DEM,340010,0,0,9,9,50
Johnston,President,Donald Trump,REP,350001,6,91,169,266,
Johnston,President,Gary Johnson,LIB,350001,2,4,5,11,
Johnston,President,Hillary Clinton,DEM,350001,1,19,39,59,
Johnston,U.S. Senate,James Lankford,REP,350001,6,86,167,259,
Johnston,U.S. Senate,Robert Murphy,LIB,350001,0,1,6,7,
Johnston,U.S. Senate,Mike Workman,DEM,350001,1,20,38,59,
Johnston,U.S. Senate,Mark Beard,IND,350001,2,6,1,9,
Johnston,U.S. Senate,Sean Braddy,IND,350001,0,1,1,2,
Johnston,U.S. House,Markwayne Mullin,REP,350001,7,82,161,250,02
Johnston,U.S. House,Joshua Harris-Till,DEM,350001,1,25,42,68,02
Johnston,U.S. House,John Mccarthy,IND,350001,1,6,11,18,02
Johnston,President,Donald Trump,REP,350002,8,50,127,185,
Johnston,President,Gary Johnson,LIB,350002,0,4,11,15,
Johnston,President,Hillary Clinton,DEM,350002,2,19,59,80,
Johnston,U.S. Senate,James Lankford,REP,350002,6,43,110,159,
Johnston,U.S. Senate,Robert Murphy,LIB,350002,0,0,5,5,
Johnston,U.S. Senate,Mike Workman,DEM,350002,3,23,59,85,
Johnston,U.S. Senate,Mark Beard,IND,350002,0,0,10,10,
Johnston,U.S. Senate,Sean Braddy,IND,350002,1,4,11,16,
Johnston,U.S. House,Markwayne Mullin,REP,350002,7,42,119,168,02
Johnston,U.S. House,Joshua Harris-Till,DEM,350002,2,19,57,78,02
Johnston,U.S. House,John Mccarthy,IND,350002,1,9,19,29,02
Johnston,President,Donald Trump,REP,350003,8,50,114,172,
Johnston,President,Gary Johnson,LIB,350003,0,3,6,9,
Johnston,President,Hillary Clinton,DEM,350003,3,19,30,52,
Johnston,U.S. Senate,James Lankford,REP,350003,7,43,91,141,
Johnston,U.S. Senate,Robert Murphy,LIB,350003,0,2,4,6,
Johnston,U.S. Senate,Mike Workman,DEM,350003,3,27,44,74,
Johnston,U.S. Senate,Mark Beard,IND,350003,0,0,1,1,
Johnston,U.S. Senate,Sean Braddy,IND,350003,0,1,6,7,
Johnston,U.S. House,Markwayne Mullin,REP,350003,6,44,92,142,02
Johnston,U.S. House,Joshua Harris-Till,DEM,350003,3,23,37,63,02
Johnston,U.S. House,John Mccarthy,IND,350003,2,5,16,23,02
Johnston,President,Donald Trump,REP,350004,18,146,332,496,
Johnston,President,Gary Johnson,LIB,350004,2,11,22,35,
Johnston,President,Hillary Clinton,DEM,350004,8,41,104,153,
Johnston,U.S. Senate,James Lankford,REP,350004,17,124,285,426,
Johnston,U.S. Senate,Robert Murphy,LIB,350004,0,4,19,23,
Johnston,U.S. Senate,Mike Workman,DEM,350004,11,56,118,185,
Johnston,U.S. Senate,Mark Beard,IND,350004,0,5,17,22,
Johnston,U.S. Senate,Sean Braddy,IND,350004,0,1,7,8,
Johnston,U.S. House,Markwayne Mullin,REP,350004,19,132,287,438,02
Johnston,U.S. House,Joshua Harris-Till,DEM,350004,8,42,117,167,02
Johnston,U.S. House,John Mccarthy,IND,350004,1,16,42,59,02
Johnston,President,Donald Trump,REP,350005,7,10,351,368,
Johnston,President,Gary Johnson,LIB,350005,0,0,8,8,
Johnston,President,Hillary Clinton,DEM,350005,2,2,66,70,
Johnston,U.S. Senate,James Lankford,REP,350005,7,8,300,315,
Johnston,U.S. Senate,Robert Murphy,LIB,350005,0,0,7,7,
Johnston,U.S. Senate,Mike Workman,DEM,350005,0,4,96,100,
Johnston,U.S. Senate,Mark Beard,IND,350005,0,0,7,7,
Johnston,U.S. Senate,Sean Braddy,IND,350005,0,0,9,9,
Johnston,U.S. House,Markwayne Mullin,REP,350005,9,8,300,317,02
Johnston,U.S. House,Joshua Harris-Till,DEM,350005,0,3,89,92,02
Johnston,U.S. House,John Mccarthy,IND,350005,0,1,30,31,02
Johnston,President,Donald Trump,REP,350006,2,38,210,250,
Johnston,President,Gary Johnson,LIB,350006,0,0,15,15,
Johnston,President,Hillary Clinton,DEM,350006,1,7,59,67,
Johnston,U.S. Senate,James Lankford,REP,350006,2,36,160,198,
Johnston,U.S. Senate,Robert Murphy,LIB,350006,0,0,9,9,
Johnston,U.S. Senate,Mike Workman,DEM,350006,1,8,81,90,
Johnston,U.S. Senate,Mark Beard,IND,350006,0,0,8,8,
Johnston,U.S. Senate,Sean Braddy,IND,350006,0,0,12,12,
Johnston,U.S. House,Markwayne Mullin,REP,350006,2,35,192,229,02
Johnston,U.S. House,Joshua Harris-Till,DEM,350006,1,8,63,72,02
Johnston,U.S. House,John Mccarthy,IND,350006,0,0,21,21,02
Johnston,President,Donald Trump,REP,350007,0,0,9,9,
Johnston,President,Gary Johnson,LIB,350007,0,0,0,0,
Johnston,President,Hillary Clinton,DEM,350007,0,0,2,2,
Johnston,U.S. Senate,James Lankford,REP,350007,0,0,10,10,
Johnston,U.S. Senate,Robert Murphy,LIB,350007,0,0,0,0,
Johnston,U.S. Senate,Mike Workman,DEM,350007,0,0,1,1,
Johnston,U.S. Senate,Mark Beard,IND,350007,0,0,0,0,
Johnston,U.S. Senate,Sean Braddy,IND,350007,0,0,0,0,
Johnston,U.S. House,Markwayne Mullin,REP,350007,0,0,9,9,02
Johnston,U.S. House,Joshua Harris-Till,DEM,350007,0,0,2,2,02
Johnston,U.S. House,John Mccarthy,IND,350007,0,0,0,0,02
Johnston,President,Donald Trump,REP,350008,0,4,185,189,
Johnston,President,Gary Johnson,LIB,350008,0,1,0,1,
Johnston,President,Hillary Clinton,DEM,350008,1,5,32,38,
Johnston,U.S. Senate,James Lankford,REP,350008,1,4,149,154,
Johnston,U.S. Senate,Robert Murphy,LIB,350008,0,0,3,3,
Johnston,U.S. Senate,Mike Workman,DEM,350008,0,6,50,56,
Johnston,U.S. Senate,Mark Beard,IND,350008,0,0,3,3,
Johnston,U.S. Senate,Sean Braddy,IND,350008,0,0,4,4,
Johnston,U.S. House,Markwayne Mullin,REP,350008,1,5,148,154,02
Johnston,U.S. House,Joshua Harris-Till,DEM,350008,0,5,42,47,02
Johnston,U.S. House,John Mccarthy,IND,350008,0,0,15,15,02
Johnston,President,Donald Trump,REP,350009,2,12,97,111,
Johnston,President,Gary Johnson,LIB,350009,0,0,2,2,
Johnston,President,Hillary Clinton,DEM,350009,2,5,26,33,
Johnston,U.S. Senate,James Lankford,REP,350009,2,11,73,86,
Johnston,U.S. Senate,Robert Murphy,LIB,350009,0,1,3,4,
Johnston,U.S. Senate,Mike Workman,DEM,350009,2,3,38,43,
Johnston,U.S. Senate,Mark Beard,IND,350009,0,2,3,5,
Johnston,U.S. Senate,Sean Braddy,IND,350009,0,0,6,6,
Johnston,U.S. House,Markwayne Mullin,REP,350009,1,11,78,90,02
Johnston,U.S. House,Joshua Harris-Till,DEM,350009,3,3,32,38,02
Johnston,U.S. House,John Mccarthy,IND,350009,0,3,12,15,02
Johnston,President,Donald Trump,REP,350010,4,3,76,83,
Johnston,President,Gary Johnson,LIB,350010,0,0,2,2,
Johnston,President,Hillary Clinton,DEM,350010,1,0,10,11,
Johnston,U.S. Senate,James Lankford,REP,350010,4,3,67,74,
Johnston,U.S. Senate,Robert Murphy,LIB,350010,0,0,1,1,
Johnston,U.S. Senate,Mike Workman,DEM,350010,1,0,13,14,
Johnston,U.S. Senate,Mark Beard,IND,350010,0,0,1,1,
Johnston,U.S. Senate,Sean Braddy,IND,350010,0,0,1,1,
Johnston,U.S. House,Markwayne Mullin,REP,350010,4,2,70,76,02
Johnston,U.S. House,Joshua Harris-Till,DEM,350010,1,1,11,13,02
Johnston,U.S. House,John Mccarthy,IND,350010,0,0,6,6,02
Johnston,President,Donald Trump,REP,350011,4,4,158,166,
Johnston,President,Gary Johnson,LIB,350011,0,0,6,6,
Johnston,President,Hillary Clinton,DEM,350011,2,1,23,26,
Johnston,U.S. Senate,James Lankford,REP,350011,4,3,120,127,
Johnston,U.S. Senate,Robert Murphy,LIB,350011,0,0,6,6,
Johnston,U.S. Senate,Mike Workman,DEM,350011,1,3,47,51,
Johnston,U.S. Senate,Mark Beard,IND,350011,0,0,3,3,
Johnston,U.S. Senate,Sean Braddy,IND,350011,1,0,2,3,
Johnston,U.S. House,Markwayne Mullin,REP,350011,4,4,125,133,02
Johnston,U.S. House,Joshua Harris-Till,DEM,350011,1,2,43,46,02
Johnston,U.S. House,John Mccarthy,IND,350011,1,0,10,11,02
Johnston,President,Donald Trump,REP,350012,4,22,306,332,
Johnston,President,Gary Johnson,LIB,350012,0,1,12,13,
Johnston,President,Hillary Clinton,DEM,350012,0,1,74,75,
Johnston,U.S. Senate,James Lankford,REP,350012,4,19,245,268,
Johnston,U.S. Senate,Robert Murphy,LIB,350012,0,0,13,13,
Johnston,U.S. Senate,Mike Workman,DEM,350012,0,2,91,93,
Johnston,U.S. Senate,Mark Beard,IND,350012,0,1,6,7,
Johnston,U.S. Senate,Sean Braddy,IND,350012,0,1,16,17,
Johnston,U.S. House,Markwayne Mullin,REP,350012,3,20,259,282,02
Johnston,U.S. House,Joshua Harris-Till,DEM,350012,1,3,79,83,02
Johnston,U.S. House,John Mccarthy,IND,350012,0,0,32,32,02
Johnston,President,Donald Trump,REP,350013,12,58,313,383,
Johnston,President,Gary Johnson,LIB,350013,0,2,18,20,
Johnston,President,Hillary Clinton,DEM,350013,3,14,92,109,
Johnston,U.S. Senate,James Lankford,REP,350013,11,56,277,344,
Johnston,U.S. Senate,Robert Murphy,LIB,350013,0,2,6,8,
Johnston,U.S. Senate,Mike Workman,DEM,350013,3,15,115,133,
Johnston,U.S. Senate,Mark Beard,IND,350013,1,0,10,11,
Johnston,U.S. Senate,Sean Braddy,IND,350013,0,0,15,15,
Johnston,U.S. House,Markwayne Mullin,REP,350013,12,54,283,349,02
Johnston,U.S. House,Joshua Harris-Till,DEM,350013,2,15,111,128,02
Johnston,U.S. House,John Mccarthy,IND,350013,1,3,28,32,02
Johnston,President,Donald Trump,REP,350014,1,10,72,83,
Johnston,President,Gary Johnson,LIB,350014,0,1,1,2,
Johnston,President,Hillary Clinton,DEM,350014,0,2,9,11,
Johnston,U.S. Senate,James Lankford,REP,350014,1,11,63,75,
Johnston,U.S. Senate,Robert Murphy,LIB,350014,0,0,1,1,
Johnston,U.S. Senate,Mike Workman,DEM,350014,0,2,13,15,
Johnston,U.S. Senate,Mark Beard,IND,350014,0,0,1,1,
Johnston,U.S. Senate,Sean Braddy,IND,350014,0,0,1,1,
Johnston,U.S. House,Markwayne Mullin,REP,350014,1,12,63,76,02
Johnston,U.S. House,Joshua Harris-Till,DEM,350014,0,1,12,13,02
Johnston,U.S. House,John Mccarthy,IND,350014,0,0,5,5,02
Kay,President,Donald Trump,REP,360001,21,147,537,705,
Kay,President,Gary Johnson,LIB,360001,7,5,34,46,
Kay,President,Hillary Clinton,DEM,360001,9,40,115,164,
Kay,U.S. Senate,James Lankford,REP,360001,22,139,529,690,
Kay,U.S. Senate,Robert Murphy,LIB,360001,0,1,21,22,
Kay,U.S. Senate,Mike Workman,DEM,360001,10,38,96,144,
Kay,U.S. Senate,Mark Beard,IND,360001,1,8,13,22,
Kay,U.S. Senate,Sean Braddy,IND,360001,2,5,19,26,
Kay,U.S. House,Frank Lucas,REP,360001,23,144,544,711,03
Kay,U.S. House,Frankie Robbins,DEM,360001,11,44,128,183,03
Kay,President,Donald Trump,REP,360101,17,16,471,504,
Kay,President,Gary Johnson,LIB,360101,1,0,23,24,
Kay,President,Hillary Clinton,DEM,360101,7,9,154,170,
Kay,U.S. Senate,James Lankford,REP,360101,17,14,450,481,
Kay,U.S. Senate,Robert Murphy,LIB,360101,0,1,18,19,
Kay,U.S. Senate,Mike Workman,DEM,360101,6,9,141,156,
Kay,U.S. Senate,Mark Beard,IND,360101,0,0,21,21,
Kay,U.S. Senate,Sean Braddy,IND,360101,3,1,12,16,
Kay,U.S. House,Frank Lucas,REP,360101,18,14,465,497,03
Kay,U.S. House,Frankie Robbins,DEM,360101,7,11,169,187,03
Kay,President,Donald Trump,REP,360103,19,17,483,519,
Kay,President,Gary Johnson,LIB,360103,2,0,38,40,
Kay,President,Hillary Clinton,DEM,360103,4,4,103,111,
Kay,U.S. Senate,James Lankford,REP,360103,18,17,474,509,
Kay,U.S. Senate,Robert Murphy,LIB,360103,1,0,16,17,
Kay,U.S. Senate,Mike Workman,DEM,360103,6,3,95,104,
Kay,U.S. Senate,Mark Beard,IND,360103,0,1,17,18,
Kay,U.S. Senate,Sean Braddy,IND,360103,0,0,17,17,
Kay,U.S. House,Frank Lucas,REP,360103,19,17,493,529,03
Kay,U.S. House,Frankie Robbins,DEM,360103,5,4,119,128,03
Kay,President,Donald Trump,REP,360202,25,32,521,578,
Kay,President,Gary Johnson,LIB,360202,2,0,43,45,
Kay,President,Hillary Clinton,DEM,360202,4,9,134,147,
Kay,U.S. Senate,James Lankford,REP,360202,25,29,509,563,
Kay,U.S. Senate,Robert Murphy,LIB,360202,1,1,16,18,
Kay,U.S. Senate,Mike Workman,DEM,360202,3,10,124,137,
Kay,U.S. Senate,Mark Beard,IND,360202,1,1,20,22,
Kay,U.S. Senate,Sean Braddy,IND,360202,1,0,28,29,
Kay,U.S. House,Frank Lucas,REP,360202,26,33,535,594,03
Kay,U.S. House,Frankie Robbins,DEM,360202,5,8,163,176,03
Kay,State Senate,Roland Pederson,REP,360202,25,29,481,535,19
Kay,State Senate,Rhonda Harlow,DEM,360202,2,10,144,156,19
Kay,State Senate,Whitney Hall,IND,360202,3,1,70,74,19
Kay,President,Donald Trump,REP,360205,21,22,491,534,
Kay,President,Gary Johnson,LIB,360205,1,0,53,54,
Kay,President,Hillary Clinton,DEM,360205,6,12,134,152,
Kay,U.S. Senate,James Lankford,REP,360205,22,23,487,532,
Kay,U.S. Senate,Robert Murphy,LIB,360205,3,0,24,27,
Kay,U.S. Senate,Mike Workman,DEM,360205,3,11,127,141,
Kay,U.S. Senate,Mark Beard,IND,360205,0,0,22,22,
Kay,U.S. Senate,Sean Braddy,IND,360205,0,0,20,20,
Kay,U.S. House,Frank Lucas,REP,360205,24,24,498,546,03
Kay,U.S. House,Frankie Robbins,DEM,360205,4,10,180,194,03
Kay,State Senate,Roland Pederson,REP,360205,21,21,446,488,19
Kay,State Senate,Rhonda Harlow,DEM,360205,5,11,162,178,19
Kay,State Senate,Whitney Hall,IND,360205,2,2,69,73,19
Kay,President,Donald Trump,REP,360206,33,42,787,862,
Kay,President,Gary Johnson,LIB,360206,6,2,57,65,
Kay,President,Hillary Clinton,DEM,360206,10,14,129,153,
Kay,U.S. Senate,James Lankford,REP,360206,43,42,782,867,
Kay,U.S. Senate,Robert Murphy,LIB,360206,2,1,33,36,
Kay,U.S. Senate,Mike Workman,DEM,360206,6,12,106,124,
Kay,U.S. Senate,Mark Beard,IND,360206,1,2,22,25,
Kay,U.S. Senate,Sean Braddy,IND,360206,0,1,26,27,
Kay,U.S. House,Frank Lucas,REP,360206,46,46,816,908,03
Kay,U.S. House,Frankie Robbins,DEM,360206,6,12,149,167,03
Kay,State Senate,Roland Pederson,REP,360206,35,40,734,809,19
Kay,State Senate,Rhonda Harlow,DEM,360206,10,15,164,189,19
Kay,State Senate,Whitney Hall,IND,360206,4,3,69,76,19
Kay,President,Donald Trump,REP,360400,5,12,86,103,
Kay,President,Gary Johnson,LIB,360400,0,4,2,6,
Kay,President,Hillary Clinton,DEM,360400,1,3,18,22,
Kay,U.S. Senate,James Lankford,REP,360400,4,15,89,108,
Kay,U.S. Senate,Robert Murphy,LIB,360400,0,0,1,1,
Kay,U.S. Senate,Mike Workman,DEM,360400,1,3,13,17,
Kay,U.S. Senate,Mark Beard,IND,360400,0,0,2,2,
Kay,U.S. Senate,Sean Braddy,IND,360400,0,1,0,1,
Kay,U.S. House,Frank Lucas,REP,360400,5,16,85,106,03
Kay,U.S. House,Frankie Robbins,DEM,360400,1,3,19,23,03
Kay,President,Donald Trump,REP,360401,0,7,44,51,
Kay,President,Gary Johnson,LIB,360401,0,0,3,3,
Kay,President,Hillary Clinton,DEM,360401,0,5,4,9,
Kay,U.S. Senate,James Lankford,REP,360401,0,8,48,56,
Kay,U.S. Senate,Robert Murphy,LIB,360401,0,0,0,0,
Kay,U.S. Senate,Mike Workman,DEM,360401,0,3,4,7,
Kay,U.S. Senate,Mark Beard,IND,360401,0,0,1,1,
Kay,U.S. Senate,Sean Braddy,IND,360401,0,1,0,1,
Kay,U.S. House,Frank Lucas,REP,360401,0,7,46,53,03
Kay,U.S. House,Frankie Robbins,DEM,360401,0,5,7,12,03
Kay,President,Donald Trump,REP,360403,13,54,291,358,
Kay,President,Gary Johnson,LIB,360403,0,3,13,16,
Kay,President,Hillary Clinton,DEM,360403,3,16,54,73,
Kay,U.S. Senate,James Lankford,REP,360403,13,57,284,354,
Kay,U.S. Senate,Robert Murphy,LIB,360403,0,3,9,12,
Kay,U.S. Senate,Mike Workman,DEM,360403,3,11,49,63,
Kay,U.S. Senate,Mark Beard,IND,360403,0,0,10,10,
Kay,U.S. Senate,Sean Braddy,IND,360403,0,0,4,4,
Kay,U.S. House,Frank Lucas,REP,360403,13,59,296,368,03
Kay,U.S. House,Frankie Robbins,DEM,360403,3,11,54,68,03
Kay,President,Donald Trump,REP,360404,5,7,123,135,
Kay,President,Gary Johnson,LIB,360404,0,0,7,7,
Kay,President,Hillary Clinton,DEM,360404,0,1,12,13,
Kay,U.S. Senate,James Lankford,REP,360404,5,6,123,134,
Kay,U.S. Senate,Robert Murphy,LIB,360404,0,0,0,0,
Kay,U.S. Senate,Mike Workman,DEM,360404,0,1,15,16,
Kay,U.S. Senate,Mark Beard,IND,360404,0,0,3,3,
Kay,U.S. Senate,Sean Braddy,IND,360404,0,0,4,4,
Kay,U.S. House,Frank Lucas,REP,360404,5,5,122,132,03
Kay,U.S. House,Frankie Robbins,DEM,360404,0,2,22,24,03
Kay,President,Donald Trump,REP,360406,2,11,173,186,
Kay,President,Gary Johnson,LIB,360406,0,0,11,11,
Kay,President,Hillary Clinton,DEM,360406,1,4,27,32,
Kay,U.S. Senate,James Lankford,REP,360406,2,12,167,181,
Kay,U.S. Senate,Robert Murphy,LIB,360406,0,1,5,6,
Kay,U.S. Senate,Mike Workman,DEM,360406,1,2,25,28,
Kay,U.S. Senate,Mark Beard,IND,360406,0,0,6,6,
Kay,U.S. Senate,Sean Braddy,IND,360406,0,0,4,4,
Kay,U.S. House,Frank Lucas,REP,360406,2,11,174,187,03
Kay,U.S. House,Frankie Robbins,DEM,360406,1,4,34,39,03
Kay,State Senate,Roland Pederson,REP,360406,2,12,152,166,19
Kay,State Senate,Rhonda Harlow,DEM,360406,1,2,32,35,19
Kay,State Senate,Whitney Hall,IND,360406,0,1,21,22,19
Kay,President,Donald Trump,REP,360407,2,1,31,34,
Kay,President,Gary Johnson,LIB,360407,0,0,1,1,
Kay,President,Hillary Clinton,DEM,360407,0,0,2,2,
Kay,U.S. Senate,James Lankford,REP,360407,2,1,32,35,
Kay,U.S. Senate,Robert Murphy,LIB,360407,0,0,0,0,
Kay,U.S. Senate,Mike Workman,DEM,360407,0,0,0,0,
Kay,U.S. Senate,Mark Beard,IND,360407,0,0,1,1,
Kay,U.S. Senate,Sean Braddy,IND,360407,0,0,1,1,
Kay,U.S. House,Frank Lucas,REP,360407,2,1,30,33,03
Kay,U.S. House,Frankie Robbins,DEM,360407,0,0,3,3,03
Kay,President,Donald Trump,REP,360409,5,8,54,67,
Kay,President,Gary Johnson,LIB,360409,0,1,6,7,
Kay,President,Hillary Clinton,DEM,360409,1,1,5,7,
Kay,U.S. Senate,James Lankford,REP,360409,5,7,59,71,
Kay,U.S. Senate,Robert Murphy,LIB,360409,0,0,1,1,
Kay,U.S. Senate,Mike Workman,DEM,360409,1,3,4,8,
Kay,U.S. Senate,Mark Beard,IND,360409,0,0,1,1,
Kay,U.S. Senate,Sean Braddy,IND,360409,0,0,0,0,
Kay,U.S. House,Frank Lucas,REP,360409,5,6,59,70,03
Kay,U.S. House,Frankie Robbins,DEM,360409,1,4,5,10,03
Kay,President,Donald Trump,REP,360411,6,15,117,138,
Kay,President,Gary Johnson,LIB,360411,0,0,7,7,
Kay,President,Hillary Clinton,DEM,360411,2,0,26,28,
Kay,U.S. Senate,James Lankford,REP,360411,6,16,115,137,
Kay,U.S. Senate,Robert Murphy,LIB,360411,0,0,5,5,
Kay,U.S. Senate,Mike Workman,DEM,360411,2,0,22,24,
Kay,U.S. Senate,Mark Beard,IND,360411,0,0,4,4,
Kay,U.S. Senate,Sean Braddy,IND,360411,0,0,2,2,
Kay,U.S. House,Frank Lucas,REP,360411,7,16,114,137,03
Kay,U.S. House,Frankie Robbins,DEM,360411,1,0,28,29,03
Kay,President,Donald Trump,REP,360412,7,7,185,199,
Kay,President,Gary Johnson,LIB,360412,0,0,9,9,
Kay,President,Hillary Clinton,DEM,360412,3,1,57,61,
Kay,U.S. Senate,James Lankford,REP,360412,6,7,171,184,
Kay,U.S. Senate,Robert Murphy,LIB,360412,0,0,3,3,
Kay,U.S. Senate,Mike Workman,DEM,360412,4,1,55,60,
Kay,U.S. Senate,Mark Beard,IND,360412,0,0,5,5,
Kay,U.S. Senate,Sean Braddy,IND,360412,0,0,8,8,
Kay,U.S. House,Frank Lucas,REP,360412,7,7,179,193,03
Kay,U.S. House,Frankie Robbins,DEM,360412,3,1,62,66,03
Kay,President,Donald Trump,REP,360413,36,72,649,757,
Kay,President,Gary Johnson,LIB,360413,4,1,32,37,
Kay,President,Hillary Clinton,DEM,360413,19,34,159,212,
Kay,U.S. Senate,James Lankford,REP,360413,42,79,670,791,
Kay,U.S. Senate,Robert Murphy,LIB,360413,2,0,16,18,
Kay,U.S. Senate,Mike Workman,DEM,360413,15,26,129,170,
Kay,U.S. Senate,Mark Beard,IND,360413,0,1,11,12,
Kay,U.S. Senate,Sean Braddy,IND,360413,1,0,7,8,
Kay,U.S. House,Frank Lucas,REP,360413,39,78,659,776,03
Kay,U.S. House,Frankie Robbins,DEM,360413,18,27,154,199,03
Kay,President,Donald Trump,REP,360419,13,18,312,343,
Kay,President,Gary Johnson,LIB,360419,1,3,13,17,
Kay,President,Hillary Clinton,DEM,360419,8,5,141,154,
Kay,U.S. Senate,James Lankford,REP,360419,14,20,312,346,
Kay,U.S. Senate,Robert Murphy,LIB,360419,0,0,8,8,
Kay,U.S. Senate,Mike Workman,DEM,360419,8,6,124,138,
Kay,U.S. Senate,Mark Beard,IND,360419,0,0,15,15,
Kay,U.S. Senate,Sean Braddy,IND,360419,0,0,9,9,
Kay,U.S. House,Frank Lucas,REP,360419,13,20,317,350,03
Kay,U.S. House,Frankie Robbins,DEM,360419,7,6,137,150,03
Kay,President,Donald Trump,REP,360420,5,8,210,223,
Kay,President,Gary Johnson,LIB,360420,0,0,16,16,
Kay,President,Hillary Clinton,DEM,360420,2,4,39,45,
Kay,U.S. Senate,James Lankford,REP,360420,4,8,203,215,
Kay,U.S. Senate,Robert Murphy,LIB,360420,2,1,6,9,
Kay,U.S. Senate,Mike Workman,DEM,360420,1,2,37,40,
Kay,U.S. Senate,Mark Beard,IND,360420,0,1,13,14,
Kay,U.S. Senate,Sean Braddy,IND,360420,0,0,5,5,
Kay,U.S. House,Frank Lucas,REP,360420,4,8,210,222,03
Kay,U.S. House,Frankie Robbins,DEM,360420,2,4,48,54,03
Kay,President,Donald Trump,REP,360503,44,81,602,727,
Kay,President,Gary Johnson,LIB,360503,7,1,54,62,
Kay,President,Hillary Clinton,DEM,360503,26,24,227,277,
Kay,U.S. Senate,James Lankford,REP,360503,43,78,605,726,
Kay,U.S. Senate,Robert Murphy,LIB,360503,3,2,37,42,
Kay,U.S. Senate,Mike Workman,DEM,360503,24,18,196,238,
Kay,U.S. Senate,Mark Beard,IND,360503,2,5,14,21,
Kay,U.S. Senate,Sean Braddy,IND,360503,3,2,32,37,
Kay,U.S. House,Frank Lucas,REP,360503,47,76,626,749,03
Kay,U.S. House,Frankie Robbins,DEM,360503,28,28,251,307,03
Kay,President,Donald Trump,REP,360507,12,28,374,414,
Kay,President,Gary Johnson,LIB,360507,0,4,37,41,
Kay,President,Hillary Clinton,DEM,360507,11,9,155,175,
Kay,U.S. Senate,James Lankford,REP,360507,12,28,385,425,
Kay,U.S. Senate,Robert Murphy,LIB,360507,0,1,20,21,
Kay,U.S. Senate,Mike Workman,DEM,360507,11,9,117,137,
Kay,U.S. Senate,Mark Beard,IND,360507,0,2,21,23,
Kay,U.S. Senate,Sean Braddy,IND,360507,0,0,20,20,
Kay,U.S. House,Frank Lucas,REP,360507,11,29,396,436,03
Kay,U.S. House,Frankie Robbins,DEM,360507,11,11,159,181,03
Kay,President,Donald Trump,REP,360516,13,19,311,343,
Kay,President,Gary Johnson,LIB,360516,2,0,33,35,
Kay,President,Hillary Clinton,DEM,360516,3,3,196,202,
Kay,U.S. Senate,James Lankford,REP,360516,12,16,285,313,
Kay,U.S. Senate,Robert Murphy,LIB,360516,2,1,30,33,
Kay,U.S. Senate,Mike Workman,DEM,360516,3,3,174,180,
Kay,U.S. Senate,Mark Beard,IND,360516,1,0,20,21,
Kay,U.S. Senate,Sean Braddy,IND,360516,1,1,21,23,
Kay,U.S. House,Frank Lucas,REP,360516,14,18,320,352,03
Kay,U.S. House,Frankie Robbins,DEM,360516,5,3,205,213,03
Kay,President,Donald Trump,REP,360517,7,26,345,378,
Kay,President,Gary Johnson,LIB,360517,0,2,48,50,
Kay,President,Hillary Clinton,DEM,360517,15,17,210,242,
Kay,U.S. Senate,James Lankford,REP,360517,7,31,373,411,
Kay,U.S. Senate,Robert Murphy,LIB,360517,0,0,23,23,
Kay,U.S. Senate,Mike Workman,DEM,360517,14,12,169,195,
Kay,U.S. Senate,Mark Beard,IND,360517,0,1,20,21,
Kay,U.S. Senate,Sean Braddy,IND,360517,0,0,22,22,
Kay,U.S. House,Frank Lucas,REP,360517,7,28,386,421,03
Kay,U.S. House,Frankie Robbins,DEM,360517,15,15,215,245,03
Kay,President,Donald Trump,REP,360527,30,69,625,724,
Kay,President,Gary Johnson,LIB,360527,3,1,50,54,
Kay,President,Hillary Clinton,DEM,360527,19,29,206,254,
Kay,U.S. Senate,James Lankford,REP,360527,38,67,651,756,
Kay,U.S. Senate,Robert Murphy,LIB,360527,1,0,13,14,
Kay,U.S. Senate,Mike Workman,DEM,360527,10,27,151,188,
Kay,U.S. Senate,Mark Beard,IND,360527,0,2,23,25,
Kay,U.S. Senate,Sean Braddy,IND,360527,3,4,32,39,
Kay,U.S. House,Frank Lucas,REP,360527,39,68,668,775,03
Kay,U.S. House,Frankie Robbins,DEM,360527,11,30,186,227,03
Kay,President,Donald Trump,REP,360530,28,52,482,562,
Kay,President,Gary Johnson,LIB,360530,4,2,46,52,
Kay,President,Hillary Clinton,DEM,360530,9,13,179,201,
Kay,U.S. Senate,James Lankford,REP,360530,25,54,488,567,
Kay,U.S. Senate,Robert Murphy,LIB,360530,3,1,24,28,
Kay,U.S. Senate,Mike Workman,DEM,360530,9,11,159,179,
Kay,U.S. Senate,Mark Beard,IND,360530,0,0,19,19,
Kay,U.S. Senate,Sean Braddy,IND,360530,1,1,12,14,
Kay,U.S. House,Frank Lucas,REP,360530,27,56,502,585,03
Kay,U.S. House,Frankie Robbins,DEM,360530,10,11,192,213,03
Kay,President,Donald Trump,REP,360532,45,58,512,615,
Kay,President,Gary Johnson,LIB,360532,4,3,34,41,
Kay,President,Hillary Clinton,DEM,360532,17,24,146,187,
Kay,U.S. Senate,James Lankford,REP,360532,46,59,536,641,
Kay,U.S. Senate,Robert Murphy,LIB,360532,2,2,17,21,
Kay,U.S. Senate,Mike Workman,DEM,360532,12,19,108,139,
Kay,U.S. Senate,Mark Beard,IND,360532,1,4,7,12,
Kay,U.S. Senate,Sean Braddy,IND,360532,3,0,21,24,
Kay,U.S. House,Frank Lucas,REP,360532,47,59,541,647,03
Kay,U.S. House,Frankie Robbins,DEM,360532,16,22,134,172,03
Kay,President,Donald Trump,REP,360533,32,44,528,604,
Kay,President,Gary Johnson,LIB,360533,4,1,47,52,
Kay,President,Hillary Clinton,DEM,360533,8,8,170,186,
Kay,U.S. Senate,James Lankford,REP,360533,37,44,536,617,
Kay,U.S. Senate,Robert Murphy,LIB,360533,1,1,21,23,
Kay,U.S. Senate,Mike Workman,DEM,360533,3,7,149,159,
Kay,U.S. Senate,Mark Beard,IND,360533,0,0,20,20,
Kay,U.S. Senate,Sean Braddy,IND,360533,2,2,15,19,
Kay,U.S. House,Frank Lucas,REP,360533,37,44,539,620,03
Kay,U.S. House,Frankie Robbins,DEM,360533,4,10,185,199,03
Kay,President,Donald Trump,REP,360534,30,106,663,799,
Kay,President,Gary Johnson,LIB,360534,4,3,51,58,
Kay,President,Hillary Clinton,DEM,360534,25,26,191,242,
Kay,U.S. Senate,James Lankford,REP,360534,30,107,698,835,
Kay,U.S. Senate,Robert Murphy,LIB,360534,3,3,15,21,
Kay,U.S. Senate,Mike Workman,DEM,360534,22,23,155,200,
Kay,U.S. Senate,Mark Beard,IND,360534,2,0,14,16,
Kay,U.S. Senate,Sean Braddy,IND,360534,2,2,20,24,
Kay,U.S. House,Frank Lucas,REP,360534,33,107,706,846,03
Kay,U.S. House,Frankie Robbins,DEM,360534,24,27,185,236,03
Kay,President,Donald Trump,REP,360535,54,78,578,710,
Kay,President,Gary Johnson,LIB,360535,1,7,29,37,
Kay,President,Hillary Clinton,DEM,360535,22,37,158,217,
Kay,U.S. Senate,James Lankford,REP,360535,62,83,620,765,
Kay,U.S. Senate,Robert Murphy,LIB,360535,0,3,13,16,
Kay,U.S. Senate,Mike Workman,DEM,360535,17,30,106,153,
Kay,U.S. Senate,Mark Beard,IND,360535,1,1,14,16,
Kay,U.S. Senate,Sean Braddy,IND,360535,0,4,14,18,
Kay,U.S. House,Frank Lucas,REP,360535,63,88,611,762,03
Kay,U.S. House,Frankie Robbins,DEM,360535,16,34,141,191,03
Kingfisher,President,Donald Trump,REP,370101,37,187,695,919,
Kingfisher,President,Gary Johnson,LIB,370101,2,6,27,35,
Kingfisher,President,Hillary Clinton,DEM,370101,15,35,94,144,
Kingfisher,U.S. Senate,James Lankford,REP,370101,41,198,717,956,
Kingfisher,U.S. Senate,Robert Murphy,LIB,370101,0,4,14,18,
Kingfisher,U.S. Senate,Mike Workman,DEM,370101,8,25,66,99,
Kingfisher,U.S. Senate,Mark Beard,IND,370101,1,0,7,8,
Kingfisher,U.S. Senate,Sean Braddy,IND,370101,1,2,12,15,
Kingfisher,U.S. House,Frank Lucas,REP,370101,42,202,723,967,03
Kingfisher,U.S. House,Frankie Robbins,DEM,370101,12,25,91,128,03
Kingfisher,President,Donald Trump,REP,370102,8,35,179,222,
Kingfisher,President,Gary Johnson,LIB,370102,1,1,8,10,
Kingfisher,President,Hillary Clinton,DEM,370102,2,2,16,20,
Kingfisher,U.S. Senate,James Lankford,REP,370102,10,34,192,236,
Kingfisher,U.S. Senate,Robert Murphy,LIB,370102,0,0,1,1,
Kingfisher,U.S. Senate,Mike Workman,DEM,370102,1,3,7,11,
Kingfisher,U.S. Senate,Mark Beard,IND,370102,0,1,1,2,
Kingfisher,U.S. Senate,Sean Braddy,IND,370102,0,0,0,0,
Kingfisher,U.S. House,Frank Lucas,REP,370102,10,34,187,231,03
Kingfisher,U.S. House,Frankie Robbins,DEM,370102,1,3,13,17,03
Kingfisher,President,Donald Trump,REP,370103,18,53,245,316,
Kingfisher,President,Gary Johnson,LIB,370103,0,2,9,11,
Kingfisher,President,Hillary Clinton,DEM,370103,1,6,14,21,
Kingfisher,U.S. Senate,James Lankford,REP,370103,18,58,243,319,
Kingfisher,U.S. Senate,Robert Murphy,LIB,370103,0,2,8,10,
Kingfisher,U.S. Senate,Mike Workman,DEM,370103,0,2,13,15,
Kingfisher,U.S. Senate,Mark Beard,IND,370103,1,0,3,4,
Kingfisher,U.S. Senate,Sean Braddy,IND,370103,0,0,3,3,
Kingfisher,U.S. House,Frank Lucas,REP,370103,18,56,249,323,03
Kingfisher,U.S. House,Frankie Robbins,DEM,370103,1,5,19,25,03
Kingfisher,President,Donald Trump,REP,370105,16,36,430,482,
Kingfisher,President,Gary Johnson,LIB,370105,1,0,27,28,
Kingfisher,President,Hillary Clinton,DEM,370105,2,5,89,96,
Kingfisher,U.S. Senate,James Lankford,REP,370105,18,38,456,512,
Kingfisher,U.S. Senate,Robert Murphy,LIB,370105,1,0,15,16,
Kingfisher,U.S. Senate,Mike Workman,DEM,370105,1,3,54,58,
Kingfisher,U.S. Senate,Mark Beard,IND,370105,0,0,8,8,
Kingfisher,U.S. Senate,Sean Braddy,IND,370105,0,0,10,10,
Kingfisher,U.S. House,Frank Lucas,REP,370105,16,38,448,502,03
Kingfisher,U.S. House,Frankie Robbins,DEM,370105,4,3,92,99,03
Kingfisher,President,Donald Trump,REP,370106,6,9,70,85,
Kingfisher,President,Gary Johnson,LIB,370106,0,0,3,3,
Kingfisher,President,Hillary Clinton,DEM,370106,1,0,4,5,
Kingfisher,U.S. Senate,James Lankford,REP,370106,6,9,71,86,
Kingfisher,U.S. Senate,Robert Murphy,LIB,370106,0,0,0,0,
Kingfisher,U.S. Senate,Mike Workman,DEM,370106,1,0,5,6,
Kingfisher,U.S. Senate,Mark Beard,IND,370106,0,0,1,1,
Kingfisher,U.S. Senate,Sean Braddy,IND,370106,0,0,0,0,
Kingfisher,U.S. House,Frank Lucas,REP,370106,6,9,71,86,03
Kingfisher,U.S. House,Frankie Robbins,DEM,370106,1,0,6,7,03
Kingfisher,President,Donald Trump,REP,370201,27,59,877,963,
Kingfisher,President,Gary Johnson,LIB,370201,0,2,28,30,
Kingfisher,President,Hillary Clinton,DEM,370201,12,14,144,170,
Kingfisher,U.S. Senate,James Lankford,REP,370201,27,62,902,991,
Kingfisher,U.S. Senate,Robert Murphy,LIB,370201,1,3,18,22,
Kingfisher,U.S. Senate,Mike Workman,DEM,370201,9,9,88,106,
Kingfisher,U.S. Senate,Mark Beard,IND,370201,1,0,12,13,
Kingfisher,U.S. Senate,Sean Braddy,IND,370201,1,0,27,28,
Kingfisher,U.S. House,Frank Lucas,REP,370201,26,61,914,1001,03
Kingfisher,U.S. House,Frankie Robbins,DEM,370201,13,11,127,151,03
Kingfisher,President,Donald Trump,REP,370203,18,12,105,135,
Kingfisher,President,Gary Johnson,LIB,370203,0,0,4,4,
Kingfisher,President,Hillary Clinton,DEM,370203,1,1,20,22,
Kingfisher,U.S. Senate,James Lankford,REP,370203,18,13,109,140,
Kingfisher,U.S. Senate,Robert Murphy,LIB,370203,0,0,5,5,
Kingfisher,U.S. Senate,Mike Workman,DEM,370203,0,0,10,10,
Kingfisher,U.S. Senate,Mark Beard,IND,370203,1,0,2,3,
Kingfisher,U.S. Senate,Sean Braddy,IND,370203,0,0,4,4,
Kingfisher,U.S. House,Frank Lucas,REP,370203,18,12,114,144,03
Kingfisher,U.S. House,Frankie Robbins,DEM,370203,1,1,16,18,03
Kingfisher,President,Donald Trump,REP,370204,4,20,239,263,
Kingfisher,President,Gary Johnson,LIB,370204,0,1,7,8,
Kingfisher,President,Hillary Clinton,DEM,370204,1,3,32,36,
Kingfisher,U.S. Senate,James Lankford,REP,370204,4,22,227,253,
Kingfisher,U.S. Senate,Robert Murphy,LIB,370204,0,0,7,7,
Kingfisher,U.S. Senate,Mike Workman,DEM,370204,1,2,27,30,
Kingfisher,U.S. Senate,Mark Beard,IND,370204,0,0,7,7,
Kingfisher,U.S. Senate,Sean Braddy,IND,370204,0,0,6,6,
Kingfisher,U.S. House,Frank Lucas,REP,370204,4,22,241,267,03
Kingfisher,U.S. House,Frankie Robbins,DEM,370204,1,2,37,40,03
Kingfisher,President,Donald Trump,REP,370301,26,182,696,904,
Kingfisher,President,Gary Johnson,LIB,370301,1,6,31,38,
Kingfisher,President,Hillary Clinton,DEM,370301,3,36,133,172,
Kingfisher,U.S. Senate,James Lankford,REP,370301,26,198,729,953,
Kingfisher,U.S. Senate,Robert Murphy,LIB,370301,0,4,23,27,
Kingfisher,U.S. Senate,Mike Workman,DEM,370301,4,21,88,113,
Kingfisher,U.S. Senate,Mark Beard,IND,370301,0,0,6,6,
Kingfisher,U.S. Senate,Sean Braddy,IND,370301,0,2,13,15,
Kingfisher,U.S. House,Frank Lucas,REP,370301,27,199,747,973,03
Kingfisher,U.S. House,Frankie Robbins,DEM,370301,2,24,110,136,03
Kingfisher,President,Donald Trump,REP,370302,18,32,366,416,
Kingfisher,President,Gary Johnson,LIB,370302,0,2,14,16,
Kingfisher,President,Hillary Clinton,DEM,370302,3,3,52,58,
Kingfisher,U.S. Senate,James Lankford,REP,370302,17,33,368,418,
Kingfisher,U.S. Senate,Robert Murphy,LIB,370302,0,1,7,8,
Kingfisher,U.S. Senate,Mike Workman,DEM,370302,3,2,47,52,
Kingfisher,U.S. Senate,Mark Beard,IND,370302,1,0,4,5,
Kingfisher,U.S. Senate,Sean Braddy,IND,370302,0,1,8,9,
Kingfisher,U.S. House,Frank Lucas,REP,370302,18,30,388,436,03
Kingfisher,U.S. House,Frankie Robbins,DEM,370302,3,6,46,55,03
Kingfisher,State Senate,Lonnie Paxton,REP,370302,18,32,359,409,23
Kingfisher,State Senate,Larry Wasson,DEM,370302,2,3,68,73,23
Kingfisher,President,Donald Trump,REP,370303,6,22,88,116,
Kingfisher,President,Gary Johnson,LIB,370303,0,0,2,2,
Kingfisher,President,Hillary Clinton,DEM,370303,1,0,7,8,
Kingfisher,U.S. Senate,James Lankford,REP,370303,6,22,88,116,
Kingfisher,U.S. Senate,Robert Murphy,LIB,370303,0,0,3,3,
Kingfisher,U.S. Senate,Mike Workman,DEM,370303,1,0,3,4,
Kingfisher,U.S. Senate,Mark Beard,IND,370303,0,0,1,1,
Kingfisher,U.S. Senate,Sean Braddy,IND,370303,0,0,2,2,
Kingfisher,U.S. House,Frank Lucas,REP,370303,7,20,92,119,03
Kingfisher,U.S. House,Frankie Robbins,DEM,370303,0,2,5,7,03
Kingfisher,President,Donald Trump,REP,370304,4,12,126,142,
Kingfisher,President,Gary Johnson,LIB,370304,0,0,3,3,
Kingfisher,President,Hillary Clinton,DEM,370304,0,3,15,18,
Kingfisher,U.S. Senate,James Lankford,REP,370304,4,12,129,145,
Kingfisher,U.S. Senate,Robert Murphy,LIB,370304,0,0,1,1,
Kingfisher,U.S. Senate,Mike Workman,DEM,370304,0,3,10,13,
Kingfisher,U.S. Senate,Mark Beard,IND,370304,0,0,0,0,
Kingfisher,U.S. Senate,Sean Braddy,IND,370304,0,0,1,1,
Kingfisher,U.S. House,Frank Lucas,REP,370304,4,12,133,149,03
Kingfisher,U.S. House,Frankie Robbins,DEM,370304,0,3,8,11,03
Kingfisher,President,Donald Trump,REP,370305,6,28,141,175,
Kingfisher,President,Gary Johnson,LIB,370305,0,0,1,1,
Kingfisher,President,Hillary Clinton,DEM,370305,4,0,11,15,
Kingfisher,U.S. Senate,James Lankford,REP,370305,8,28,144,180,
Kingfisher,U.S. Senate,Robert Murphy,LIB,370305,1,0,2,3,
Kingfisher,U.S. Senate,Mike Workman,DEM,370305,1,0,5,6,
Kingfisher,U.S. Senate,Mark Beard,IND,370305,0,0,2,2,
Kingfisher,U.S. Senate,Sean Braddy,IND,370305,0,0,2,2,
Kingfisher,U.S. House,Frank Lucas,REP,370305,9,28,141,178,03
Kingfisher,U.S. House,Frankie Robbins,DEM,370305,1,0,13,14,03
Kingfisher,President,Donald Trump,REP,370306,0,0,18,18,
Kingfisher,President,Gary Johnson,LIB,370306,0,0,0,0,
Kingfisher,President,Hillary Clinton,DEM,370306,0,0,1,1,
Kingfisher,U.S. Senate,James Lankford,REP,370306,0,0,18,18,
Kingfisher,U.S. Senate,Robert Murphy,LIB,370306,0,0,0,0,
Kingfisher,U.S. Senate,Mike Workman,DEM,370306,0,0,1,1,
Kingfisher,U.S. Senate,Mark Beard,IND,370306,0,0,0,0,
Kingfisher,U.S. Senate,Sean Braddy,IND,370306,0,0,0,0,
Kingfisher,U.S. House,Frank Lucas,REP,370306,0,0,17,17,03
Kingfisher,U.S. House,Frankie Robbins,DEM,370306,0,0,2,2,03
Kiowa,President,Donald Trump,REP,380001,31,144,384,559,
Kiowa,President,Gary Johnson,LIB,380001,0,4,30,34,
Kiowa,President,Hillary Clinton,DEM,380001,13,43,88,144,
Kiowa,U.S. Senate,James Lankford,REP,380001,30,156,423,609,
Kiowa,U.S. Senate,Robert Murphy,LIB,380001,0,2,4,6,
Kiowa,U.S. Senate,Mike Workman,DEM,380001,10,30,64,104,
Kiowa,U.S. Senate,Mark Beard,IND,380001,2,0,2,4,
Kiowa,U.S. Senate,Sean Braddy,IND,380001,1,3,8,12,
Kiowa,U.S. House,Frank Lucas,REP,380001,32,158,440,630,03
Kiowa,U.S. House,Frankie Robbins,DEM,380001,12,33,58,103,03
Kiowa,State House,Todd Russ,REP,380001,26,126,313,465,55
Kiowa,State House,Wayne Walters,DEM,380001,17,65,187,269,55
Kiowa,President,Donald Trump,REP,380002,2,21,98,121,
Kiowa,President,Gary Johnson,LIB,380002,0,1,3,4,
Kiowa,President,Hillary Clinton,DEM,380002,1,5,19,25,
Kiowa,U.S. Senate,James Lankford,REP,380002,2,21,107,130,
Kiowa,U.S. Senate,Robert Murphy,LIB,380002,0,0,3,3,
Kiowa,U.S. Senate,Mike Workman,DEM,380002,1,5,11,17,
Kiowa,U.S. Senate,Mark Beard,IND,380002,0,1,0,1,
Kiowa,U.S. Senate,Sean Braddy,IND,380002,0,1,1,2,
Kiowa,U.S. House,Frank Lucas,REP,380002,2,22,105,129,03
Kiowa,U.S. House,Frankie Robbins,DEM,380002,1,6,17,24,03
Kiowa,State House,Todd Russ,REP,380002,3,8,76,87,55
Kiowa,State House,Wayne Walters,DEM,380002,0,20,43,63,55
Kiowa,President,Donald Trump,REP,380004,5,84,242,331,
Kiowa,President,Gary Johnson,LIB,380004,1,6,25,32,
Kiowa,President,Hillary Clinton,DEM,380004,7,36,73,116,
Kiowa,U.S. Senate,James Lankford,REP,380004,7,90,269,366,
Kiowa,U.S. Senate,Robert Murphy,LIB,380004,0,1,1,2,
Kiowa,U.S. Senate,Mike Workman,DEM,380004,7,30,63,100,
Kiowa,U.S. Senate,Mark Beard,IND,380004,0,2,3,5,
Kiowa,U.S. Senate,Sean Braddy,IND,380004,0,0,5,5,
Kiowa,U.S. House,Frank Lucas,REP,380004,7,95,271,373,03
Kiowa,U.S. House,Frankie Robbins,DEM,380004,7,28,71,106,03
Kiowa,State House,Todd Russ,REP,380004,6,73,194,273,55
Kiowa,State House,Wayne Walters,DEM,380004,8,51,148,207,55
Kiowa,President,Donald Trump,REP,380005,0,7,34,41,
Kiowa,President,Gary Johnson,LIB,380005,0,0,2,2,
Kiowa,President,Hillary Clinton,DEM,380005,0,3,22,25,
Kiowa,U.S. Senate,James Lankford,REP,380005,0,7,30,37,
Kiowa,U.S. Senate,Robert Murphy,LIB,380005,0,0,2,2,
Kiowa,U.S. Senate,Mike Workman,DEM,380005,0,2,19,21,
Kiowa,U.S. Senate,Mark Beard,IND,380005,0,0,3,3,
Kiowa,U.S. Senate,Sean Braddy,IND,380005,0,1,1,2,
Kiowa,U.S. House,Frank Lucas,REP,380005,0,6,33,39,03
Kiowa,U.S. House,Frankie Robbins,DEM,380005,0,4,23,27,03
Kiowa,State House,Todd Russ,REP,380005,0,6,30,36,55
Kiowa,State House,Wayne Walters,DEM,380005,0,4,26,30,55
Kiowa,President,Donald Trump,REP,380006,4,12,108,124,
Kiowa,President,Gary Johnson,LIB,380006,0,0,1,1,
Kiowa,President,Hillary Clinton,DEM,380006,2,3,31,36,
Kiowa,U.S. Senate,James Lankford,REP,380006,4,13,116,133,
Kiowa,U.S. Senate,Robert Murphy,LIB,380006,0,0,0,0,
Kiowa,U.S. Senate,Mike Workman,DEM,380006,2,1,18,21,
Kiowa,U.S. Senate,Mark Beard,IND,380006,0,0,2,2,
Kiowa,U.S. Senate,Sean Braddy,IND,380006,0,1,5,6,
Kiowa,U.S. House,Frank Lucas,REP,380006,4,12,115,131,03
Kiowa,U.S. House,Frankie Robbins,DEM,380006,2,2,25,29,03
Kiowa,State House,Chris Verser,REP,380006,2,6,38,46,56
Kiowa,State House,David Perryman,DEM,380006,4,8,104,116,56
Kiowa,President,Donald Trump,REP,380007,0,3,11,14,
Kiowa,President,Gary Johnson,LIB,380007,0,0,0,0,
Kiowa,President,Hillary Clinton,DEM,380007,0,0,1,1,
Kiowa,U.S. Senate,James Lankford,REP,380007,0,3,11,14,
Kiowa,U.S. Senate,Robert Murphy,LIB,380007,0,0,0,0,
Kiowa,U.S. Senate,Mike Workman,DEM,380007,0,0,1,1,
Kiowa,U.S. Senate,Mark Beard,IND,380007,0,0,0,0,
Kiowa,U.S. Senate,Sean Braddy,IND,380007,0,0,0,0,
Kiowa,U.S. House,Frank Lucas,REP,380007,0,3,11,14,03
Kiowa,U.S. House,Frankie Robbins,DEM,380007,0,0,1,1,03
Kiowa,State House,Chris Verser,REP,380007,0,3,6,9,56
Kiowa,State House,David Perryman,DEM,380007,0,0,6,6,56
Kiowa,President,Donald Trump,REP,380008,3,13,158,174,
Kiowa,President,Gary Johnson,LIB,380008,1,1,6,8,
Kiowa,President,Hillary Clinton,DEM,380008,4,1,34,39,
Kiowa,U.S. Senate,James Lankford,REP,380008,4,14,157,175,
Kiowa,U.S. Senate,Robert Murphy,LIB,380008,1,0,7,8,
Kiowa,U.S. Senate,Mike Workman,DEM,380008,3,1,34,38,
Kiowa,U.S. Senate,Mark Beard,IND,380008,0,0,0,0,
Kiowa,U.S. Senate,Sean Braddy,IND,380008,0,0,0,0,
Kiowa,U.S. House,Frank Lucas,REP,380008,5,14,168,187,03
Kiowa,U.S. House,Frankie Robbins,DEM,380008,3,1,30,34,03
Kiowa,State House,Todd Russ,REP,380008,4,10,120,134,55
Kiowa,State House,Wayne Walters,DEM,380008,4,5,78,87,55
Kiowa,President,Donald Trump,REP,380009,0,4,22,26,
Kiowa,President,Gary Johnson,LIB,380009,1,0,0,1,
Kiowa,President,Hillary Clinton,DEM,380009,0,0,3,3,
Kiowa,U.S. Senate,James Lankford,REP,380009,0,4,19,23,
Kiowa,U.S. Senate,Robert Murphy,LIB,380009,1,0,0,1,
Kiowa,U.S. Senate,Mike Workman,DEM,380009,0,0,6,6,
Kiowa,U.S. Senate,Mark Beard,IND,380009,0,0,0,0,
Kiowa,U.S. Senate,Sean Braddy,IND,380009,0,0,0,0,
Kiowa,U.S. House,Frank Lucas,REP,380009,1,4,22,27,03
Kiowa,U.S. House,Frankie Robbins,DEM,380009,0,0,3,3,03
Kiowa,State House,Chris Verser,REP,380009,0,1,9,10,56
Kiowa,State House,David Perryman,DEM,380009,1,3,16,20,56
Kiowa,President,Donald Trump,REP,380010,20,16,339,375,
Kiowa,President,Gary Johnson,LIB,380010,1,0,10,11,
Kiowa,President,Hillary Clinton,DEM,380010,7,11,96,114,
Kiowa,U.S. Senate,James Lankford,REP,380010,23,18,340,381,
Kiowa,U.S. Senate,Robert Murphy,LIB,380010,0,0,7,7,
Kiowa,U.S. Senate,Mike Workman,DEM,380010,4,8,88,100,
Kiowa,U.S. Senate,Mark Beard,IND,380010,0,0,4,4,
Kiowa,U.S. Senate,Sean Braddy,IND,380010,0,1,6,7,
Kiowa,U.S. House,Frank Lucas,REP,380010,22,16,362,400,03
Kiowa,U.S. House,Frankie Robbins,DEM,380010,5,10,83,98,03
Kiowa,State House,Chris Verser,REP,380010,15,7,119,141,56
Kiowa,State House,David Perryman,DEM,380010,12,20,327,359,56
Kiowa,President,Donald Trump,REP,380011,7,16,75,98,
Kiowa,President,Gary Johnson,LIB,380011,0,0,6,6,
Kiowa,President,Hillary Clinton,DEM,380011,0,2,6,8,
Kiowa,U.S. Senate,James Lankford,REP,380011,7,13,78,98,
Kiowa,U.S. Senate,Robert Murphy,LIB,380011,0,1,1,2,
Kiowa,U.S. Senate,Mike Workman,DEM,380011,0,2,6,8,
Kiowa,U.S. Senate,Mark Beard,IND,380011,0,0,2,2,
Kiowa,U.S. Senate,Sean Braddy,IND,380011,0,0,0,0,
Kiowa,U.S. House,Frank Lucas,REP,380011,7,14,77,98,03
Kiowa,U.S. House,Frankie Robbins,DEM,380011,0,2,10,12,03
Kiowa,President,Donald Trump,REP,380014,11,6,379,396,
Kiowa,President,Gary Johnson,LIB,380014,0,0,13,13,
Kiowa,President,Hillary Clinton,DEM,380014,8,4,141,153,
Kiowa,U.S. Senate,James Lankford,REP,380014,13,5,384,402,
Kiowa,U.S. Senate,Robert Murphy,LIB,380014,0,0,7,7,
Kiowa,U.S. Senate,Mike Workman,DEM,380014,5,4,128,137,
Kiowa,U.S. Senate,Mark Beard,IND,380014,0,0,6,6,
Kiowa,U.S. Senate,Sean Braddy,IND,380014,1,1,8,10,
Kiowa,U.S. House,Frank Lucas,REP,380014,15,6,391,412,03
Kiowa,U.S. House,Frankie Robbins,DEM,380014,4,4,139,147,03
Kiowa,President,Donald Trump,REP,380015,2,13,109,124,
Kiowa,President,Gary Johnson,LIB,380015,1,0,4,5,
Kiowa,President,Hillary Clinton,DEM,380015,2,3,34,39,
Kiowa,U.S. Senate,James Lankford,REP,380015,3,12,120,135,
Kiowa,U.S. Senate,Robert Murphy,LIB,380015,0,1,0,1,
Kiowa,U.S. Senate,Mike Workman,DEM,380015,1,2,20,23,
Kiowa,U.S. Senate,Mark Beard,IND,380015,1,0,1,2,
Kiowa,U.S. Senate,Sean Braddy,IND,380015,0,1,4,5,
Kiowa,U.S. House,Frank Lucas,REP,380015,3,14,116,133,03
Kiowa,U.S. House,Frankie Robbins,DEM,380015,2,2,28,32,03
Kiowa,State House,Chris Verser,REP,380015,1,6,55,62,56
Kiowa,State House,David Perryman,DEM,380015,4,10,92,106,56
Kiowa,President,Donald Trump,REP,380016,1,8,65,74,
Kiowa,President,Gary Johnson,LIB,380016,0,1,3,4,
Kiowa,President,Hillary Clinton,DEM,380016,1,1,13,15,
Kiowa,U.S. Senate,James Lankford,REP,380016,1,8,64,73,
Kiowa,U.S. Senate,Robert Murphy,LIB,380016,0,0,1,1,
Kiowa,U.S. Senate,Mike Workman,DEM,380016,1,2,14,17,
Kiowa,U.S. Senate,Mark Beard,IND,380016,0,0,1,1,
Kiowa,U.S. Senate,Sean Braddy,IND,380016,0,0,1,1,
Kiowa,U.S. House,Frank Lucas,REP,380016,1,7,64,72,03
Kiowa,U.S. House,Frankie Robbins,DEM,380016,1,2,17,20,03
Kiowa,President,Donald Trump,REP,380022,6,5,128,139,
Kiowa,President,Gary Johnson,LIB,380022,0,0,9,9,
Kiowa,President,Hillary Clinton,DEM,380022,3,1,45,49,
Kiowa,U.S. Senate,James Lankford,REP,380022,6,5,130,141,
Kiowa,U.S. Senate,Robert Murphy,LIB,380022,0,0,7,7,
Kiowa,U.S. Senate,Mike Workman,DEM,380022,3,0,39,42,
Kiowa,U.S. Senate,Mark Beard,IND,380022,0,0,0,0,
Kiowa,U.S. Senate,Sean Braddy,IND,380022,0,1,3,4,
Kiowa,U.S. House,Frank Lucas,REP,380022,6,5,131,142,03
Kiowa,U.S. House,Frankie Robbins,DEM,380022,3,1,47,51,03
Latimer,President,Donald Trump,REP,390001,11,51,256,318,
Latimer,President,Gary Johnson,LIB,390001,0,3,23,26,
Latimer,President,Hillary Clinton,DEM,390001,3,22,79,104,
Latimer,U.S. Senate,James Lankford,REP,390001,10,50,242,302,
Latimer,U.S. Senate,Robert Murphy,LIB,390001,0,1,10,11,
Latimer,U.S. Senate,Mike Workman,DEM,390001,3,21,84,108,
Latimer,U.S. Senate,Mark Beard,IND,390001,0,1,6,7,
Latimer,U.S. Senate,Sean Braddy,IND,390001,1,4,11,16,
Latimer,U.S. House,Markwayne Mullin,REP,390001,11,54,242,307,02
Latimer,U.S. House,Joshua Harris-Till,DEM,390001,3,18,83,104,02
Latimer,U.S. House,John Mccarthy,IND,390001,0,5,29,34,02
Latimer,State Senate,Larry Boggs,REP,390001,10,45,225,280,7
Latimer,State Senate,Joel Kerns,DEM,390001,4,32,133,169,7
Latimer,State House,Paul Marean,REP,390001,7,26,140,173,17
Latimer,State House,Brian Renegar,DEM,390001,7,50,213,270,17
Latimer,President,Donald Trump,REP,390002,13,38,298,349,
Latimer,President,Gary Johnson,LIB,390002,0,3,22,25,
Latimer,President,Hillary Clinton,DEM,390002,9,34,87,130,
Latimer,U.S. Senate,James Lankford,REP,390002,16,39,262,317,
Latimer,U.S. Senate,Robert Murphy,LIB,390002,2,3,10,15,
Latimer,U.S. Senate,Mike Workman,DEM,390002,4,31,113,148,
Latimer,U.S. Senate,Mark Beard,IND,390002,0,0,7,7,
Latimer,U.S. Senate,Sean Braddy,IND,390002,0,1,11,12,
Latimer,U.S. House,Markwayne Mullin,REP,390002,16,44,282,342,02
Latimer,U.S. House,Joshua Harris-Till,DEM,390002,4,28,94,126,02
Latimer,U.S. House,John Mccarthy,IND,390002,2,2,30,34,02
Latimer,State Senate,Larry Boggs,REP,390002,18,28,244,290,7
Latimer,State Senate,Joel Kerns,DEM,390002,5,48,161,214,7
Latimer,State House,Paul Marean,REP,390002,10,18,156,184,17
Latimer,State House,Brian Renegar,DEM,390002,11,56,247,314,17
Latimer,President,Donald Trump,REP,390003,5,52,164,221,
Latimer,President,Gary Johnson,LIB,390003,0,1,9,10,
Latimer,President,Hillary Clinton,DEM,390003,0,11,19,30,
Latimer,U.S. Senate,James Lankford,REP,390003,5,54,157,216,
Latimer,U.S. Senate,Robert Murphy,LIB,390003,0,0,2,2,
Latimer,U.S. Senate,Mike Workman,DEM,390003,0,12,24,36,
Latimer,U.S. Senate,Mark Beard,IND,390003,0,1,4,5,
Latimer,U.S. Senate,Sean Braddy,IND,390003,0,0,2,2,
Latimer,U.S. House,Markwayne Mullin,REP,390003,5,54,161,220,02
Latimer,U.S. House,Joshua Harris-Till,DEM,390003,0,12,24,36,02
Latimer,U.S. House,John Mccarthy,IND,390003,0,1,6,7,02
Latimer,State Senate,Larry Boggs,REP,390003,5,44,124,173,7
Latimer,State Senate,Joel Kerns,DEM,390003,0,23,68,91,7
Latimer,State House,Paul Marean,REP,390003,4,21,88,113,17
Latimer,State House,Brian Renegar,DEM,390003,1,43,103,147,17
Latimer,President,Donald Trump,REP,390004,9,26,126,161,
Latimer,President,Gary Johnson,LIB,390004,1,2,5,8,
Latimer,President,Hillary Clinton,DEM,390004,3,9,49,61,
Latimer,U.S. Senate,James Lankford,REP,390004,9,28,120,157,
Latimer,U.S. Senate,Robert Murphy,LIB,390004,0,0,4,4,
Latimer,U.S. Senate,Mike Workman,DEM,390004,4,9,46,59,
Latimer,U.S. Senate,Mark Beard,IND,390004,0,0,5,5,
Latimer,U.S. Senate,Sean Braddy,IND,390004,0,0,4,4,
Latimer,U.S. House,Markwayne Mullin,REP,390004,10,28,132,170,02
Latimer,U.S. House,Joshua Harris-Till,DEM,390004,3,9,37,49,02
Latimer,U.S. House,John Mccarthy,IND,390004,0,0,10,10,02
Latimer,State Senate,Larry Boggs,REP,390004,9,24,114,147,7
Latimer,State Senate,Joel Kerns,DEM,390004,4,13,66,83,7
Latimer,State House,Paul Marean,REP,390004,6,15,67,88,17
Latimer,State House,Brian Renegar,DEM,390004,7,22,111,140,17
Latimer,President,Donald Trump,REP,390005,7,51,285,343,
Latimer,President,Gary Johnson,LIB,390005,1,0,13,14,
Latimer,President,Hillary Clinton,DEM,390005,1,16,57,74,
Latimer,U.S. Senate,James Lankford,REP,390005,7,46,249,302,
Latimer,U.S. Senate,Robert Murphy,LIB,390005,1,2,5,8,
Latimer,U.S. Senate,Mike Workman,DEM,390005,1,17,80,98,
Latimer,U.S. Senate,Mark Beard,IND,390005,0,1,12,13,
Latimer,U.S. Senate,Sean Braddy,IND,390005,0,1,4,5,
Latimer,U.S. House,Markwayne Mullin,REP,390005,7,45,267,319,02
Latimer,U.S. House,Joshua Harris-Till,DEM,390005,1,17,67,85,02
Latimer,U.S. House,John Mccarthy,IND,390005,1,5,15,21,02
Latimer,State Senate,Larry Boggs,REP,390005,7,44,213,264,7
Latimer,State Senate,Joel Kerns,DEM,390005,1,23,138,162,7
Latimer,State House,Paul Marean,REP,390005,2,29,134,165,17
Latimer,State House,Brian Renegar,DEM,390005,6,38,214,258,17
Latimer,President,Donald Trump,REP,390006,1,13,105,119,
Latimer,President,Gary Johnson,LIB,390006,0,0,5,5,
Latimer,President,Hillary Clinton,DEM,390006,2,2,19,23,
Latimer,U.S. Senate,James Lankford,REP,390006,1,13,94,108,
Latimer,U.S. Senate,Robert Murphy,LIB,390006,0,0,2,2,
Latimer,U.S. Senate,Mike Workman,DEM,390006,2,2,30,34,
Latimer,U.S. Senate,Mark Beard,IND,390006,0,0,1,1,
Latimer,U.S. Senate,Sean Braddy,IND,390006,0,0,3,3,
Latimer,U.S. House,Markwayne Mullin,REP,390006,1,12,99,112,02
Latimer,U.S. House,Joshua Harris-Till,DEM,390006,2,3,23,28,02
Latimer,U.S. House,John Mccarthy,IND,390006,0,0,7,7,02
Latimer,State Senate,Larry Boggs,REP,390006,1,12,74,87,7
Latimer,State Senate,Joel Kerns,DEM,390006,2,3,57,62,7
Latimer,State House,Paul Marean,REP,390006,1,11,62,74,17
Latimer,State House,Brian Renegar,DEM,390006,2,4,68,74,17
Latimer,President,Donald Trump,REP,390007,6,23,115,144,
Latimer,President,Gary Johnson,LIB,390007,0,1,4,5,
Latimer,President,Hillary Clinton,DEM,390007,2,1,27,30,
Latimer,U.S. Senate,James Lankford,REP,390007,5,22,106,133,
Latimer,U.S. Senate,Robert Murphy,LIB,390007,0,0,5,5,
Latimer,U.S. Senate,Mike Workman,DEM,390007,2,2,28,32,
Latimer,U.S. Senate,Mark Beard,IND,390007,1,1,3,5,
Latimer,U.S. Senate,Sean Braddy,IND,390007,0,0,4,4,
Latimer,U.S. House,Markwayne Mullin,REP,390007,5,19,110,134,02
Latimer,U.S. House,Joshua Harris-Till,DEM,390007,2,5,26,33,02
Latimer,U.S. House,John Mccarthy,IND,390007,1,1,10,12,02
Latimer,State Senate,Larry Boggs,REP,390007,6,21,105,132,7
Latimer,State Senate,Joel Kerns,DEM,390007,2,4,43,49,7
Latimer,State House,Paul Marean,REP,390007,4,12,74,90,17
Latimer,State House,Brian Renegar,DEM,390007,4,13,68,85,17
Latimer,President,Donald Trump,REP,390008,17,15,279,311,
Latimer,President,Gary Johnson,LIB,390008,0,0,14,14,
Latimer,President,Hillary Clinton,DEM,390008,2,3,46,51,
Latimer,U.S. Senate,James Lankford,REP,390008,14,14,242,270,
Latimer,U.S. Senate,Robert Murphy,LIB,390008,0,0,9,9,
Latimer,U.S. Senate,Mike Workman,DEM,390008,2,4,76,82,
Latimer,U.S. Senate,Mark Beard,IND,390008,0,0,2,2,
Latimer,U.S. Senate,Sean Braddy,IND,390008,0,0,4,4,
Latimer,U.S. House,Markwayne Mullin,REP,390008,14,14,251,279,02
Latimer,U.S. House,Joshua Harris-Till,DEM,390008,2,4,74,80,02
Latimer,U.S. House,John Mccarthy,IND,390008,0,0,9,9,02
Latimer,State Senate,Larry Boggs,REP,390008,12,14,195,221,7
Latimer,State Senate,Joel Kerns,DEM,390008,4,3,142,149,7
Latimer,State House,Paul Marean,REP,390008,9,10,150,169,17
Latimer,State House,Brian Renegar,DEM,390008,8,8,185,201,17
Latimer,President,Donald Trump,REP,390009,6,12,220,238,
Latimer,President,Gary Johnson,LIB,390009,1,2,8,11,
Latimer,President,Hillary Clinton,DEM,390009,8,5,52,65,
Latimer,U.S. Senate,James Lankford,REP,390009,7,11,196,214,
Latimer,U.S. Senate,Robert Murphy,LIB,390009,1,0,4,5,
Latimer,U.S. Senate,Mike Workman,DEM,390009,7,7,63,77,
Latimer,U.S. Senate,Mark Beard,IND,390009,0,0,9,9,
Latimer,U.S. Senate,Sean Braddy,IND,390009,0,0,4,4,
Latimer,U.S. House,Markwayne Mullin,REP,390009,6,9,197,212,02
Latimer,U.S. House,Joshua Harris-Till,DEM,390009,9,9,64,82,02
Latimer,U.S. House,John Mccarthy,IND,390009,0,0,15,15,02
Latimer,State Senate,Larry Boggs,REP,390009,5,10,167,182,7
Latimer,State Senate,Joel Kerns,DEM,390009,10,8,109,127,7
Latimer,State House,Paul Marean,REP,390009,4,6,154,164,17
Latimer,State House,Brian Renegar,DEM,390009,11,12,121,144,17
Latimer,President,Donald Trump,REP,390010,4,42,193,239,
Latimer,President,Gary Johnson,LIB,390010,4,0,5,9,
Latimer,President,Hillary Clinton,DEM,390010,5,6,40,51,
Latimer,U.S. Senate,James Lankford,REP,390010,5,36,186,227,
Latimer,U.S. Senate,Robert Murphy,LIB,390010,1,0,0,1,
Latimer,U.S. Senate,Mike Workman,DEM,390010,7,9,49,65,
Latimer,U.S. Senate,Mark Beard,IND,390010,0,0,1,1,
Latimer,U.S. Senate,Sean Braddy,IND,390010,0,1,3,4,
Latimer,U.S. House,Markwayne Mullin,REP,390010,4,35,186,225,02
Latimer,U.S. House,Joshua Harris-Till,DEM,390010,8,10,44,62,02
Latimer,U.S. House,John Mccarthy,IND,390010,1,1,4,6,02
Latimer,State Senate,Larry Boggs,REP,390010,4,34,147,185,7
Latimer,State Senate,Joel Kerns,DEM,390010,9,13,91,113,7
Latimer,State House,Paul Marean,REP,390010,3,22,108,133,17
Latimer,State House,Brian Renegar,DEM,390010,10,24,128,162,17
Latimer,President,Donald Trump,REP,390011,18,33,447,498,
Latimer,President,Gary Johnson,LIB,390011,1,2,21,24,
Latimer,President,Hillary Clinton,DEM,390011,11,7,126,144,
Latimer,U.S. Senate,James Lankford,REP,390011,15,31,366,412,
Latimer,U.S. Senate,Robert Murphy,LIB,390011,0,0,15,15,
Latimer,U.S. Senate,Mike Workman,DEM,390011,15,11,164,190,
Latimer,U.S. Senate,Mark Beard,IND,390011,0,0,7,7,
Latimer,U.S. Senate,Sean Braddy,IND,390011,0,0,16,16,
Latimer,U.S. House,Markwayne Mullin,REP,390011,17,33,365,415,02
Latimer,U.S. House,Joshua Harris-Till,DEM,390011,13,7,154,174,02
Latimer,U.S. House,John Mccarthy,IND,390011,1,1,47,49,02
Latimer,State Senate,Larry Boggs,REP,390011,16,29,341,386,7
Latimer,State Senate,Joel Kerns,DEM,390011,16,13,245,274,7
Latimer,State House,Paul Marean,REP,390011,8,15,253,276,17
Latimer,State House,Brian Renegar,DEM,390011,24,26,317,367,17
Latimer,President,Donald Trump,REP,390012,11,17,131,159,
Latimer,President,Gary Johnson,LIB,390012,1,0,7,8,
Latimer,President,Hillary Clinton,DEM,390012,4,1,29,34,
Latimer,U.S. Senate,James Lankford,REP,390012,11,15,119,145,
Latimer,U.S. Senate,Robert Murphy,LIB,390012,0,0,3,3,
Latimer,U.S. Senate,Mike Workman,DEM,390012,5,0,32,37,
Latimer,U.S. Senate,Mark Beard,IND,390012,0,1,3,4,
Latimer,U.S. Senate,Sean Braddy,IND,390012,0,1,7,8,
Latimer,U.S. House,Markwayne Mullin,REP,390012,10,13,122,145,02
Latimer,U.S. House,Joshua Harris-Till,DEM,390012,5,1,29,35,02
Latimer,U.S. House,John Mccarthy,IND,390012,0,3,17,20,02
Latimer,State Senate,Larry Boggs,REP,390012,7,14,115,136,7
Latimer,State Senate,Joel Kerns,DEM,390012,9,3,53,65,7
Latimer,State House,Paul Marean,REP,390012,3,13,76,92,17
Latimer,State House,Brian Renegar,DEM,390012,13,4,86,103,17
Leflore,President,Donald Trump,REP,400101,12,19,253,284,
Leflore,President,Gary Johnson,LIB,400101,0,0,14,14,
Leflore,President,Hillary Clinton,DEM,400101,2,6,56,64,
Leflore,U.S. Senate,James Lankford,REP,400101,12,15,226,253,
Leflore,U.S. Senate,Robert Murphy,LIB,400101,0,1,8,9,
Leflore,U.S. Senate,Mike Workman,DEM,400101,2,10,69,81,
Leflore,U.S. Senate,Mark Beard,IND,400101,0,0,10,10,
Leflore,U.S. Senate,Sean Braddy,IND,400101,0,0,9,9,
Leflore,U.S. House,Markwayne Mullin,REP,400101,11,16,227,254,02
Leflore,U.S. House,Joshua Harris-Till,DEM,400101,3,9,69,81,02
Leflore,U.S. House,John Mccarthy,IND,400101,0,1,23,24,02
Leflore,State House,Don Herrold,REP,400101,10,14,152,176,15
Leflore,State House,Ed Cannaday,DEM,400101,4,12,166,182,15
Leflore,President,Donald Trump,REP,400102,15,26,344,385,
Leflore,President,Gary Johnson,LIB,400102,0,1,9,10,
Leflore,President,Hillary Clinton,DEM,400102,0,5,70,75,
Leflore,U.S. Senate,James Lankford,REP,400102,15,22,301,338,
Leflore,U.S. Senate,Robert Murphy,LIB,400102,0,0,5,5,
Leflore,U.S. Senate,Mike Workman,DEM,400102,0,10,94,104,
Leflore,U.S. Senate,Mark Beard,IND,400102,1,0,3,4,
Leflore,U.S. Senate,Sean Braddy,IND,400102,0,0,10,10,
Leflore,U.S. House,Markwayne Mullin,REP,400102,15,25,313,353,02
Leflore,U.S. House,Joshua Harris-Till,DEM,400102,0,6,81,87,02
Leflore,U.S. House,John Mccarthy,IND,400102,1,1,20,22,02
Leflore,State House,Rick West,REP,400102,13,25,307,345,3
Leflore,State House,Troy Dyer,DEM,400102,2,7,93,102,3
Leflore,State House,Dewey Harrison,IND,400102,0,0,21,21,3
Leflore,President,Donald Trump,REP,400103,20,49,431,500,
Leflore,President,Gary Johnson,LIB,400103,1,0,15,16,
Leflore,President,Hillary Clinton,DEM,400103,4,10,96,110,
Leflore,U.S. Senate,James Lankford,REP,400103,22,44,388,454,
Leflore,U.S. Senate,Robert Murphy,LIB,400103,0,0,12,12,
Leflore,U.S. Senate,Mike Workman,DEM,400103,5,12,116,133,
Leflore,U.S. Senate,Mark Beard,IND,400103,0,0,8,8,
Leflore,U.S. Senate,Sean Braddy,IND,400103,0,1,13,14,
Leflore,U.S. House,Markwayne Mullin,REP,400103,21,43,378,442,02
Leflore,U.S. House,Joshua Harris-Till,DEM,400103,5,11,111,127,02
Leflore,U.S. House,John Mccarthy,IND,400103,1,1,44,46,02
Leflore,State House,Rick West,REP,400103,16,44,381,441,3
Leflore,State House,Troy Dyer,DEM,400103,9,8,131,148,3
Leflore,State House,Dewey Harrison,IND,400103,2,5,27,34,3
Leflore,President,Donald Trump,REP,400104,1,2,54,57,
Leflore,President,Gary Johnson,LIB,400104,0,0,4,4,
Leflore,President,Hillary Clinton,DEM,400104,14,6,118,138,
Leflore,U.S. Senate,James Lankford,REP,400104,1,2,45,48,
Leflore,U.S. Senate,Robert Murphy,LIB,400104,0,0,4,4,
Leflore,U.S. Senate,Mike Workman,DEM,400104,14,6,120,140,
Leflore,U.S. Senate,Mark Beard,IND,400104,0,0,3,3,
Leflore,U.S. Senate,Sean Braddy,IND,400104,0,0,3,3,
Leflore,U.S. House,Markwayne Mullin,REP,400104,1,2,44,47,02
Leflore,U.S. House,Joshua Harris-Till,DEM,400104,14,6,122,142,02
Leflore,U.S. House,John Mccarthy,IND,400104,0,0,6,6,02
Leflore,State House,Rick West,REP,400104,1,2,44,47,3
Leflore,State House,Troy Dyer,DEM,400104,14,6,124,144,3
Leflore,State House,Dewey Harrison,IND,400104,0,0,6,6,3
Leflore,President,Donald Trump,REP,400105,9,33,526,568,
Leflore,President,Gary Johnson,LIB,400105,0,1,16,17,
Leflore,President,Hillary Clinton,DEM,400105,4,12,118,134,
Leflore,U.S. Senate,James Lankford,REP,400105,9,33,471,513,
Leflore,U.S. Senate,Robert Murphy,LIB,400105,0,0,14,14,
Leflore,U.S. Senate,Mike Workman,DEM,400105,4,12,122,138,
Leflore,U.S. Senate,Mark Beard,IND,400105,0,0,16,16,
Leflore,U.S. Senate,Sean Braddy,IND,400105,0,0,18,18,
Leflore,U.S. House,Markwayne Mullin,REP,400105,9,33,466,508,02
Leflore,U.S. House,Joshua Harris-Till,DEM,400105,4,11,122,137,02
Leflore,U.S. House,John Mccarthy,IND,400105,0,2,49,51,02
Leflore,State House,Rick West,REP,400105,9,32,480,521,3
Leflore,State House,Troy Dyer,DEM,400105,4,13,137,154,3
Leflore,State House,Dewey Harrison,IND,400105,0,1,31,32,3
Leflore,President,Donald Trump,REP,400106,9,38,446,493,
Leflore,President,Gary Johnson,LIB,400106,0,1,24,25,
Leflore,President,Hillary Clinton,DEM,400106,3,9,110,122,
Leflore,U.S. Senate,James Lankford,REP,400106,8,36,396,440,
Leflore,U.S. Senate,Robert Murphy,LIB,400106,0,0,18,18,
Leflore,U.S. Senate,Mike Workman,DEM,400106,3,8,123,134,
Leflore,U.S. Senate,Mark Beard,IND,400106,0,2,19,21,
Leflore,U.S. Senate,Sean Braddy,IND,400106,0,1,11,12,
Leflore,U.S. House,Markwayne Mullin,REP,400106,7,32,390,429,02
Leflore,U.S. House,Joshua Harris-Till,DEM,400106,3,8,126,137,02
Leflore,U.S. House,John Mccarthy,IND,400106,1,7,49,57,02
Leflore,State House,Rick West,REP,400106,5,32,379,416,3
Leflore,State House,Troy Dyer,DEM,400106,4,11,128,143,3
Leflore,State House,Dewey Harrison,IND,400106,1,5,64,70,3
Leflore,President,Donald Trump,REP,400107,11,60,655,726,
Leflore,President,Gary Johnson,LIB,400107,2,0,33,35,
Leflore,President,Hillary Clinton,DEM,400107,13,10,126,149,
Leflore,U.S. Senate,James Lankford,REP,400107,8,58,588,654,
Leflore,U.S. Senate,Robert Murphy,LIB,400107,1,0,22,23,
Leflore,U.S. Senate,Mike Workman,DEM,400107,9,9,150,168,
Leflore,U.S. Senate,Mark Beard,IND,400107,1,3,22,26,
Leflore,U.S. Senate,Sean Braddy,IND,400107,2,0,20,22,
Leflore,U.S. House,Markwayne Mullin,REP,400107,7,57,590,654,02
Leflore,U.S. House,Joshua Harris-Till,DEM,400107,11,9,147,167,02
Leflore,U.S. House,John Mccarthy,IND,400107,3,4,57,64,02
Leflore,State House,Rick West,REP,400107,10,58,564,632,3
Leflore,State House,Troy Dyer,DEM,400107,7,8,154,169,3
Leflore,State House,Dewey Harrison,IND,400107,3,3,95,101,3
Leflore,President,Donald Trump,REP,400108,12,12,320,344,
Leflore,President,Gary Johnson,LIB,400108,0,2,10,12,
Leflore,President,Hillary Clinton,DEM,400108,6,1,76,83,
Leflore,U.S. Senate,James Lankford,REP,400108,11,10,291,312,
Leflore,U.S. Senate,Robert Murphy,LIB,400108,0,1,7,8,
Leflore,U.S. Senate,Mike Workman,DEM,400108,5,1,76,82,
Leflore,U.S. Senate,Mark Beard,IND,400108,0,2,13,15,
Leflore,U.S. Senate,Sean Braddy,IND,400108,1,1,14,16,
Leflore,U.S. House,Markwayne Mullin,REP,400108,10,11,291,312,02
Leflore,U.S. House,Joshua Harris-Till,DEM,400108,6,2,75,83,02
Leflore,U.S. House,John Mccarthy,IND,400108,2,2,34,38,02
Leflore,State House,Rick West,REP,400108,10,14,301,325,3
Leflore,State House,Troy Dyer,DEM,400108,7,1,73,81,3
Leflore,State House,Dewey Harrison,IND,400108,1,0,27,28,3
Leflore,President,Donald Trump,REP,400109,18,94,511,623,
Leflore,President,Gary Johnson,LIB,400109,0,7,22,29,
Leflore,President,Hillary Clinton,DEM,400109,5,25,109,139,
Leflore,U.S. Senate,James Lankford,REP,400109,18,78,428,524,
Leflore,U.S. Senate,Robert Murphy,LIB,400109,0,3,20,23,
Leflore,U.S. Senate,Mike Workman,DEM,400109,4,32,149,185,
Leflore,U.S. Senate,Mark Beard,IND,400109,0,8,25,33,
Leflore,U.S. Senate,Sean Braddy,IND,400109,1,3,12,16,
Leflore,U.S. House,Markwayne Mullin,REP,400109,18,77,445,540,02
Leflore,U.S. House,Joshua Harris-Till,DEM,400109,5,36,138,179,02
Leflore,U.S. House,John Mccarthy,IND,400109,0,12,47,59,02
Leflore,State House,Rick West,REP,400109,18,78,417,513,3
Leflore,State House,Troy Dyer,DEM,400109,3,37,148,188,3
Leflore,State House,Dewey Harrison,IND,400109,1,12,77,90,3
Leflore,President,Donald Trump,REP,400110,4,48,447,499,
Leflore,President,Gary Johnson,LIB,400110,4,4,14,22,
Leflore,President,Hillary Clinton,DEM,400110,6,8,100,114,
Leflore,U.S. Senate,James Lankford,REP,400110,4,39,340,383,
Leflore,U.S. Senate,Robert Murphy,LIB,400110,1,1,16,18,
Leflore,U.S. Senate,Mike Workman,DEM,400110,8,17,153,178,
Leflore,U.S. Senate,Mark Beard,IND,400110,0,1,18,19,
Leflore,U.S. Senate,Sean Braddy,IND,400110,0,1,19,20,
Leflore,U.S. House,Markwayne Mullin,REP,400110,6,41,357,404,02
Leflore,U.S. House,Joshua Harris-Till,DEM,400110,6,16,140,162,02
Leflore,U.S. House,John Mccarthy,IND,400110,1,3,50,54,02
Leflore,State House,Don Herrold,REP,400110,2,35,266,303,15
Leflore,State House,Ed Cannaday,DEM,400110,12,23,280,315,15
Leflore,President,Donald Trump,REP,400111,18,97,469,584,
Leflore,President,Gary Johnson,LIB,400111,3,0,20,23,
Leflore,President,Hillary Clinton,DEM,400111,0,7,90,97,
Leflore,U.S. Senate,James Lankford,REP,400111,18,90,394,502,
Leflore,U.S. Senate,Robert Murphy,LIB,400111,1,2,10,13,
Leflore,U.S. Senate,Mike Workman,DEM,400111,2,7,127,136,
Leflore,U.S. Senate,Mark Beard,IND,400111,1,3,14,18,
Leflore,U.S. Senate,Sean Braddy,IND,400111,0,2,23,25,
Leflore,U.S. House,Markwayne Mullin,REP,400111,18,89,392,499,02
Leflore,U.S. House,Joshua Harris-Till,DEM,400111,2,8,126,136,02
Leflore,U.S. House,John Mccarthy,IND,400111,2,6,51,59,02
Leflore,State House,Don Herrold,REP,400111,16,74,309,399,15
Leflore,State House,Ed Cannaday,DEM,400111,6,30,247,283,15
Leflore,President,Donald Trump,REP,400112,5,10,108,123,
Leflore,President,Gary Johnson,LIB,400112,0,0,10,10,
Leflore,President,Hillary Clinton,DEM,400112,0,2,32,34,
Leflore,U.S. Senate,James Lankford,REP,400112,3,10,82,95,
Leflore,U.S. Senate,Robert Murphy,LIB,400112,0,0,6,6,
Leflore,U.S. Senate,Mike Workman,DEM,400112,0,2,51,53,
Leflore,U.S. Senate,Mark Beard,IND,400112,0,0,6,6,
Leflore,U.S. Senate,Sean Braddy,IND,400112,0,0,1,1,
Leflore,U.S. House,Markwayne Mullin,REP,400112,3,9,85,97,02
Leflore,U.S. House,Joshua Harris-Till,DEM,400112,0,2,47,49,02
Leflore,U.S. House,John Mccarthy,IND,400112,0,1,12,13,02
Leflore,State House,Don Herrold,REP,400112,2,7,62,71,15
Leflore,State House,Ed Cannaday,DEM,400112,1,5,83,89,15
Leflore,President,Donald Trump,REP,400113,11,25,247,283,
Leflore,President,Gary Johnson,LIB,400113,1,1,7,9,
Leflore,President,Hillary Clinton,DEM,400113,3,11,33,47,
Leflore,U.S. Senate,James Lankford,REP,400113,7,24,209,240,
Leflore,U.S. Senate,Robert Murphy,LIB,400113,3,0,7,10,
Leflore,U.S. Senate,Mike Workman,DEM,400113,3,11,49,63,
Leflore,U.S. Senate,Mark Beard,IND,400113,2,1,8,11,
Leflore,U.S. Senate,Sean Braddy,IND,400113,0,0,12,12,
Leflore,U.S. House,Markwayne Mullin,REP,400113,11,23,208,242,02
Leflore,U.S. House,Joshua Harris-Till,DEM,400113,2,11,56,69,02
Leflore,U.S. House,John Mccarthy,IND,400113,1,2,19,22,02
Leflore,State House,Don Herrold,REP,400113,11,17,155,183,15
Leflore,State House,Ed Cannaday,DEM,400113,4,19,127,150,15
Leflore,President,Donald Trump,REP,400114,5,12,121,138,
Leflore,President,Gary Johnson,LIB,400114,0,0,4,4,
Leflore,President,Hillary Clinton,DEM,400114,0,4,37,41,
Leflore,U.S. Senate,James Lankford,REP,400114,5,9,89,103,
Leflore,U.S. Senate,Robert Murphy,LIB,400114,0,1,2,3,
Leflore,U.S. Senate,Mike Workman,DEM,400114,0,3,49,52,
Leflore,U.S. Senate,Mark Beard,IND,400114,0,1,9,10,
Leflore,U.S. Senate,Sean Braddy,IND,400114,0,0,6,6,
Leflore,U.S. House,Markwayne Mullin,REP,400114,5,8,86,99,02
Leflore,U.S. House,Joshua Harris-Till,DEM,400114,0,4,52,56,02
Leflore,U.S. House,John Mccarthy,IND,400114,0,3,17,20,02
Leflore,State House,Don Herrold,REP,400114,3,4,61,68,15
Leflore,State House,Ed Cannaday,DEM,400114,2,11,97,110,15
Leflore,President,Donald Trump,REP,400201,0,7,75,82,
Leflore,President,Gary Johnson,LIB,400201,0,0,3,3,
Leflore,President,Hillary Clinton,DEM,400201,0,3,17,20,
Leflore,U.S. Senate,James Lankford,REP,400201,0,7,65,72,
Leflore,U.S. Senate,Robert Murphy,LIB,400201,0,0,4,4,
Leflore,U.S. Senate,Mike Workman,DEM,400201,0,3,22,25,
Leflore,U.S. Senate,Mark Beard,IND,400201,0,0,2,2,
Leflore,U.S. Senate,Sean Braddy,IND,400201,0,0,0,0,
Leflore,U.S. House,Markwayne Mullin,REP,400201,0,7,69,76,02
Leflore,U.S. House,Joshua Harris-Till,DEM,400201,0,3,22,25,02
Leflore,U.S. House,John Mccarthy,IND,400201,0,0,1,1,02
Leflore,State House,Don Herrold,REP,400201,0,6,52,58,15
Leflore,State House,Ed Cannaday,DEM,400201,0,4,41,45,15
Leflore,President,Donald Trump,REP,400202,9,18,110,137,
Leflore,President,Gary Johnson,LIB,400202,0,0,7,7,
Leflore,President,Hillary Clinton,DEM,400202,2,4,32,38,
Leflore,U.S. Senate,James Lankford,REP,400202,9,18,95,122,
Leflore,U.S. Senate,Robert Murphy,LIB,400202,0,0,2,2,
Leflore,U.S. Senate,Mike Workman,DEM,400202,2,4,45,51,
Leflore,U.S. Senate,Mark Beard,IND,400202,0,0,4,4,
Leflore,U.S. Senate,Sean Braddy,IND,400202,0,0,3,3,
Leflore,U.S. House,Markwayne Mullin,REP,400202,9,15,97,121,02
Leflore,U.S. House,Joshua Harris-Till,DEM,400202,2,4,41,47,02
Leflore,U.S. House,John Mccarthy,IND,400202,0,3,11,14,02
Leflore,State Senate,Joseph Silk,REP,400202,7,18,91,116,5
Leflore,State Senate,Stacey Allen Ebert,DEM,400202,4,4,56,64,5
Leflore,State House,Rick West,REP,400202,6,17,80,103,3
Leflore,State House,Troy Dyer,DEM,400202,2,3,54,59,3
Leflore,State House,Dewey Harrison,IND,400202,3,2,13,18,3
Leflore,President,Donald Trump,REP,400203,32,310,673,1015,
Leflore,President,Gary Johnson,LIB,400203,3,9,40,52,
Leflore,President,Hillary Clinton,DEM,400203,21,82,188,291,
Leflore,U.S. Senate,James Lankford,REP,400203,33,277,600,910,
Leflore,U.S. Senate,Robert Murphy,LIB,400203,0,5,22,27,
Leflore,U.S. Senate,Mike Workman,DEM,400203,17,93,211,321,
Leflore,U.S. Senate,Mark Beard,IND,400203,1,11,23,35,
Leflore,U.S. Senate,Sean Braddy,IND,400203,1,3,22,26,
Leflore,U.S. House,Markwayne Mullin,REP,400203,33,281,616,930,02
Leflore,U.S. House,Joshua Harris-Till,DEM,400203,19,94,206,319,02
Leflore,U.S. House,John Mccarthy,IND,400203,2,18,58,78,02
Leflore,State House,Rick West,REP,400203,26,253,501,780,3
Leflore,State House,Troy Dyer,DEM,400203,17,103,249,369,3
Leflore,State House,Dewey Harrison,IND,400203,11,41,151,203,3
Leflore,President,Donald Trump,REP,400204,15,128,423,566,
Leflore,President,Gary Johnson,LIB,400204,1,4,38,43,
Leflore,President,Hillary Clinton,DEM,400204,2,43,134,179,
Leflore,U.S. Senate,James Lankford,REP,400204,15,121,390,526,
Leflore,U.S. Senate,Robert Murphy,LIB,400204,0,1,14,15,
Leflore,U.S. Senate,Mike Workman,DEM,400204,4,46,152,202,
Leflore,U.S. Senate,Mark Beard,IND,400204,0,1,19,20,
Leflore,U.S. Senate,Sean Braddy,IND,400204,0,3,12,15,
Leflore,U.S. House,Markwayne Mullin,REP,400204,15,117,394,526,02
Leflore,U.S. House,Joshua Harris-Till,DEM,400204,3,48,149,200,02
Leflore,U.S. House,John Mccarthy,IND,400204,1,5,46,52,02
Leflore,State House,Rick West,REP,400204,16,100,326,442,3
Leflore,State House,Troy Dyer,DEM,400204,2,55,173,230,3
Leflore,State House,Dewey Harrison,IND,400204,1,19,96,116,3
Leflore,President,Donald Trump,REP,400205,10,74,163,247,
Leflore,President,Gary Johnson,LIB,400205,2,1,15,18,
Leflore,President,Hillary Clinton,DEM,400205,5,21,43,69,
Leflore,U.S. Senate,James Lankford,REP,400205,10,71,134,215,
Leflore,U.S. Senate,Robert Murphy,LIB,400205,1,2,13,16,
Leflore,U.S. Senate,Mike Workman,DEM,400205,5,23,59,87,
Leflore,U.S. Senate,Mark Beard,IND,400205,0,0,6,6,
Leflore,U.S. Senate,Sean Braddy,IND,400205,1,0,3,4,
Leflore,U.S. House,Markwayne Mullin,REP,400205,10,71,145,226,02
Leflore,U.S. House,Joshua Harris-Till,DEM,400205,5,20,54,79,02
Leflore,U.S. House,John Mccarthy,IND,400205,2,4,16,22,02
Leflore,State House,Rick West,REP,400205,5,59,117,181,3
Leflore,State House,Troy Dyer,DEM,400205,4,25,69,98,3
Leflore,State House,Dewey Harrison,IND,400205,8,12,37,57,3
Leflore,President,Donald Trump,REP,400207,11,115,405,531,
Leflore,President,Gary Johnson,LIB,400207,1,4,26,31,
Leflore,President,Hillary Clinton,DEM,400207,1,31,90,122,
Leflore,U.S. Senate,James Lankford,REP,400207,11,108,355,474,
Leflore,U.S. Senate,Robert Murphy,LIB,400207,1,2,7,10,
Leflore,U.S. Senate,Mike Workman,DEM,400207,1,26,106,133,
Leflore,U.S. Senate,Mark Beard,IND,400207,0,6,24,30,
Leflore,U.S. Senate,Sean Braddy,IND,400207,0,2,17,19,
Leflore,U.S. House,Markwayne Mullin,REP,400207,11,103,354,468,02
Leflore,U.S. House,Joshua Harris-Till,DEM,400207,1,24,112,137,02
Leflore,U.S. House,John Mccarthy,IND,400207,1,17,43,61,02
Leflore,State House,Rick West,REP,400207,11,81,273,365,3
Leflore,State House,Troy Dyer,DEM,400207,0,36,126,162,3
Leflore,State House,Dewey Harrison,IND,400207,2,35,120,157,3
Leflore,President,Donald Trump,REP,400208,18,104,378,500,
Leflore,President,Gary Johnson,LIB,400208,4,2,33,39,
Leflore,President,Hillary Clinton,DEM,400208,7,32,131,170,
Leflore,U.S. Senate,James Lankford,REP,400208,19,89,344,452,
Leflore,U.S. Senate,Robert Murphy,LIB,400208,3,5,17,25,
Leflore,U.S. Senate,Mike Workman,DEM,400208,5,35,140,180,
Leflore,U.S. Senate,Mark Beard,IND,400208,0,2,21,23,
Leflore,U.S. Senate,Sean Braddy,IND,400208,1,2,10,13,
Leflore,U.S. House,Markwayne Mullin,REP,400208,20,89,334,443,02
Leflore,U.S. House,Joshua Harris-Till,DEM,400208,6,31,140,177,02
Leflore,U.S. House,John Mccarthy,IND,400208,2,13,57,72,02
Leflore,State House,Rick West,REP,400208,19,75,305,399,3
Leflore,State House,Troy Dyer,DEM,400208,8,38,149,195,3
Leflore,State House,Dewey Harrison,IND,400208,2,23,87,112,3
Leflore,President,Donald Trump,REP,400210,21,112,453,586,
Leflore,President,Gary Johnson,LIB,400210,3,0,12,15,
Leflore,President,Hillary Clinton,DEM,400210,3,20,92,115,
Leflore,U.S. Senate,James Lankford,REP,400210,18,104,401,523,
Leflore,U.S. Senate,Robert Murphy,LIB,400210,2,0,8,10,
Leflore,U.S. Senate,Mike Workman,DEM,400210,6,23,113,142,
Leflore,U.S. Senate,Mark Beard,IND,400210,0,3,7,10,
Leflore,U.S. Senate,Sean Braddy,IND,400210,1,0,10,11,
Leflore,U.S. House,Markwayne Mullin,REP,400210,19,105,396,520,02
Leflore,U.S. House,Joshua Harris-Till,DEM,400210,6,18,114,138,02
Leflore,U.S. House,John Mccarthy,IND,400210,2,6,31,39,02
Leflore,State House,Rick West,REP,400210,20,88,325,433,3
Leflore,State House,Troy Dyer,DEM,400210,6,30,151,187,3
Leflore,State House,Dewey Harrison,IND,400210,1,14,79,94,3
Leflore,President,Donald Trump,REP,400211,7,82,426,515,
Leflore,President,Gary Johnson,LIB,400211,1,4,18,23,
Leflore,President,Hillary Clinton,DEM,400211,2,6,87,95,
Leflore,U.S. Senate,James Lankford,REP,400211,7,71,357,435,
Leflore,U.S. Senate,Robert Murphy,LIB,400211,1,0,16,17,
Leflore,U.S. Senate,Mike Workman,DEM,400211,2,17,120,139,
Leflore,U.S. Senate,Mark Beard,IND,400211,0,2,10,12,
Leflore,U.S. Senate,Sean Braddy,IND,400211,0,2,10,12,
Leflore,U.S. House,Markwayne Mullin,REP,400211,7,67,351,425,02
Leflore,U.S. House,Joshua Harris-Till,DEM,400211,2,18,118,138,02
Leflore,U.S. House,John Mccarthy,IND,400211,0,7,47,54,02
Leflore,State Senate,Joseph Silk,REP,400211,6,66,318,390,5
Leflore,State Senate,Stacey Allen Ebert,DEM,400211,3,26,199,228,5
Leflore,State House,Rick West,REP,400211,3,60,267,330,3
Leflore,State House,Troy Dyer,DEM,400211,4,18,218,240,3
Leflore,State House,Dewey Harrison,IND,400211,2,14,45,61,3
Leflore,President,Donald Trump,REP,400212,24,165,604,793,
Leflore,President,Gary Johnson,LIB,400212,0,6,31,37,
Leflore,President,Hillary Clinton,DEM,400212,8,23,129,160,
Leflore,U.S. Senate,James Lankford,REP,400212,23,151,482,656,
Leflore,U.S. Senate,Robert Murphy,LIB,400212,1,3,20,24,
Leflore,U.S. Senate,Mike Workman,DEM,400212,8,33,197,238,
Leflore,U.S. Senate,Mark Beard,IND,400212,1,5,30,36,
Leflore,U.S. Senate,Sean Braddy,IND,400212,0,1,17,18,
Leflore,U.S. House,Markwayne Mullin,REP,400212,21,153,516,690,02
Leflore,U.S. House,Joshua Harris-Till,DEM,400212,11,29,174,214,02
Leflore,U.S. House,John Mccarthy,IND,400212,1,10,57,68,02
Leflore,State House,Rick West,REP,400212,13,124,422,559,3
Leflore,State House,Troy Dyer,DEM,400212,11,41,221,273,3
Leflore,State House,Dewey Harrison,IND,400212,8,28,119,155,3
Leflore,President,Donald Trump,REP,400213,0,5,65,70,
Leflore,President,Gary Johnson,LIB,400213,0,0,5,5,
Leflore,President,Hillary Clinton,DEM,400213,0,0,13,13,
Leflore,U.S. Senate,James Lankford,REP,400213,0,5,55,60,
Leflore,U.S. Senate,Robert Murphy,LIB,400213,0,0,3,3,
Leflore,U.S. Senate,Mike Workman,DEM,400213,0,0,19,19,
Leflore,U.S. Senate,Mark Beard,IND,400213,0,0,4,4,
Leflore,U.S. Senate,Sean Braddy,IND,400213,0,0,1,1,
Leflore,U.S. House,Markwayne Mullin,REP,400213,0,5,58,63,02
Leflore,U.S. House,Joshua Harris-Till,DEM,400213,0,0,14,14,02
Leflore,U.S. House,John Mccarthy,IND,400213,0,0,8,8,02
Leflore,State Senate,Joseph Silk,REP,400213,0,5,50,55,5
Leflore,State Senate,Stacey Allen Ebert,DEM,400213,0,0,29,29,5
Leflore,State House,Paul Marean,REP,400213,0,5,49,54,17
Leflore,State House,Brian Renegar,DEM,400213,0,0,30,30,17
Leflore,President,Donald Trump,REP,400214,7,10,113,130,
Leflore,President,Gary Johnson,LIB,400214,2,1,1,4,
Leflore,President,Hillary Clinton,DEM,400214,3,0,16,19,
Leflore,U.S. Senate,James Lankford,REP,400214,7,7,90,104,
Leflore,U.S. Senate,Robert Murphy,LIB,400214,2,1,0,3,
Leflore,U.S. Senate,Mike Workman,DEM,400214,3,1,31,35,
Leflore,U.S. Senate,Mark Beard,IND,400214,0,0,1,1,
Leflore,U.S. Senate,Sean Braddy,IND,400214,0,2,2,4,
Leflore,U.S. House,Markwayne Mullin,REP,400214,7,9,80,96,02
Leflore,U.S. House,Joshua Harris-Till,DEM,400214,3,2,32,37,02
Leflore,U.S. House,John Mccarthy,IND,400214,2,0,9,11,02
Leflore,State Senate,Joseph Silk,REP,400214,8,9,77,94,5
Leflore,State Senate,Stacey Allen Ebert,DEM,400214,4,2,45,51,5
Leflore,State House,Paul Marean,REP,400214,8,7,61,76,17
Leflore,State House,Brian Renegar,DEM,400214,4,4,59,67,17
Leflore,President,Donald Trump,REP,400215,5,17,192,214,
Leflore,President,Gary Johnson,LIB,400215,0,1,8,9,
Leflore,President,Hillary Clinton,DEM,400215,1,6,36,43,
Leflore,U.S. Senate,James Lankford,REP,400215,4,10,153,167,
Leflore,U.S. Senate,Robert Murphy,LIB,400215,0,0,2,2,
Leflore,U.S. Senate,Mike Workman,DEM,400215,2,11,59,72,
Leflore,U.S. Senate,Mark Beard,IND,400215,0,1,5,6,
Leflore,U.S. Senate,Sean Braddy,IND,400215,0,1,6,7,
Leflore,U.S. House,Markwayne Mullin,REP,400215,4,13,163,180,02
Leflore,U.S. House,Joshua Harris-Till,DEM,400215,2,7,48,57,02
Leflore,U.S. House,John Mccarthy,IND,400215,0,2,17,19,02
Leflore,State Senate,Joseph Silk,REP,400215,3,7,148,158,5
Leflore,State Senate,Stacey Allen Ebert,DEM,400215,3,15,80,98,5
Leflore,State House,Paul Marean,REP,400215,2,9,123,134,17
Leflore,State House,Brian Renegar,DEM,400215,4,13,96,113,17
Leflore,President,Donald Trump,REP,400301,4,3,234,241,
Leflore,President,Gary Johnson,LIB,400301,0,0,14,14,
Leflore,President,Hillary Clinton,DEM,400301,2,5,85,92,
Leflore,U.S. Senate,James Lankford,REP,400301,5,2,205,212,
Leflore,U.S. Senate,Robert Murphy,LIB,400301,0,0,7,7,
Leflore,U.S. Senate,Mike Workman,DEM,400301,1,5,104,110,
Leflore,U.S. Senate,Mark Beard,IND,400301,0,0,7,7,
Leflore,U.S. Senate,Sean Braddy,IND,400301,0,0,6,6,
Leflore,U.S. House,Markwayne Mullin,REP,400301,6,2,214,222,02
Leflore,U.S. House,Joshua Harris-Till,DEM,400301,0,5,89,94,02
Leflore,U.S. House,John Mccarthy,IND,400301,0,0,27,27,02
Leflore,State Senate,Joseph Silk,REP,400301,4,2,214,220,5
Leflore,State Senate,Stacey Allen Ebert,DEM,400301,2,6,115,123,5
Leflore,State House,Paul Marean,REP,400301,4,0,174,178,17
Leflore,State House,Brian Renegar,DEM,400301,2,7,153,162,17
Leflore,President,Donald Trump,REP,400302,10,13,375,398,
Leflore,President,Gary Johnson,LIB,400302,1,0,17,18,
Leflore,President,Hillary Clinton,DEM,400302,10,7,68,85,
Leflore,U.S. Senate,James Lankford,REP,400302,11,14,306,331,
Leflore,U.S. Senate,Robert Murphy,LIB,400302,0,0,11,11,
Leflore,U.S. Senate,Mike Workman,DEM,400302,10,6,118,134,
Leflore,U.S. Senate,Mark Beard,IND,400302,0,0,9,9,
Leflore,U.S. Senate,Sean Braddy,IND,400302,1,0,14,15,
Leflore,U.S. House,Markwayne Mullin,REP,400302,11,14,319,344,02
Leflore,U.S. House,Joshua Harris-Till,DEM,400302,10,5,98,113,02
Leflore,U.S. House,John Mccarthy,IND,400302,1,1,41,43,02
Leflore,State Senate,Joseph Silk,REP,400302,9,15,288,312,5
Leflore,State Senate,Stacey Allen Ebert,DEM,400302,11,5,174,190,5
Leflore,State House,Steven Mcgowen,REP,400302,10,14,292,316,1
Leflore,State House,Johnny Tadlock,DEM,400302,11,6,161,178,1
Leflore,President,Donald Trump,REP,400303,5,5,139,149,
Leflore,President,Gary Johnson,LIB,400303,0,0,4,4,
Leflore,President,Hillary Clinton,DEM,400303,1,2,28,31,
Leflore,U.S. Senate,James Lankford,REP,400303,5,3,132,140,
Leflore,U.S. Senate,Robert Murphy,LIB,400303,0,0,3,3,
Leflore,U.S. Senate,Mike Workman,DEM,400303,0,2,31,33,
Leflore,U.S. Senate,Mark Beard,IND,400303,0,1,1,2,
Leflore,U.S. Senate,Sean Braddy,IND,400303,1,0,3,4,
Leflore,U.S. House,Markwayne Mullin,REP,400303,5,2,124,131,02
Leflore,U.S. House,Joshua Harris-Till,DEM,400303,0,2,31,33,02
Leflore,U.S. House,John Mccarthy,IND,400303,1,2,12,15,02
Leflore,State Senate,Joseph Silk,REP,400303,4,4,117,125,5
Leflore,State Senate,Stacey Allen Ebert,DEM,400303,1,2,49,52,5
Leflore,State House,Steven Mcgowen,REP,400303,4,4,111,119,1
Leflore,State House,Johnny Tadlock,DEM,400303,1,2,55,58,1
Leflore,President,Donald Trump,REP,400304,6,1,172,179,
Leflore,President,Gary Johnson,LIB,400304,0,0,4,4,
Leflore,President,Hillary Clinton,DEM,400304,1,0,22,23,
Leflore,U.S. Senate,James Lankford,REP,400304,7,1,157,165,
Leflore,U.S. Senate,Robert Murphy,LIB,400304,0,0,2,2,
Leflore,U.S. Senate,Mike Workman,DEM,400304,0,0,29,29,
Leflore,U.S. Senate,Mark Beard,IND,400304,0,0,4,4,
Leflore,U.S. Senate,Sean Braddy,IND,400304,0,0,2,2,
Leflore,U.S. House,Markwayne Mullin,REP,400304,7,1,156,164,02
Leflore,U.S. House,Joshua Harris-Till,DEM,400304,0,0,31,31,02
Leflore,U.S. House,John Mccarthy,IND,400304,0,0,8,8,02
Leflore,State Senate,Joseph Silk,REP,400304,4,1,127,132,5
Leflore,State Senate,Stacey Allen Ebert,DEM,400304,3,0,70,73,5
Leflore,State House,Steven Mcgowen,REP,400304,4,1,127,132,1
Leflore,State House,Johnny Tadlock,DEM,400304,3,0,69,72,1
Leflore,President,Donald Trump,REP,400305,4,7,115,126,
Leflore,President,Gary Johnson,LIB,400305,0,0,3,3,
Leflore,President,Hillary Clinton,DEM,400305,3,3,26,32,
Leflore,U.S. Senate,James Lankford,REP,400305,4,7,93,104,
Leflore,U.S. Senate,Robert Murphy,LIB,400305,0,0,0,0,
Leflore,U.S. Senate,Mike Workman,DEM,400305,3,3,41,47,
Leflore,U.S. Senate,Mark Beard,IND,400305,0,0,2,2,
Leflore,U.S. Senate,Sean Braddy,IND,400305,0,0,6,6,
Leflore,U.S. House,Markwayne Mullin,REP,400305,4,7,96,107,02
Leflore,U.S. House,Joshua Harris-Till,DEM,400305,3,3,38,44,02
Leflore,U.S. House,John Mccarthy,IND,400305,0,0,8,8,02
Leflore,State Senate,Joseph Silk,REP,400305,4,7,87,98,5
Leflore,State Senate,Stacey Allen Ebert,DEM,400305,3,3,57,63,5
Leflore,State House,Steven Mcgowen,REP,400305,4,5,78,87,1
Leflore,State House,Johnny Tadlock,DEM,400305,3,5,65,73,1
Leflore,President,Donald Trump,REP,400306,4,9,82,95,
Leflore,President,Gary Johnson,LIB,400306,0,0,3,3,
Leflore,President,Hillary Clinton,DEM,400306,0,2,6,8,
Leflore,U.S. Senate,James Lankford,REP,400306,4,6,66,76,
Leflore,U.S. Senate,Robert Murphy,LIB,400306,0,0,0,0,
Leflore,U.S. Senate,Mike Workman,DEM,400306,0,3,12,15,
Leflore,U.S. Senate,Mark Beard,IND,400306,0,0,3,3,
Leflore,U.S. Senate,Sean Braddy,IND,400306,0,0,1,1,
Leflore,U.S. House,Markwayne Mullin,REP,400306,4,6,68,78,02
Leflore,U.S. House,Joshua Harris-Till,DEM,400306,0,3,10,13,02
Leflore,U.S. House,John Mccarthy,IND,400306,0,0,7,7,02
Leflore,State Senate,Joseph Silk,REP,400306,3,4,63,70,5
Leflore,State Senate,Stacey Allen Ebert,DEM,400306,1,3,24,28,5
Leflore,State House,Steven Mcgowen,REP,400306,3,7,60,70,1
Leflore,State House,Johnny Tadlock,DEM,400306,1,3,24,28,1
Leflore,President,Donald Trump,REP,400309,1,3,63,67,
Leflore,President,Gary Johnson,LIB,400309,1,0,0,1,
Leflore,President,Hillary Clinton,DEM,400309,1,1,11,13,
Leflore,U.S. Senate,James Lankford,REP,400309,1,3,54,58,
Leflore,U.S. Senate,Robert Murphy,LIB,400309,1,0,0,1,
Leflore,U.S. Senate,Mike Workman,DEM,400309,1,1,11,13,
Leflore,U.S. Senate,Mark Beard,IND,400309,0,0,2,2,
Leflore,U.S. Senate,Sean Braddy,IND,400309,0,0,3,3,
Leflore,U.S. House,Markwayne Mullin,REP,400309,2,3,53,58,02
Leflore,U.S. House,Joshua Harris-Till,DEM,400309,1,1,11,13,02
Leflore,U.S. House,John Mccarthy,IND,400309,0,0,5,5,02
Leflore,State Senate,Joseph Silk,REP,400309,2,1,58,61,5
Leflore,State Senate,Stacey Allen Ebert,DEM,400309,1,3,12,16,5
Leflore,State House,Rick West,REP,400309,2,3,50,55,3
Leflore,State House,Troy Dyer,DEM,400309,1,1,21,23,3
Leflore,State House,Dewey Harrison,IND,400309,0,0,3,3,3
Leflore,President,Donald Trump,REP,400310,15,65,433,513,
Leflore,President,Gary Johnson,LIB,400310,0,3,22,25,
Leflore,President,Hillary Clinton,DEM,400310,8,21,84,113,
Leflore,U.S. Senate,James Lankford,REP,400310,13,58,365,436,
Leflore,U.S. Senate,Robert Murphy,LIB,400310,0,1,9,10,
Leflore,U.S. Senate,Mike Workman,DEM,400310,8,23,131,162,
Leflore,U.S. Senate,Mark Beard,IND,400310,1,2,10,13,
Leflore,U.S. Senate,Sean Braddy,IND,400310,1,1,14,16,
Leflore,U.S. House,Markwayne Mullin,REP,400310,14,59,369,442,02
Leflore,U.S. House,Joshua Harris-Till,DEM,400310,8,21,125,154,02
Leflore,U.S. House,John Mccarthy,IND,400310,1,5,31,37,02
Leflore,State Senate,Joseph Silk,REP,400310,12,62,341,415,5
Leflore,State Senate,Stacey Allen Ebert,DEM,400310,11,26,183,220,5
Leflore,State House,Rick West,REP,400310,13,55,282,350,3
Leflore,State House,Troy Dyer,DEM,400310,7,27,220,254,3
Leflore,State House,Dewey Harrison,IND,400310,3,7,33,43,3
Leflore,President,Donald Trump,REP,400311,14,32,313,359,
Leflore,President,Gary Johnson,LIB,400311,0,1,14,15,
Leflore,President,Hillary Clinton,DEM,400311,8,2,93,103,
Leflore,U.S. Senate,James Lankford,REP,400311,13,27,277,317,
Leflore,U.S. Senate,Robert Murphy,LIB,400311,0,1,11,12,
Leflore,U.S. Senate,Mike Workman,DEM,400311,7,6,108,121,
Leflore,U.S. Senate,Mark Beard,IND,400311,2,1,9,12,
Leflore,U.S. Senate,Sean Braddy,IND,400311,0,0,5,5,
Leflore,U.S. House,Markwayne Mullin,REP,400311,13,29,294,336,02
Leflore,U.S. House,Joshua Harris-Till,DEM,400311,8,4,90,102,02
Leflore,U.S. House,John Mccarthy,IND,400311,1,1,24,26,02
Leflore,State Senate,Joseph Silk,REP,400311,11,29,279,319,5
Leflore,State Senate,Stacey Allen Ebert,DEM,400311,7,6,136,149,5
Leflore,State House,Rick West,REP,400311,5,22,229,256,3
Leflore,State House,Troy Dyer,DEM,400311,13,12,158,183,3
Leflore,State House,Dewey Harrison,IND,400311,1,1,35,37,3
Leflore,President,Donald Trump,REP,400312,2,13,227,242,
Leflore,President,Gary Johnson,LIB,400312,0,0,6,6,
Leflore,President,Hillary Clinton,DEM,400312,1,3,65,69,
Leflore,U.S. Senate,James Lankford,REP,400312,1,11,185,197,
Leflore,U.S. Senate,Robert Murphy,LIB,400312,0,0,4,4,
Leflore,U.S. Senate,Mike Workman,DEM,400312,2,2,90,94,
Leflore,U.S. Senate,Mark Beard,IND,400312,0,1,5,6,
Leflore,U.S. Senate,Sean Braddy,IND,400312,0,0,7,7,
Leflore,U.S. House,Markwayne Mullin,REP,400312,2,11,204,217,02
Leflore,U.S. House,Joshua Harris-Till,DEM,400312,1,3,73,77,02
Leflore,U.S. House,John Mccarthy,IND,400312,0,1,14,15,02
Leflore,State Senate,Joseph Silk,REP,400312,0,11,180,191,5
Leflore,State Senate,Stacey Allen Ebert,DEM,400312,2,3,111,116,5
Leflore,State House,Rick West,REP,400312,1,9,184,194,3
Leflore,State House,Troy Dyer,DEM,400312,2,6,97,105,3
Leflore,State House,Dewey Harrison,IND,400312,0,1,17,18,3
Lincoln,President,Donald Trump,REP,410001,27,21,398,446,
Lincoln,President,Gary Johnson,LIB,410001,2,2,29,33,
Lincoln,President,Hillary Clinton,DEM,410001,6,4,107,117,
Lincoln,U.S. Senate,James Lankford,REP,410001,30,22,413,465,
Lincoln,U.S. Senate,Robert Murphy,LIB,410001,1,0,10,11,
Lincoln,U.S. Senate,Mike Workman,DEM,410001,2,3,94,99,
Lincoln,U.S. Senate,Mark Beard,IND,410001,0,1,4,5,
Lincoln,U.S. Senate,Sean Braddy,IND,410001,1,0,9,10,
Lincoln,U.S. House,Frank Lucas,REP,410001,31,21,402,454,03
Lincoln,U.S. House,Frankie Robbins,DEM,410001,4,5,119,128,03
Lincoln,State House,Kevin Wallace,REP,410001,30,19,386,435,32
Lincoln,State House,Billy Hinton,DEM,410001,5,6,135,146,32
Lincoln,President,Donald Trump,REP,410002,22,38,589,649,
Lincoln,President,Gary Johnson,LIB,410002,3,1,46,50,
Lincoln,President,Hillary Clinton,DEM,410002,3,4,108,115,
Lincoln,U.S. Senate,James Lankford,REP,410002,21,38,608,667,
Lincoln,U.S. Senate,Robert Murphy,LIB,410002,2,0,12,14,
Lincoln,U.S. Senate,Mike Workman,DEM,410002,5,4,94,103,
Lincoln,U.S. Senate,Mark Beard,IND,410002,0,0,10,10,
Lincoln,U.S. Senate,Sean Braddy,IND,410002,0,0,15,15,
Lincoln,U.S. House,Frank Lucas,REP,410002,23,39,590,652,03
Lincoln,U.S. House,Frankie Robbins,DEM,410002,4,4,141,149,03
Lincoln,State House,Kevin Wallace,REP,410002,23,38,577,638,32
Lincoln,State House,Billy Hinton,DEM,410002,3,5,154,162,32
Lincoln,President,Donald Trump,REP,410003,26,97,593,716,
Lincoln,President,Gary Johnson,LIB,410003,1,10,38,49,
Lincoln,President,Hillary Clinton,DEM,410003,7,16,125,148,
Lincoln,U.S. Senate,James Lankford,REP,410003,28,98,606,732,
Lincoln,U.S. Senate,Robert Murphy,LIB,410003,0,3,14,17,
Lincoln,U.S. Senate,Mike Workman,DEM,410003,5,16,110,131,
Lincoln,U.S. Senate,Mark Beard,IND,410003,0,4,13,17,
Lincoln,U.S. Senate,Sean Braddy,IND,410003,1,3,13,17,
Lincoln,U.S. House,Frank Lucas,REP,410003,26,105,593,724,03
Lincoln,U.S. House,Frankie Robbins,DEM,410003,8,19,155,182,03
Lincoln,State House,Kevin Wallace,REP,410003,23,97,583,703,32
Lincoln,State House,Billy Hinton,DEM,410003,7,27,168,202,32
Lincoln,President,Donald Trump,REP,410004,18,7,326,351,
Lincoln,President,Gary Johnson,LIB,410004,1,0,9,10,
Lincoln,President,Hillary Clinton,DEM,410004,2,0,49,51,
Lincoln,U.S. Senate,James Lankford,REP,410004,20,7,327,354,
Lincoln,U.S. Senate,Robert Murphy,LIB,410004,0,0,9,9,
Lincoln,U.S. Senate,Mike Workman,DEM,410004,0,0,47,47,
Lincoln,U.S. Senate,Mark Beard,IND,410004,0,0,0,0,
Lincoln,U.S. Senate,Sean Braddy,IND,410004,1,0,2,3,
Lincoln,U.S. House,Frank Lucas,REP,410004,15,7,327,349,03
Lincoln,U.S. House,Frankie Robbins,DEM,410004,6,0,58,64,03
Lincoln,State House,Kevin Wallace,REP,410004,18,7,311,336,32
Lincoln,State House,Billy Hinton,DEM,410004,3,0,72,75,32
Lincoln,President,Donald Trump,REP,410005,17,56,444,517,
Lincoln,President,Gary Johnson,LIB,410005,4,5,14,23,
Lincoln,President,Hillary Clinton,DEM,410005,0,10,90,100,
Lincoln,U.S. Senate,James Lankford,REP,410005,17,56,447,520,
Lincoln,U.S. Senate,Robert Murphy,LIB,410005,5,0,11,16,
Lincoln,U.S. Senate,Mike Workman,DEM,410005,0,12,78,90,
Lincoln,U.S. Senate,Mark Beard,IND,410005,0,1,9,10,
Lincoln,U.S. Senate,Sean Braddy,IND,410005,0,2,9,11,
Lincoln,U.S. House,Frank Lucas,REP,410005,21,54,459,534,03
Lincoln,U.S. House,Frankie Robbins,DEM,410005,1,17,95,113,03
Lincoln,State House,Kevin Wallace,REP,410005,17,53,410,480,32
Lincoln,State House,Billy Hinton,DEM,410005,3,16,139,158,32
Lincoln,President,Donald Trump,REP,410006,4,15,204,223,
Lincoln,President,Gary Johnson,LIB,410006,0,0,16,16,
Lincoln,President,Hillary Clinton,DEM,410006,1,3,53,57,
Lincoln,U.S. Senate,James Lankford,REP,410006,5,15,201,221,
Lincoln,U.S. Senate,Robert Murphy,LIB,410006,0,0,12,12,
Lincoln,U.S. Senate,Mike Workman,DEM,410006,0,3,45,48,
Lincoln,U.S. Senate,Mark Beard,IND,410006,0,0,8,8,
Lincoln,U.S. Senate,Sean Braddy,IND,410006,0,0,6,6,
Lincoln,U.S. House,Frank Lucas,REP,410006,5,15,204,224,03
Lincoln,U.S. House,Frankie Robbins,DEM,410006,0,3,65,68,03
Lincoln,State House,Kevin Wallace,REP,410006,4,14,201,219,32
Lincoln,State House,Billy Hinton,DEM,410006,1,4,66,71,32
Lincoln,President,Donald Trump,REP,410007,12,23,269,304,
Lincoln,President,Gary Johnson,LIB,410007,1,0,16,17,
Lincoln,President,Hillary Clinton,DEM,410007,1,1,72,74,
Lincoln,U.S. Senate,James Lankford,REP,410007,14,20,264,298,
Lincoln,U.S. Senate,Robert Murphy,LIB,410007,1,0,13,14,
Lincoln,U.S. Senate,Mike Workman,DEM,410007,0,3,61,64,
Lincoln,U.S. Senate,Mark Beard,IND,410007,0,1,4,5,
Lincoln,U.S. Senate,Sean Braddy,IND,410007,0,0,12,12,
Lincoln,U.S. House,Frank Lucas,REP,410007,14,23,271,308,03
Lincoln,U.S. House,Frankie Robbins,DEM,410007,1,1,81,83,03
Lincoln,State House,Kevin Wallace,REP,410007,14,22,254,290,32
Lincoln,State House,Billy Hinton,DEM,410007,1,2,93,96,32
Lincoln,President,Donald Trump,REP,410008,23,52,742,817,
Lincoln,President,Gary Johnson,LIB,410008,3,2,47,52,
Lincoln,President,Hillary Clinton,DEM,410008,10,24,148,182,
Lincoln,U.S. Senate,James Lankford,REP,410008,28,54,776,858,
Lincoln,U.S. Senate,Robert Murphy,LIB,410008,0,1,24,25,
Lincoln,U.S. Senate,Mike Workman,DEM,410008,5,21,120,146,
Lincoln,U.S. Senate,Mark Beard,IND,410008,1,1,9,11,
Lincoln,U.S. Senate,Sean Braddy,IND,410008,1,3,13,17,
Lincoln,U.S. House,Frank Lucas,REP,410008,28,54,773,855,03
Lincoln,U.S. House,Frankie Robbins,DEM,410008,7,25,159,191,03
Lincoln,State House,Kevin Wallace,REP,410008,26,49,781,856,32
Lincoln,State House,Billy Hinton,DEM,410008,9,31,155,195,32
Lincoln,President,Donald Trump,REP,410009,26,57,393,476,
Lincoln,President,Gary Johnson,LIB,410009,2,5,30,37,
Lincoln,President,Hillary Clinton,DEM,410009,3,8,87,98,
Lincoln,U.S. Senate,James Lankford,REP,410009,26,60,419,505,
Lincoln,U.S. Senate,Robert Murphy,LIB,410009,0,2,16,18,
Lincoln,U.S. Senate,Mike Workman,DEM,410009,3,10,62,75,
Lincoln,U.S. Senate,Mark Beard,IND,410009,1,0,11,12,
Lincoln,U.S. Senate,Sean Braddy,IND,410009,1,0,8,9,
Lincoln,U.S. House,Frank Lucas,REP,410009,27,58,421,506,03
Lincoln,U.S. House,Frankie Robbins,DEM,410009,4,13,89,106,03
Lincoln,State House,Kevin Wallace,REP,410009,27,57,427,511,32
Lincoln,State House,Billy Hinton,DEM,410009,3,15,82,100,32
Lincoln,President,Donald Trump,REP,410010,26,190,470,686,
Lincoln,President,Gary Johnson,LIB,410010,1,10,27,38,
Lincoln,President,Hillary Clinton,DEM,410010,9,41,106,156,
Lincoln,U.S. Senate,James Lankford,REP,410010,24,199,512,735,
Lincoln,U.S. Senate,Robert Murphy,LIB,410010,3,3,13,19,
Lincoln,U.S. Senate,Mike Workman,DEM,410010,6,37,65,108,
Lincoln,U.S. Senate,Mark Beard,IND,410010,1,0,7,8,
Lincoln,U.S. Senate,Sean Braddy,IND,410010,2,3,11,16,
Lincoln,U.S. House,Frank Lucas,REP,410010,29,198,511,738,03
Lincoln,U.S. House,Frankie Robbins,DEM,410010,7,44,95,146,03
Lincoln,State House,Kevin Wallace,REP,410010,28,188,491,707,32
Lincoln,State House,Billy Hinton,DEM,410010,8,53,112,173,32
Lincoln,President,Donald Trump,REP,410011,19,161,387,567,
Lincoln,President,Gary Johnson,LIB,410011,1,13,34,48,
Lincoln,President,Hillary Clinton,DEM,410011,10,43,104,157,
Lincoln,U.S. Senate,James Lankford,REP,410011,20,174,403,597,
Lincoln,U.S. Senate,Robert Murphy,LIB,410011,0,5,12,17,
Lincoln,U.S. Senate,Mike Workman,DEM,410011,8,32,91,131,
Lincoln,U.S. Senate,Mark Beard,IND,410011,0,5,14,19,
Lincoln,U.S. Senate,Sean Braddy,IND,410011,1,5,9,15,
Lincoln,U.S. House,Frank Lucas,REP,410011,20,170,408,598,03
Lincoln,U.S. House,Frankie Robbins,DEM,410011,8,47,118,173,03
Lincoln,State House,Kevin Wallace,REP,410011,20,164,399,583,32
Lincoln,State House,Billy Hinton,DEM,410011,8,55,132,195,32
Lincoln,President,Donald Trump,REP,410012,13,119,387,519,
Lincoln,President,Gary Johnson,LIB,410012,0,5,33,38,
Lincoln,President,Hillary Clinton,DEM,410012,2,32,141,175,
Lincoln,U.S. Senate,James Lankford,REP,410012,13,136,410,559,
Lincoln,U.S. Senate,Robert Murphy,LIB,410012,0,2,12,14,
Lincoln,U.S. Senate,Mike Workman,DEM,410012,2,17,113,132,
Lincoln,U.S. Senate,Mark Beard,IND,410012,0,3,12,15,
Lincoln,U.S. Senate,Sean Braddy,IND,410012,0,1,17,18,
Lincoln,U.S. House,Frank Lucas,REP,410012,12,135,411,558,03
Lincoln,U.S. House,Frankie Robbins,DEM,410012,2,23,146,171,03
Lincoln,State House,Kevin Wallace,REP,410012,11,133,402,546,32
Lincoln,State House,Billy Hinton,DEM,410012,4,26,153,183,32
Lincoln,President,Donald Trump,REP,410013,8,9,189,206,
Lincoln,President,Gary Johnson,LIB,410013,0,0,15,15,
Lincoln,President,Hillary Clinton,DEM,410013,0,3,32,35,
Lincoln,U.S. Senate,James Lankford,REP,410013,10,10,192,212,
Lincoln,U.S. Senate,Robert Murphy,LIB,410013,0,0,9,9,
Lincoln,U.S. Senate,Mike Workman,DEM,410013,1,3,30,34,
Lincoln,U.S. Senate,Mark Beard,IND,410013,1,0,3,4,
Lincoln,U.S. Senate,Sean Braddy,IND,410013,0,0,1,1,
Lincoln,U.S. House,Frank Lucas,REP,410013,11,8,196,215,03
Lincoln,U.S. House,Frankie Robbins,DEM,410013,1,5,38,44,03
Lincoln,State House,Kevin Wallace,REP,410013,11,5,187,203,32
Lincoln,State House,Billy Hinton,DEM,410013,1,8,44,53,32
Lincoln,President,Donald Trump,REP,410015,37,45,742,824,
Lincoln,President,Gary Johnson,LIB,410015,2,3,57,62,
Lincoln,President,Hillary Clinton,DEM,410015,9,8,160,177,
Lincoln,U.S. Senate,James Lankford,REP,410015,39,43,737,819,
Lincoln,U.S. Senate,Robert Murphy,LIB,410015,1,6,28,35,
Lincoln,U.S. Senate,Mike Workman,DEM,410015,6,5,151,162,
Lincoln,U.S. Senate,Mark Beard,IND,410015,1,1,16,18,
Lincoln,U.S. Senate,Sean Braddy,IND,410015,1,0,26,27,
Lincoln,U.S. House,Frank Lucas,REP,410015,41,45,757,843,03
Lincoln,U.S. House,Frankie Robbins,DEM,410015,7,10,194,211,03
Lincoln,State House,Kevin Wallace,REP,410015,41,45,720,806,32
Lincoln,State House,Billy Hinton,DEM,410015,7,7,225,239,32
Lincoln,President,Donald Trump,REP,410016,18,35,544,597,
Lincoln,President,Gary Johnson,LIB,410016,2,1,38,41,
Lincoln,President,Hillary Clinton,DEM,410016,5,13,91,109,
Lincoln,U.S. Senate,James Lankford,REP,410016,21,35,576,632,
Lincoln,U.S. Senate,Robert Murphy,LIB,410016,0,1,13,14,
Lincoln,U.S. Senate,Mike Workman,DEM,410016,2,13,67,82,
Lincoln,U.S. Senate,Mark Beard,IND,410016,2,0,11,13,
Lincoln,U.S. Senate,Sean Braddy,IND,410016,0,0,9,9,
Lincoln,U.S. House,Frank Lucas,REP,410016,21,36,573,630,03
Lincoln,U.S. House,Frankie Robbins,DEM,410016,4,13,96,113,03
Lincoln,State House,Kevin Wallace,REP,410016,21,37,550,608,32
Lincoln,State House,Billy Hinton,DEM,410016,4,11,122,137,32
Lincoln,President,Donald Trump,REP,410017,4,30,136,170,
Lincoln,President,Gary Johnson,LIB,410017,0,1,13,14,
Lincoln,President,Hillary Clinton,DEM,410017,8,11,41,60,
Lincoln,U.S. Senate,James Lankford,REP,410017,5,35,136,176,
Lincoln,U.S. Senate,Robert Murphy,LIB,410017,0,0,8,8,
Lincoln,U.S. Senate,Mike Workman,DEM,410017,5,6,37,48,
Lincoln,U.S. Senate,Mark Beard,IND,410017,1,0,3,4,
Lincoln,U.S. Senate,Sean Braddy,IND,410017,1,2,5,8,
Lincoln,U.S. House,Frank Lucas,REP,410017,5,36,134,175,03
Lincoln,U.S. House,Frankie Robbins,DEM,410017,7,7,55,69,03
Lincoln,State House,Kevin Wallace,REP,410017,5,33,128,166,32
Lincoln,State House,Billy Hinton,DEM,410017,7,9,60,76,32
Lincoln,President,Donald Trump,REP,410018,5,18,315,338,
Lincoln,President,Gary Johnson,LIB,410018,1,3,28,32,
Lincoln,President,Hillary Clinton,DEM,410018,4,7,94,105,
Lincoln,U.S. Senate,James Lankford,REP,410018,7,22,331,360,
Lincoln,U.S. Senate,Robert Murphy,LIB,410018,0,1,14,15,
Lincoln,U.S. Senate,Mike Workman,DEM,410018,3,5,74,82,
Lincoln,U.S. Senate,Mark Beard,IND,410018,0,0,10,10,
Lincoln,U.S. Senate,Sean Braddy,IND,410018,0,0,13,13,
Lincoln,U.S. House,Frank Lucas,REP,410018,7,21,341,369,03
Lincoln,U.S. House,Frankie Robbins,DEM,410018,3,5,99,107,03
Lincoln,State House,Kevin Wallace,REP,410018,6,18,311,335,32
Lincoln,State House,Billy Hinton,DEM,410018,3,9,125,137,32
Lincoln,President,Donald Trump,REP,410019,15,21,544,580,
Lincoln,President,Gary Johnson,LIB,410019,2,0,27,29,
Lincoln,President,Hillary Clinton,DEM,410019,5,3,88,96,
Lincoln,U.S. Senate,James Lankford,REP,410019,16,21,551,588,
Lincoln,U.S. Senate,Robert Murphy,LIB,410019,1,0,14,15,
Lincoln,U.S. Senate,Mike Workman,DEM,410019,2,2,70,74,
Lincoln,U.S. Senate,Mark Beard,IND,410019,2,0,13,15,
Lincoln,U.S. Senate,Sean Braddy,IND,410019,1,1,10,12,
Lincoln,U.S. House,Frank Lucas,REP,410019,17,20,536,573,03
Lincoln,U.S. House,Frankie Robbins,DEM,410019,5,4,117,126,03
Lincoln,State House,Kevin Wallace,REP,410019,18,23,512,553,32
Lincoln,State House,Billy Hinton,DEM,410019,4,1,128,133,32
Lincoln,President,Donald Trump,REP,410020,8,23,379,410,
Lincoln,President,Gary Johnson,LIB,410020,0,0,32,32,
Lincoln,President,Hillary Clinton,DEM,410020,2,8,91,101,
Lincoln,U.S. Senate,James Lankford,REP,410020,7,24,379,410,
Lincoln,U.S. Senate,Robert Murphy,LIB,410020,1,1,19,21,
Lincoln,U.S. Senate,Mike Workman,DEM,410020,0,5,76,81,
Lincoln,U.S. Senate,Mark Beard,IND,410020,0,0,20,20,
Lincoln,U.S. Senate,Sean Braddy,IND,410020,1,0,9,10,
Lincoln,U.S. House,Frank Lucas,REP,410020,9,22,380,411,03
Lincoln,U.S. House,Frankie Robbins,DEM,410020,0,8,119,127,03
Lincoln,State House,Kevin Wallace,REP,410020,8,19,380,407,32
Lincoln,State House,Billy Hinton,DEM,410020,1,11,120,132,32
Lincoln,President,Donald Trump,REP,410021,34,25,683,742,
Lincoln,President,Gary Johnson,LIB,410021,1,6,59,66,
Lincoln,President,Hillary Clinton,DEM,410021,8,2,126,136,
Lincoln,U.S. Senate,James Lankford,REP,410021,31,27,698,756,
Lincoln,U.S. Senate,Robert Murphy,LIB,410021,1,2,26,29,
Lincoln,U.S. Senate,Mike Workman,DEM,410021,7,1,109,117,
Lincoln,U.S. Senate,Mark Beard,IND,410021,1,3,17,21,
Lincoln,U.S. Senate,Sean Braddy,IND,410021,3,0,13,16,
Lincoln,U.S. House,Frank Lucas,REP,410021,33,30,698,761,03
Lincoln,U.S. House,Frankie Robbins,DEM,410021,10,4,157,171,03
Lincoln,State House,Kevin Wallace,REP,410021,35,27,647,709,32
Lincoln,State House,Billy Hinton,DEM,410021,8,7,205,220,32
Lincoln,President,Donald Trump,REP,410022,26,18,672,716,
Lincoln,President,Gary Johnson,LIB,410022,1,1,37,39,
Lincoln,President,Hillary Clinton,DEM,410022,15,11,155,181,
Lincoln,U.S. Senate,James Lankford,REP,410022,33,17,701,751,
Lincoln,U.S. Senate,Robert Murphy,LIB,410022,0,0,17,17,
Lincoln,U.S. Senate,Mike Workman,DEM,410022,9,12,132,153,
Lincoln,U.S. Senate,Mark Beard,IND,410022,0,0,6,6,
Lincoln,U.S. Senate,Sean Braddy,IND,410022,2,0,14,16,
Lincoln,U.S. House,Frank Lucas,REP,410022,32,15,696,743,03
Lincoln,U.S. House,Frankie Robbins,DEM,410022,11,14,172,197,03
Lincoln,State House,Kevin Wallace,REP,410022,31,16,651,698,32
Lincoln,State House,Billy Hinton,DEM,410022,12,13,209,234,32
Logan,President,Donald Trump,REP,420101,38,57,437,532,
Logan,President,Gary Johnson,LIB,420101,8,1,26,35,
Logan,President,Hillary Clinton,DEM,420101,8,8,57,73,
Logan,U.S. Senate,James Lankford,REP,420101,45,57,453,555,
Logan,U.S. Senate,Robert Murphy,LIB,420101,2,2,18,22,
Logan,U.S. Senate,Mike Workman,DEM,420101,6,5,37,48,
Logan,U.S. Senate,Mark Beard,IND,420101,0,1,6,7,
Logan,U.S. Senate,Sean Braddy,IND,420101,1,1,8,10,
Logan,U.S. House,Frank Lucas,REP,420101,47,58,462,567,03
Logan,U.S. House,Frankie Robbins,DEM,420101,5,8,57,70,03
Logan,State House,Jason Murphey,REP,420101,45,57,447,549,31
Logan,State House,John Tiller,DEM,420101,9,9,70,88,31
Logan,President,Donald Trump,REP,420102,47,133,462,642,
Logan,President,Gary Johnson,LIB,420102,1,9,37,47,
Logan,President,Hillary Clinton,DEM,420102,22,40,129,191,
Logan,U.S. Senate,James Lankford,REP,420102,52,140,476,668,
Logan,U.S. Senate,Robert Murphy,LIB,420102,0,4,24,28,
Logan,U.S. Senate,Mike Workman,DEM,420102,15,34,93,142,
Logan,U.S. Senate,Mark Beard,IND,420102,2,2,14,18,
Logan,U.S. Senate,Sean Braddy,IND,420102,1,2,14,17,
Logan,U.S. House,Frank Lucas,REP,420102,55,139,485,679,03
Logan,U.S. House,Frankie Robbins,DEM,420102,16,39,134,189,03
Logan,State House,Jason Murphey,REP,420102,54,133,438,625,31
Logan,State House,John Tiller,DEM,420102,16,49,181,246,31
Logan,President,Donald Trump,REP,420103,194,336,1164,1694,
Logan,President,Gary Johnson,LIB,420103,11,12,79,102,
Logan,President,Hillary Clinton,DEM,420103,83,78,274,435,
Logan,U.S. Senate,James Lankford,REP,420103,205,356,1225,1786,
Logan,U.S. Senate,Robert Murphy,LIB,420103,9,9,45,63,
Logan,U.S. Senate,Mike Workman,DEM,420103,65,55,213,333,
Logan,U.S. Senate,Mark Beard,IND,420103,3,2,22,27,
Logan,U.S. Senate,Sean Braddy,IND,420103,2,3,23,28,
Logan,U.S. House,Frank Lucas,REP,420103,208,355,1253,1816,03
Logan,U.S. House,Frankie Robbins,DEM,420103,72,68,256,396,03
Logan,State House,Jason Murphey,REP,420103,202,338,1199,1739,31
Logan,State House,John Tiller,DEM,420103,75,81,302,458,31
Logan,President,Donald Trump,REP,420104,136,256,713,1105,
Logan,President,Gary Johnson,LIB,420104,13,21,59,93,
Logan,President,Hillary Clinton,DEM,420104,31,59,116,206,
Logan,U.S. Senate,James Lankford,REP,420104,142,267,727,1136,
Logan,U.S. Senate,Robert Murphy,LIB,420104,4,8,45,57,
Logan,U.S. Senate,Mike Workman,DEM,420104,23,50,90,163,
Logan,U.S. Senate,Mark Beard,IND,420104,5,2,17,24,
Logan,U.S. Senate,Sean Braddy,IND,420104,6,8,12,26,
Logan,U.S. House,Frank Lucas,REP,420104,148,276,758,1182,03
Logan,U.S. House,Frankie Robbins,DEM,420104,31,58,126,215,03
Logan,State House,Jason Murphey,REP,420104,142,264,746,1152,31
Logan,State House,John Tiller,DEM,420104,37,67,134,238,31
Logan,President,Donald Trump,REP,420105,32,106,431,569,
Logan,President,Gary Johnson,LIB,420105,4,9,43,56,
Logan,President,Hillary Clinton,DEM,420105,16,42,95,153,
Logan,U.S. Senate,James Lankford,REP,420105,39,116,442,597,
Logan,U.S. Senate,Robert Murphy,LIB,420105,1,4,36,41,
Logan,U.S. Senate,Mike Workman,DEM,420105,9,34,68,111,
Logan,U.S. Senate,Mark Beard,IND,420105,2,0,10,12,
Logan,U.S. Senate,Sean Braddy,IND,420105,0,5,13,18,
Logan,U.S. House,Frank Lucas,REP,420105,40,115,457,612,03
Logan,U.S. House,Frankie Robbins,DEM,420105,11,42,100,153,03
Logan,State House,Jason Murphey,REP,420105,37,111,419,567,31
Logan,State House,John Tiller,DEM,420105,14,47,143,204,31
Logan,President,Donald Trump,REP,420106,98,192,762,1052,
Logan,President,Gary Johnson,LIB,420106,13,12,84,109,
Logan,President,Hillary Clinton,DEM,420106,44,52,177,273,
Logan,U.S. Senate,James Lankford,REP,420106,112,206,830,1148,
Logan,U.S. Senate,Robert Murphy,LIB,420106,3,5,53,61,
Logan,U.S. Senate,Mike Workman,DEM,420106,34,49,116,199,
Logan,U.S. Senate,Mark Beard,IND,420106,5,2,13,20,
Logan,U.S. Senate,Sean Braddy,IND,420106,4,3,21,28,
Logan,U.S. House,Frank Lucas,REP,420106,117,204,854,1175,03
Logan,U.S. House,Frankie Robbins,DEM,420106,42,57,172,271,03
Logan,State House,Jason Murphey,REP,420106,119,200,830,1149,31
Logan,State House,John Tiller,DEM,420106,39,61,192,292,31
Logan,President,Donald Trump,REP,420201,0,6,121,127,
Logan,President,Gary Johnson,LIB,420201,0,0,9,9,
Logan,President,Hillary Clinton,DEM,420201,2,2,32,36,
Logan,U.S. Senate,James Lankford,REP,420201,0,6,114,120,
Logan,U.S. Senate,Robert Murphy,LIB,420201,0,0,5,5,
Logan,U.S. Senate,Mike Workman,DEM,420201,2,1,33,36,
Logan,U.S. Senate,Mark Beard,IND,420201,0,1,4,5,
Logan,U.S. Senate,Sean Braddy,IND,420201,0,0,4,4,
Logan,U.S. House,Frank Lucas,REP,420201,0,6,122,128,03
Logan,U.S. House,Frankie Robbins,DEM,420201,2,2,38,42,03
Logan,State House,Greg Babinec,REP,420201,0,5,75,80,33
Logan,State House,Erin Adams,LIB,420201,0,1,8,9,33
Logan,State House,Caryl Talley,DEM,420201,2,2,77,81,33
Logan,President,Donald Trump,REP,420203,31,21,185,237,
Logan,President,Gary Johnson,LIB,420203,3,1,21,25,
Logan,President,Hillary Clinton,DEM,420203,11,10,87,108,
Logan,U.S. Senate,James Lankford,REP,420203,31,22,197,250,
Logan,U.S. Senate,Robert Murphy,LIB,420203,2,0,14,16,
Logan,U.S. Senate,Mike Workman,DEM,420203,9,7,74,90,
Logan,U.S. Senate,Mark Beard,IND,420203,1,1,7,9,
Logan,U.S. Senate,Sean Braddy,IND,420203,1,2,4,7,
Logan,U.S. House,Frank Lucas,REP,420203,30,21,201,252,03
Logan,U.S. House,Frankie Robbins,DEM,420203,14,11,91,116,03
Logan,State House,Kevin Wallace,REP,420203,27,21,194,242,32
Logan,State House,Billy Hinton,DEM,420203,16,11,99,126,32
Logan,President,Donald Trump,REP,420204,33,202,588,823,
Logan,President,Gary Johnson,LIB,420204,3,10,46,59,
Logan,President,Hillary Clinton,DEM,420204,20,105,205,330,
Logan,U.S. Senate,James Lankford,REP,420204,39,214,610,863,
Logan,U.S. Senate,Robert Murphy,LIB,420204,0,13,40,53,
Logan,U.S. Senate,Mike Workman,DEM,420204,15,72,160,247,
Logan,U.S. Senate,Mark Beard,IND,420204,2,6,8,16,
Logan,U.S. Senate,Sean Braddy,IND,420204,0,7,15,22,
Logan,U.S. House,Frank Lucas,REP,420204,39,215,633,887,03
Logan,U.S. House,Frankie Robbins,DEM,420204,17,93,194,304,03
Logan,State House,Jason Murphey,REP,420204,37,181,544,762,31
Logan,State House,John Tiller,DEM,420204,19,125,284,428,31
Logan,President,Donald Trump,REP,420205,77,292,877,1246,
Logan,President,Gary Johnson,LIB,420205,2,14,75,91,
Logan,President,Hillary Clinton,DEM,420205,21,81,185,287,
Logan,U.S. Senate,James Lankford,REP,420205,69,300,884,1253,
Logan,U.S. Senate,Robert Murphy,LIB,420205,5,14,65,84,
Logan,U.S. Senate,Mike Workman,DEM,420205,17,64,144,225,
Logan,U.S. Senate,Mark Beard,IND,420205,3,5,22,30,
Logan,U.S. Senate,Sean Braddy,IND,420205,3,4,25,32,
Logan,U.S. House,Frank Lucas,REP,420205,75,302,931,1308,03
Logan,U.S. House,Frankie Robbins,DEM,420205,23,86,206,315,03
Logan,State House,Jason Murphey,REP,420205,67,282,846,1195,31
Logan,State House,John Tiller,DEM,420205,31,105,283,419,31
Logan,President,Donald Trump,REP,420206,62,169,704,935,
Logan,President,Gary Johnson,LIB,420206,3,14,84,101,
Logan,President,Hillary Clinton,DEM,420206,27,47,228,302,
Logan,U.S. Senate,James Lankford,REP,420206,65,170,751,986,
Logan,U.S. Senate,Robert Murphy,LIB,420206,2,9,49,60,
Logan,U.S. Senate,Mike Workman,DEM,420206,18,39,179,236,
Logan,U.S. Senate,Mark Beard,IND,420206,4,4,10,18,
Logan,U.S. Senate,Sean Braddy,IND,420206,4,7,30,41,
Logan,U.S. House,Frank Lucas,REP,420206,68,176,751,995,03
Logan,U.S. House,Frankie Robbins,DEM,420206,24,49,256,329,03
Logan,State House,Jason Murphey,REP,420206,65,175,742,982,31
Logan,State House,John Tiller,DEM,420206,25,53,265,343,31
Logan,President,Donald Trump,REP,420207,92,225,881,1198,
Logan,President,Gary Johnson,LIB,420207,10,14,77,101,
Logan,President,Hillary Clinton,DEM,420207,55,42,213,310,
Logan,U.S. Senate,James Lankford,REP,420207,102,227,928,1257,
Logan,U.S. Senate,Robert Murphy,LIB,420207,7,11,42,60,
Logan,U.S. Senate,Mike Workman,DEM,420207,46,31,166,243,
Logan,U.S. Senate,Mark Beard,IND,420207,0,3,23,26,
Logan,U.S. Senate,Sean Braddy,IND,420207,7,4,19,30,
Logan,U.S. House,Frank Lucas,REP,420207,105,232,927,1264,03
Logan,U.S. House,Frankie Robbins,DEM,420207,57,43,234,334,03
Logan,State House,Jason Murphey,REP,420207,101,223,896,1220,31
Logan,State House,John Tiller,DEM,420207,58,52,262,372,31
Logan,President,Donald Trump,REP,420301,5,7,165,177,
Logan,President,Gary Johnson,LIB,420301,0,0,7,7,
Logan,President,Hillary Clinton,DEM,420301,0,0,6,6,
Logan,U.S. Senate,James Lankford,REP,420301,4,7,163,174,
Logan,U.S. Senate,Robert Murphy,LIB,420301,0,0,6,6,
Logan,U.S. Senate,Mike Workman,DEM,420301,0,0,5,5,
Logan,U.S. Senate,Mark Beard,IND,420301,0,0,4,4,
Logan,U.S. Senate,Sean Braddy,IND,420301,0,0,2,2,
Logan,U.S. House,Frank Lucas,REP,420301,4,7,164,175,03
Logan,U.S. House,Frankie Robbins,DEM,420301,0,0,15,15,03
Logan,President,Donald Trump,REP,420302,2,1,93,96,
Logan,President,Gary Johnson,LIB,420302,1,0,5,6,
Logan,President,Hillary Clinton,DEM,420302,1,0,15,16,
Logan,U.S. Senate,James Lankford,REP,420302,1,1,102,104,
Logan,U.S. Senate,Robert Murphy,LIB,420302,1,0,0,1,
Logan,U.S. Senate,Mike Workman,DEM,420302,2,0,11,13,
Logan,U.S. Senate,Mark Beard,IND,420302,0,0,1,1,
Logan,U.S. Senate,Sean Braddy,IND,420302,0,0,0,0,
Logan,U.S. House,Frank Lucas,REP,420302,1,1,106,108,03
Logan,U.S. House,Frankie Robbins,DEM,420302,3,0,6,9,03
Logan,President,Donald Trump,REP,420303,44,53,910,1007,
Logan,President,Gary Johnson,LIB,420303,2,4,50,56,
Logan,President,Hillary Clinton,DEM,420303,12,15,173,200,
Logan,U.S. Senate,James Lankford,REP,420303,46,58,918,1022,
Logan,U.S. Senate,Robert Murphy,LIB,420303,0,3,33,36,
Logan,U.S. Senate,Mike Workman,DEM,420303,11,10,133,154,
Logan,U.S. Senate,Mark Beard,IND,420303,0,1,21,22,
Logan,U.S. Senate,Sean Braddy,IND,420303,1,1,22,24,
Logan,U.S. House,Frank Lucas,REP,420303,44,57,918,1019,03
Logan,U.S. House,Frankie Robbins,DEM,420303,14,14,196,224,03
Logan,President,Donald Trump,REP,420304,12,8,251,271,
Logan,President,Gary Johnson,LIB,420304,0,0,10,10,
Logan,President,Hillary Clinton,DEM,420304,0,0,29,29,
Logan,U.S. Senate,James Lankford,REP,420304,12,7,263,282,
Logan,U.S. Senate,Robert Murphy,LIB,420304,0,0,7,7,
Logan,U.S. Senate,Mike Workman,DEM,420304,0,0,20,20,
Logan,U.S. Senate,Mark Beard,IND,420304,0,0,0,0,
Logan,U.S. Senate,Sean Braddy,IND,420304,0,0,1,1,
Logan,U.S. House,Frank Lucas,REP,420304,12,7,251,270,03
Logan,U.S. House,Frankie Robbins,DEM,420304,0,0,34,34,03
Logan,President,Donald Trump,REP,420305,43,101,435,579,
Logan,President,Gary Johnson,LIB,420305,0,6,38,44,
Logan,President,Hillary Clinton,DEM,420305,20,35,120,175,
Logan,U.S. Senate,James Lankford,REP,420305,45,103,436,584,
Logan,U.S. Senate,Robert Murphy,LIB,420305,0,2,33,35,
Logan,U.S. Senate,Mike Workman,DEM,420305,13,26,97,136,
Logan,U.S. Senate,Mark Beard,IND,420305,1,7,16,24,
Logan,U.S. Senate,Sean Braddy,IND,420305,2,4,10,16,
Logan,U.S. House,Frank Lucas,REP,420305,46,108,455,609,03
Logan,U.S. House,Frankie Robbins,DEM,420305,15,31,127,173,03
Logan,President,Donald Trump,REP,420306,6,25,176,207,
Logan,President,Gary Johnson,LIB,420306,0,1,16,17,
Logan,President,Hillary Clinton,DEM,420306,8,16,54,78,
Logan,U.S. Senate,James Lankford,REP,420306,7,25,188,220,
Logan,U.S. Senate,Robert Murphy,LIB,420306,0,2,10,12,
Logan,U.S. Senate,Mike Workman,DEM,420306,7,11,36,54,
Logan,U.S. Senate,Mark Beard,IND,420306,0,3,5,8,
Logan,U.S. Senate,Sean Braddy,IND,420306,0,1,6,7,
Logan,U.S. House,Frank Lucas,REP,420306,6,26,192,224,03
Logan,U.S. House,Frankie Robbins,DEM,420306,8,16,51,75,03
Logan,State House,Jason Murphey,REP,420306,9,28,171,208,31
Logan,State House,John Tiller,DEM,420306,5,14,70,89,31
Logan,President,Donald Trump,REP,420307,42,135,451,628,
Logan,President,Gary Johnson,LIB,420307,2,9,50,61,
Logan,President,Hillary Clinton,DEM,420307,24,90,181,295,
Logan,U.S. Senate,James Lankford,REP,420307,47,139,466,652,
Logan,U.S. Senate,Robert Murphy,LIB,420307,2,8,43,53,
Logan,U.S. Senate,Mike Workman,DEM,420307,17,76,142,235,
Logan,U.S. Senate,Mark Beard,IND,420307,0,1,15,16,
Logan,U.S. Senate,Sean Braddy,IND,420307,2,9,20,31,
Logan,U.S. House,Frank Lucas,REP,420307,45,144,473,662,03
Logan,U.S. House,Frankie Robbins,DEM,420307,21,87,203,311,03
Logan,State House,Jason Murphey,REP,420307,41,130,398,569,31
Logan,State House,John Tiller,DEM,420307,25,98,279,402,31
Logan,President,Donald Trump,REP,420308,10,106,361,477,
Logan,President,Gary Johnson,LIB,420308,1,10,40,51,
Logan,President,Hillary Clinton,DEM,420308,18,108,238,364,
Logan,U.S. Senate,James Lankford,REP,420308,12,122,396,530,
Logan,U.S. Senate,Robert Murphy,LIB,420308,0,2,28,30,
Logan,U.S. Senate,Mike Workman,DEM,420308,16,91,189,296,
Logan,U.S. Senate,Mark Beard,IND,420308,0,3,13,16,
Logan,U.S. Senate,Sean Braddy,IND,420308,1,4,12,17,
Logan,U.S. House,Frank Lucas,REP,420308,13,123,395,531,03
Logan,U.S. House,Frankie Robbins,DEM,420308,15,98,241,354,03
Logan,State House,Jason Murphey,REP,420308,12,97,345,454,31
Logan,State House,John Tiller,DEM,420308,16,124,290,430,31
Logan,President,Donald Trump,REP,420309,3,3,19,25,
Logan,President,Gary Johnson,LIB,420309,1,0,1,2,
Logan,President,Hillary Clinton,DEM,420309,0,5,19,24,
Logan,U.S. Senate,James Lankford,REP,420309,2,3,23,28,
Logan,U.S. Senate,Robert Murphy,LIB,420309,2,1,0,3,
Logan,U.S. Senate,Mike Workman,DEM,420309,0,3,16,19,
Logan,U.S. Senate,Mark Beard,IND,420309,0,1,0,1,
Logan,U.S. Senate,Sean Braddy,IND,420309,0,0,0,0,
Logan,U.S. House,Frank Lucas,REP,420309,4,3,22,29,03
Logan,U.S. House,Frankie Robbins,DEM,420309,0,5,17,22,03
Logan,State House,Greg Babinec,REP,420309,2,3,18,23,33
Logan,State House,Erin Adams,LIB,420309,2,1,0,3,33
Logan,State House,Caryl Talley,DEM,420309,0,4,20,24,33
Logan,President,Donald Trump,REP,420310,0,0,6,6,
Logan,President,Gary Johnson,LIB,420310,0,3,13,16,
Logan,President,Hillary Clinton,DEM,420310,9,14,334,357,
Logan,U.S. Senate,James Lankford,REP,420310,0,2,17,19,
Logan,U.S. Senate,Robert Murphy,LIB,420310,0,1,7,8,
Logan,U.S. Senate,Mike Workman,DEM,420310,7,12,295,314,
Logan,U.S. Senate,Mark Beard,IND,420310,0,1,17,18,
Logan,U.S. Senate,Sean Braddy,IND,420310,1,0,17,18,
Logan,U.S. House,Frank Lucas,REP,420310,1,0,22,23,03
Logan,U.S. House,Frankie Robbins,DEM,420310,7,16,330,353,03
Logan,State House,Kevin Wallace,REP,420310,1,0,15,16,32
Logan,State House,Billy Hinton,DEM,420310,7,16,337,360,32
Love,President,Donald Trump,REP,430101,5,34,217,256,
Love,President,Gary Johnson,LIB,430101,1,2,11,14,
Love,President,Hillary Clinton,DEM,430101,1,13,68,82,
Love,U.S. Senate,James Lankford,REP,430101,6,34,195,235,
Love,U.S. Senate,Robert Murphy,LIB,430101,0,0,6,6,
Love,U.S. Senate,Mike Workman,DEM,430101,1,13,74,88,
Love,U.S. Senate,Mark Beard,IND,430101,0,1,8,9,
Love,U.S. Senate,Sean Braddy,IND,430101,0,1,9,10,
Love,U.S. House,Tom Cole,REP,430101,6,34,225,265,04
Love,U.S. House,Sevier White,LIB,430101,0,0,13,13,04
Love,U.S. House,Christina Owen,DEM,430101,1,15,57,73,04
Love,State House,Tommy Hardin,REP,430101,6,34,220,260,49
Love,State House,Michelle Bray,DEM,430101,1,15,73,89,49
Love,President,Donald Trump,REP,430102,5,61,226,292,
Love,President,Gary Johnson,LIB,430102,0,3,8,11,
Love,President,Hillary Clinton,DEM,430102,1,8,30,39,
Love,U.S. Senate,James Lankford,REP,430102,4,51,203,258,
Love,U.S. Senate,Robert Murphy,LIB,430102,0,3,2,5,
Love,U.S. Senate,Mike Workman,DEM,430102,1,12,46,59,
Love,U.S. Senate,Mark Beard,IND,430102,0,1,2,3,
Love,U.S. Senate,Sean Braddy,IND,430102,0,2,2,4,
Love,U.S. House,Tom Cole,REP,430102,4,57,224,285,04
Love,U.S. House,Sevier White,LIB,430102,0,1,0,1,04
Love,U.S. House,Christina Owen,DEM,430102,1,14,33,48,04
Love,State House,Tommy Hardin,REP,430102,4,59,220,283,49
Love,State House,Michelle Bray,DEM,430102,1,13,40,54,49
Love,President,Donald Trump,REP,430103,17,56,450,523,
Love,President,Gary Johnson,LIB,430103,0,2,19,21,
Love,President,Hillary Clinton,DEM,430103,3,11,85,99,
Love,U.S. Senate,James Lankford,REP,430103,12,52,372,436,
Love,U.S. Senate,Robert Murphy,LIB,430103,0,0,17,17,
Love,U.S. Senate,Mike Workman,DEM,430103,4,11,123,138,
Love,U.S. Senate,Mark Beard,IND,430103,2,1,16,19,
Love,U.S. Senate,Sean Braddy,IND,430103,0,4,13,17,
Love,U.S. House,Tom Cole,REP,430103,15,57,433,505,04
Love,U.S. House,Sevier White,LIB,430103,0,0,20,20,04
Love,U.S. House,Christina Owen,DEM,430103,3,11,94,108,04
Love,State House,Tommy Hardin,REP,430103,14,54,417,485,49
Love,State House,Michelle Bray,DEM,430103,4,13,125,142,49
Love,President,Donald Trump,REP,430204,6,39,179,224,
Love,President,Gary Johnson,LIB,430204,1,1,12,14,
Love,President,Hillary Clinton,DEM,430204,4,20,65,89,
Love,U.S. Senate,James Lankford,REP,430204,5,37,161,203,
Love,U.S. Senate,Robert Murphy,LIB,430204,1,1,8,10,
Love,U.S. Senate,Mike Workman,DEM,430204,4,22,74,100,
Love,U.S. Senate,Mark Beard,IND,430204,0,0,6,6,
Love,U.S. Senate,Sean Braddy,IND,430204,0,1,4,5,
Love,U.S. House,Tom Cole,REP,430204,4,42,174,220,04
Love,U.S. House,Sevier White,LIB,430204,1,0,10,11,04
Love,U.S. House,Christina Owen,DEM,430204,6,19,72,97,04
Love,State House,Tommy Hardin,REP,430204,5,42,177,224,49
Love,State House,Michelle Bray,DEM,430204,5,19,75,99,49
Love,President,Donald Trump,REP,430205,11,69,335,415,
Love,President,Gary Johnson,LIB,430205,1,4,11,16,
Love,President,Hillary Clinton,DEM,430205,3,9,60,72,
Love,U.S. Senate,James Lankford,REP,430205,12,69,299,380,
Love,U.S. Senate,Robert Murphy,LIB,430205,0,0,8,8,
Love,U.S. Senate,Mike Workman,DEM,430205,3,9,80,92,
Love,U.S. Senate,Mark Beard,IND,430205,0,1,6,7,
Love,U.S. Senate,Sean Braddy,IND,430205,0,2,5,7,
Love,U.S. House,Tom Cole,REP,430205,12,71,322,405,04
Love,U.S. House,Sevier White,LIB,430205,0,1,9,10,04
Love,U.S. House,Christina Owen,DEM,430205,3,10,71,84,04
Love,State House,Tommy Hardin,REP,430205,12,69,299,380,49
Love,State House,Michelle Bray,DEM,430205,3,12,96,111,49
Love,President,Donald Trump,REP,430206,6,11,128,145,
Love,President,Gary Johnson,LIB,430206,1,1,6,8,
Love,President,Hillary Clinton,DEM,430206,0,3,35,38,
Love,U.S. Senate,James Lankford,REP,430206,6,9,107,122,
Love,U.S. Senate,Robert Murphy,LIB,430206,0,2,3,5,
Love,U.S. Senate,Mike Workman,DEM,430206,1,4,42,47,
Love,U.S. Senate,Mark Beard,IND,430206,0,0,4,4,
Love,U.S. Senate,Sean Braddy,IND,430206,0,0,6,6,
Love,U.S. House,Tom Cole,REP,430206,6,12,130,148,04
Love,U.S. House,Sevier White,LIB,430206,0,0,5,5,04
Love,U.S. House,Christina Owen,DEM,430206,1,2,34,37,04
Love,State House,Tommy Hardin,REP,430206,7,10,126,143,49
Love,State House,Michelle Bray,DEM,430206,0,5,42,47,49
Love,President,Donald Trump,REP,430207,2,4,47,53,
Love,President,Gary Johnson,LIB,430207,0,0,3,3,
Love,President,Hillary Clinton,DEM,430207,2,2,29,33,
Love,U.S. Senate,James Lankford,REP,430207,3,5,35,43,
Love,U.S. Senate,Robert Murphy,LIB,430207,0,0,2,2,
Love,U.S. Senate,Mike Workman,DEM,430207,1,1,36,38,
Love,U.S. Senate,Mark Beard,IND,430207,0,0,2,2,
Love,U.S. Senate,Sean Braddy,IND,430207,0,0,2,2,
Love,U.S. House,Tom Cole,REP,430207,3,6,44,53,04
Love,U.S. House,Sevier White,LIB,430207,0,0,3,3,04
Love,U.S. House,Christina Owen,DEM,430207,1,0,32,33,04
Love,State House,Tommy Hardin,REP,430207,3,6,47,56,49
Love,State House,Michelle Bray,DEM,430207,1,0,30,31,49
Love,President,Donald Trump,REP,430208,0,3,35,38,
Love,President,Gary Johnson,LIB,430208,0,0,3,3,
Love,President,Hillary Clinton,DEM,430208,0,0,9,9,
Love,U.S. Senate,James Lankford,REP,430208,0,2,27,29,
Love,U.S. Senate,Robert Murphy,LIB,430208,0,0,4,4,
Love,U.S. Senate,Mike Workman,DEM,430208,0,1,11,12,
Love,U.S. Senate,Mark Beard,IND,430208,0,0,3,3,
Love,U.S. Senate,Sean Braddy,IND,430208,0,0,2,2,
Love,U.S. House,Tom Cole,REP,430208,0,3,37,40,04
Love,U.S. House,Sevier White,LIB,430208,0,0,2,2,04
Love,U.S. House,Christina Owen,DEM,430208,0,0,8,8,04
Love,State House,Tommy Hardin,REP,430208,0,3,37,40,49
Love,State House,Michelle Bray,DEM,430208,0,0,9,9,49
Love,President,Donald Trump,REP,430310,3,32,231,266,
Love,President,Gary Johnson,LIB,430310,1,4,10,15,
Love,President,Hillary Clinton,DEM,430310,2,15,88,105,
Love,U.S. Senate,James Lankford,REP,430310,3,30,207,240,
Love,U.S. Senate,Robert Murphy,LIB,430310,1,2,12,15,
Love,U.S. Senate,Mike Workman,DEM,430310,2,15,84,101,
Love,U.S. Senate,Mark Beard,IND,430310,0,3,7,10,
Love,U.S. Senate,Sean Braddy,IND,430310,0,1,11,12,
Love,U.S. House,Tom Cole,REP,430310,3,33,244,280,04
Love,U.S. House,Sevier White,LIB,430310,1,2,9,12,04
Love,U.S. House,Christina Owen,DEM,430310,2,16,70,88,04
Love,State House,Tommy Hardin,REP,430310,4,32,238,274,49
Love,State House,Michelle Bray,DEM,430310,2,19,87,108,49
Love,President,Donald Trump,REP,430311,12,41,249,302,
Love,President,Gary Johnson,LIB,430311,1,5,6,12,
Love,President,Hillary Clinton,DEM,430311,4,10,55,69,
Love,U.S. Senate,James Lankford,REP,430311,12,40,230,282,
Love,U.S. Senate,Robert Murphy,LIB,430311,0,2,3,5,
Love,U.S. Senate,Mike Workman,DEM,430311,4,12,56,72,
Love,U.S. Senate,Mark Beard,IND,430311,1,0,11,12,
Love,U.S. Senate,Sean Braddy,IND,430311,0,2,8,10,
Love,U.S. House,Tom Cole,REP,430311,11,42,242,295,04
Love,U.S. House,Sevier White,LIB,430311,0,2,10,12,04
Love,U.S. House,Christina Owen,DEM,430311,6,12,58,76,04
Love,State House,Tommy Hardin,REP,430311,12,46,241,299,49
Love,State House,Michelle Bray,DEM,430311,5,10,68,83,49
Love,President,Donald Trump,REP,430312,3,35,241,279,
Love,President,Gary Johnson,LIB,430312,0,1,5,6,
Love,President,Hillary Clinton,DEM,430312,8,1,55,64,
Love,U.S. Senate,James Lankford,REP,430312,4,29,212,245,
Love,U.S. Senate,Robert Murphy,LIB,430312,0,1,13,14,
Love,U.S. Senate,Mike Workman,DEM,430312,6,3,62,71,
Love,U.S. Senate,Mark Beard,IND,430312,0,2,6,8,
Love,U.S. Senate,Sean Braddy,IND,430312,1,1,5,7,
Love,U.S. House,Tom Cole,REP,430312,5,32,240,277,04
Love,U.S. House,Sevier White,LIB,430312,0,2,6,8,04
Love,U.S. House,Christina Owen,DEM,430312,6,3,53,62,04
Love,State House,Tommy Hardin,REP,430312,3,33,230,266,49
Love,State House,Michelle Bray,DEM,430312,8,3,70,81,49
Love,President,Donald Trump,REP,430313,2,15,112,129,
Love,President,Gary Johnson,LIB,430313,0,2,7,9,
Love,President,Hillary Clinton,DEM,430313,0,2,34,36,
Love,U.S. Senate,James Lankford,REP,430313,2,15,110,127,
Love,U.S. Senate,Robert Murphy,LIB,430313,0,0,4,4,
Love,U.S. Senate,Mike Workman,DEM,430313,0,3,34,37,
Love,U.S. Senate,Mark Beard,IND,430313,0,1,1,2,
Love,U.S. Senate,Sean Braddy,IND,430313,0,0,2,2,
Love,U.S. House,Tom Cole,REP,430313,2,16,117,135,04
Love,U.S. House,Sevier White,LIB,430313,0,1,4,5,04
Love,U.S. House,Christina Owen,DEM,430313,0,2,32,34,04
Love,State House,Tommy Hardin,REP,430313,2,15,112,129,49
Love,State House,Michelle Bray,DEM,430313,0,4,39,43,49
Mcclain,President,Donald Trump,REP,440001,3,3,237,243,
Mcclain,President,Gary Johnson,LIB,440001,0,0,9,9,
Mcclain,President,Hillary Clinton,DEM,440001,1,0,28,29,
Mcclain,U.S. Senate,James Lankford,REP,440001,3,3,248,254,
Mcclain,U.S. Senate,Robert Murphy,LIB,440001,0,0,2,2,
Mcclain,U.S. Senate,Mike Workman,DEM,440001,0,0,22,22,
Mcclain,U.S. Senate,Mark Beard,IND,440001,0,0,2,2,
Mcclain,U.S. Senate,Sean Braddy,IND,440001,0,0,4,4,
Mcclain,U.S. House,Tom Cole,REP,440001,3,3,241,247,04
Mcclain,U.S. House,Sevier White,LIB,440001,0,0,4,4,04
Mcclain,U.S. House,Christina Owen,DEM,440001,0,0,31,31,04
Mcclain,State Senate,Paul Scott,REP,440001,3,3,217,223,43
Mcclain,State Senate,Leah Pollan,DEM,440001,0,0,56,56,43
Mcclain,State House,Bobby Cleveland,REP,440001,3,3,225,231,20
Mcclain,State House,Matt Failing,DEM,440001,0,0,47,47,20
Mcclain,President,Donald Trump,REP,440002,11,12,160,183,
Mcclain,President,Gary Johnson,LIB,440002,0,0,12,12,
Mcclain,President,Hillary Clinton,DEM,440002,2,0,42,44,
Mcclain,U.S. Senate,James Lankford,REP,440002,9,12,163,184,
Mcclain,U.S. Senate,Robert Murphy,LIB,440002,0,0,7,7,
Mcclain,U.S. Senate,Mike Workman,DEM,440002,2,0,35,37,
Mcclain,U.S. Senate,Mark Beard,IND,440002,2,0,5,7,
Mcclain,U.S. Senate,Sean Braddy,IND,440002,0,0,1,1,
Mcclain,U.S. House,Tom Cole,REP,440002,9,12,162,183,04
Mcclain,U.S. House,Sevier White,LIB,440002,0,0,10,10,04
Mcclain,U.S. House,Christina Owen,DEM,440002,2,0,39,41,04
Mcclain,State Senate,Paul Scott,REP,440002,11,11,157,179,43
Mcclain,State Senate,Leah Pollan,DEM,440002,2,1,54,57,43
Mcclain,State House,Bobby Cleveland,REP,440002,11,12,160,183,20
Mcclain,State House,Matt Failing,DEM,440002,2,0,51,53,20
Mcclain,President,Donald Trump,REP,440003,7,27,129,163,
Mcclain,President,Gary Johnson,LIB,440003,1,1,16,18,
Mcclain,President,Hillary Clinton,DEM,440003,5,1,25,31,
Mcclain,U.S. Senate,James Lankford,REP,440003,8,23,133,164,
Mcclain,U.S. Senate,Robert Murphy,LIB,440003,1,1,7,9,
Mcclain,U.S. Senate,Mike Workman,DEM,440003,4,3,25,32,
Mcclain,U.S. Senate,Mark Beard,IND,440003,0,1,4,5,
Mcclain,U.S. Senate,Sean Braddy,IND,440003,0,1,2,3,
Mcclain,U.S. House,Tom Cole,REP,440003,8,22,134,164,04
Mcclain,U.S. House,Sevier White,LIB,440003,1,4,9,14,04
Mcclain,U.S. House,Christina Owen,DEM,440003,4,3,27,34,04
Mcclain,State Senate,Paul Scott,REP,440003,8,21,118,147,43
Mcclain,State Senate,Leah Pollan,DEM,440003,5,7,53,65,43
Mcclain,State House,Bobby Cleveland,REP,440003,9,22,114,145,20
Mcclain,State House,Matt Failing,DEM,440003,4,6,56,66,20
Mcclain,President,Donald Trump,REP,440004,8,16,243,267,
Mcclain,President,Gary Johnson,LIB,440004,0,0,17,17,
Mcclain,President,Hillary Clinton,DEM,440004,1,7,81,89,
Mcclain,U.S. Senate,James Lankford,REP,440004,7,17,264,288,
Mcclain,U.S. Senate,Robert Murphy,LIB,440004,0,1,3,4,
Mcclain,U.S. Senate,Mike Workman,DEM,440004,1,5,62,68,
Mcclain,U.S. Senate,Mark Beard,IND,440004,1,1,4,6,
Mcclain,U.S. Senate,Sean Braddy,IND,440004,0,0,10,10,
Mcclain,U.S. House,Tom Cole,REP,440004,5,16,260,281,04
Mcclain,U.S. House,Sevier White,LIB,440004,1,1,7,9,04
Mcclain,U.S. House,Christina Owen,DEM,440004,1,7,76,84,04
Mcclain,State Senate,Paul Scott,REP,440004,5,17,228,250,43
Mcclain,State Senate,Leah Pollan,DEM,440004,2,6,113,121,43
Mcclain,State House,Tim Downing,REP,440004,5,15,238,258,42
Mcclain,State House,Liz George,DEM,440004,2,9,104,115,42
Mcclain,President,Donald Trump,REP,440005,32,41,478,551,
Mcclain,President,Gary Johnson,LIB,440005,0,4,23,27,
Mcclain,President,Hillary Clinton,DEM,440005,9,7,60,76,
Mcclain,U.S. Senate,James Lankford,REP,440005,32,46,463,541,
Mcclain,U.S. Senate,Robert Murphy,LIB,440005,1,3,21,25,
Mcclain,U.S. Senate,Mike Workman,DEM,440005,8,2,53,63,
Mcclain,U.S. Senate,Mark Beard,IND,440005,0,0,11,11,
Mcclain,U.S. Senate,Sean Braddy,IND,440005,1,0,11,12,
Mcclain,U.S. House,Tom Cole,REP,440005,32,44,469,545,04
Mcclain,U.S. House,Sevier White,LIB,440005,1,3,28,32,04
Mcclain,U.S. House,Christina Owen,DEM,440005,9,5,65,79,04
Mcclain,State Senate,Paul Scott,REP,440005,31,41,444,516,43
Mcclain,State Senate,Leah Pollan,DEM,440005,11,11,110,132,43
Mcclain,State House,Tim Downing,REP,440005,33,41,434,508,42
Mcclain,State House,Liz George,DEM,440005,9,11,123,143,42
Mcclain,President,Donald Trump,REP,440006,29,208,537,774,
Mcclain,President,Gary Johnson,LIB,440006,0,8,29,37,
Mcclain,President,Hillary Clinton,DEM,440006,7,32,104,143,
Mcclain,U.S. Senate,James Lankford,REP,440006,31,207,532,770,
Mcclain,U.S. Senate,Robert Murphy,LIB,440006,0,2,14,16,
Mcclain,U.S. Senate,Mike Workman,DEM,440006,5,24,104,133,
Mcclain,U.S. Senate,Mark Beard,IND,440006,0,9,10,19,
Mcclain,U.S. Senate,Sean Braddy,IND,440006,0,7,8,15,
Mcclain,U.S. House,Tom Cole,REP,440006,31,204,542,777,04
Mcclain,U.S. House,Sevier White,LIB,440006,0,10,17,27,04
Mcclain,U.S. House,Christina Owen,DEM,440006,5,34,109,148,04
Mcclain,State Senate,Paul Scott,REP,440006,29,195,485,709,43
Mcclain,State Senate,Leah Pollan,DEM,440006,7,49,174,230,43
Mcclain,State House,Tim Downing,REP,440006,29,198,495,722,42
Mcclain,State House,Liz George,DEM,440006,7,51,166,224,42
Mcclain,President,Donald Trump,REP,440007,13,42,233,288,
Mcclain,President,Gary Johnson,LIB,440007,0,4,11,15,
Mcclain,President,Hillary Clinton,DEM,440007,3,5,51,59,
Mcclain,U.S. Senate,James Lankford,REP,440007,13,38,226,277,
Mcclain,U.S. Senate,Robert Murphy,LIB,440007,0,0,6,6,
Mcclain,U.S. Senate,Mike Workman,DEM,440007,2,6,52,60,
Mcclain,U.S. Senate,Mark Beard,IND,440007,0,1,6,7,
Mcclain,U.S. Senate,Sean Braddy,IND,440007,1,5,3,9,
Mcclain,U.S. House,Tom Cole,REP,440007,12,41,215,268,04
Mcclain,U.S. House,Sevier White,LIB,440007,1,2,19,22,04
Mcclain,U.S. House,Christina Owen,DEM,440007,3,8,56,67,04
Mcclain,State Senate,Paul Scott,REP,440007,13,34,207,254,43
Mcclain,State Senate,Leah Pollan,DEM,440007,3,16,85,104,43
Mcclain,State House,Tim Downing,REP,440007,14,39,209,262,42
Mcclain,State House,Liz George,DEM,440007,2,12,82,96,42
Mcclain,President,Donald Trump,REP,440008,35,54,618,707,
Mcclain,President,Gary Johnson,LIB,440008,2,2,37,41,
Mcclain,President,Hillary Clinton,DEM,440008,4,8,110,122,
Mcclain,U.S. Senate,James Lankford,REP,440008,37,58,626,721,
Mcclain,U.S. Senate,Robert Murphy,LIB,440008,1,1,20,22,
Mcclain,U.S. Senate,Mike Workman,DEM,440008,3,4,95,102,
Mcclain,U.S. Senate,Mark Beard,IND,440008,0,2,7,9,
Mcclain,U.S. Senate,Sean Braddy,IND,440008,0,0,17,17,
Mcclain,U.S. House,Tom Cole,REP,440008,37,59,627,723,04
Mcclain,U.S. House,Sevier White,LIB,440008,1,3,31,35,04
Mcclain,U.S. House,Christina Owen,DEM,440008,3,2,104,109,04
Mcclain,State Senate,Paul Scott,REP,440008,31,51,570,652,43
Mcclain,State Senate,Leah Pollan,DEM,440008,9,13,185,207,43
Mcclain,State House,Tim Downing,REP,440008,35,51,559,645,42
Mcclain,State House,Liz George,DEM,440008,6,14,197,217,42
Mcclain,President,Donald Trump,REP,440009,40,55,500,595,
Mcclain,President,Gary Johnson,LIB,440009,5,3,37,45,
Mcclain,President,Hillary Clinton,DEM,440009,19,28,172,219,
Mcclain,U.S. Senate,James Lankford,REP,440009,48,56,525,629,
Mcclain,U.S. Senate,Robert Murphy,LIB,440009,1,1,26,28,
Mcclain,U.S. Senate,Mike Workman,DEM,440009,16,24,131,171,
Mcclain,U.S. Senate,Mark Beard,IND,440009,0,1,8,9,
Mcclain,U.S. Senate,Sean Braddy,IND,440009,2,3,18,23,
Mcclain,U.S. House,Tom Cole,REP,440009,51,63,531,645,04
Mcclain,U.S. House,Sevier White,LIB,440009,0,0,34,34,04
Mcclain,U.S. House,Christina Owen,DEM,440009,16,23,143,182,04
Mcclain,State Senate,Paul Scott,REP,440009,42,56,488,586,43
Mcclain,State Senate,Leah Pollan,DEM,440009,23,29,214,266,43
Mcclain,State House,Bobby Cleveland,REP,440009,46,55,520,621,20
Mcclain,State House,Matt Failing,DEM,440009,20,30,184,234,20
Mcclain,President,Donald Trump,REP,440010,8,20,198,226,
Mcclain,President,Gary Johnson,LIB,440010,0,1,9,10,
Mcclain,President,Hillary Clinton,DEM,440010,0,2,24,26,
Mcclain,U.S. Senate,James Lankford,REP,440010,7,19,192,218,
Mcclain,U.S. Senate,Robert Murphy,LIB,440010,1,0,2,3,
Mcclain,U.S. Senate,Mike Workman,DEM,440010,0,2,26,28,
Mcclain,U.S. Senate,Mark Beard,IND,440010,0,1,5,6,
Mcclain,U.S. Senate,Sean Braddy,IND,440010,0,0,4,4,
Mcclain,U.S. House,Tom Cole,REP,440010,6,20,198,224,04
Mcclain,U.S. House,Sevier White,LIB,440010,2,1,6,9,04
Mcclain,U.S. House,Christina Owen,DEM,440010,0,2,23,25,04
Mcclain,State Senate,Paul Scott,REP,440010,5,19,186,210,43
Mcclain,State Senate,Leah Pollan,DEM,440010,2,3,41,46,43
Mcclain,State House,Tim Downing,REP,440010,5,19,179,203,42
Mcclain,State House,Liz George,DEM,440010,3,3,49,55,42
Mcclain,President,Donald Trump,REP,440011,10,29,311,350,
Mcclain,President,Gary Johnson,LIB,440011,0,2,16,18,
Mcclain,President,Hillary Clinton,DEM,440011,2,4,57,63,
Mcclain,U.S. Senate,James Lankford,REP,440011,11,28,310,349,
Mcclain,U.S. Senate,Robert Murphy,LIB,440011,0,1,13,14,
Mcclain,U.S. Senate,Mike Workman,DEM,440011,1,4,47,52,
Mcclain,U.S. Senate,Mark Beard,IND,440011,0,0,3,3,
Mcclain,U.S. Senate,Sean Braddy,IND,440011,0,2,6,8,
Mcclain,U.S. House,Tom Cole,REP,440011,11,29,314,354,04
Mcclain,U.S. House,Sevier White,LIB,440011,0,0,12,12,04
Mcclain,U.S. House,Christina Owen,DEM,440011,1,6,54,61,04
Mcclain,State Senate,Paul Scott,REP,440011,10,29,294,333,43
Mcclain,State Senate,Leah Pollan,DEM,440011,2,6,80,88,43
Mcclain,State House,Tim Downing,REP,440011,10,28,293,331,42
Mcclain,State House,Liz George,DEM,440011,2,6,83,91,42
Mcclain,President,Donald Trump,REP,440012,38,66,865,969,
Mcclain,President,Gary Johnson,LIB,440012,9,5,45,59,
Mcclain,President,Hillary Clinton,DEM,440012,19,9,162,190,
Mcclain,U.S. Senate,James Lankford,REP,440012,44,67,879,990,
Mcclain,U.S. Senate,Robert Murphy,LIB,440012,3,1,27,31,
Mcclain,U.S. Senate,Mike Workman,DEM,440012,16,6,133,155,
Mcclain,U.S. Senate,Mark Beard,IND,440012,2,2,15,19,
Mcclain,U.S. Senate,Sean Braddy,IND,440012,1,1,21,23,
Mcclain,U.S. House,Tom Cole,REP,440012,41,68,862,971,04
Mcclain,U.S. House,Sevier White,LIB,440012,5,3,50,58,04
Mcclain,U.S. House,Christina Owen,DEM,440012,19,7,160,186,04
Mcclain,State Senate,Paul Scott,REP,440012,36,64,809,909,43
Mcclain,State Senate,Leah Pollan,DEM,440012,30,11,256,297,43
Mcclain,State House,Tim Downing,REP,440012,37,62,686,785,42
Mcclain,State House,Liz George,DEM,440012,30,13,383,426,42
Mcclain,President,Donald Trump,REP,440013,162,102,1338,1602,
Mcclain,President,Gary Johnson,LIB,440013,8,3,109,120,
Mcclain,President,Hillary Clinton,DEM,440013,27,23,308,358,
Mcclain,U.S. Senate,James Lankford,REP,440013,169,95,1359,1623,
Mcclain,U.S. Senate,Robert Murphy,LIB,440013,0,3,56,59,
Mcclain,U.S. Senate,Mike Workman,DEM,440013,23,21,267,311,
Mcclain,U.S. Senate,Mark Beard,IND,440013,1,2,26,29,
Mcclain,U.S. Senate,Sean Braddy,IND,440013,5,6,45,56,
Mcclain,U.S. House,Tom Cole,REP,440013,160,98,1369,1627,04
Mcclain,U.S. House,Sevier White,LIB,440013,2,7,67,76,04
Mcclain,U.S. House,Christina Owen,DEM,440013,35,22,310,367,04
Mcclain,State Senate,Paul Scott,REP,440013,150,97,1267,1514,43
Mcclain,State Senate,Leah Pollan,DEM,440013,44,28,457,529,43
Mcclain,State House,Bobby Cleveland,REP,440013,157,100,1313,1570,20
Mcclain,State House,Matt Failing,DEM,440013,38,26,412,476,20
Mcclain,President,Donald Trump,REP,440014,38,19,435,492,
Mcclain,President,Gary Johnson,LIB,440014,1,2,21,24,
Mcclain,President,Hillary Clinton,DEM,440014,10,7,65,82,
Mcclain,U.S. Senate,James Lankford,REP,440014,42,18,442,502,
Mcclain,U.S. Senate,Robert Murphy,LIB,440014,0,0,7,7,
Mcclain,U.S. Senate,Mike Workman,DEM,440014,6,9,51,66,
Mcclain,U.S. Senate,Mark Beard,IND,440014,0,1,6,7,
Mcclain,U.S. Senate,Sean Braddy,IND,440014,1,0,11,12,
Mcclain,U.S. House,Tom Cole,REP,440014,39,20,445,504,04
Mcclain,U.S. House,Sevier White,LIB,440014,1,0,14,15,04
Mcclain,U.S. House,Christina Owen,DEM,440014,8,8,60,76,04
Mcclain,State Senate,Paul Scott,REP,440014,38,17,420,475,43
Mcclain,State Senate,Leah Pollan,DEM,440014,10,10,92,112,43
Mcclain,State House,Bobby Cleveland,REP,440014,39,16,426,481,20
Mcclain,State House,Matt Failing,DEM,440014,10,12,84,106,20
Mcclain,President,Donald Trump,REP,440015,51,29,716,796,
Mcclain,President,Gary Johnson,LIB,440015,2,1,42,45,
Mcclain,President,Hillary Clinton,DEM,440015,16,12,140,168,
Mcclain,U.S. Senate,James Lankford,REP,440015,50,31,741,822,
Mcclain,U.S. Senate,Robert Murphy,LIB,440015,3,2,26,31,
Mcclain,U.S. Senate,Mike Workman,DEM,440015,15,8,105,128,
Mcclain,U.S. Senate,Mark Beard,IND,440015,1,1,11,13,
Mcclain,U.S. Senate,Sean Braddy,IND,440015,2,0,17,19,
Mcclain,U.S. House,Tom Cole,REP,440015,51,27,726,804,04
Mcclain,U.S. House,Sevier White,LIB,440015,3,5,50,58,04
Mcclain,U.S. House,Christina Owen,DEM,440015,16,10,119,145,04
Mcclain,State Senate,Paul Scott,REP,440015,48,29,701,778,43
Mcclain,State Senate,Leah Pollan,DEM,440015,19,13,179,211,43
Mcclain,State House,Scott Biggs,REP,440015,45,32,706,783,51
Mcclain,State House,Charles Murdock,DEM,440015,23,10,171,204,51
Mcclain,President,Donald Trump,REP,440016,48,48,723,819,
Mcclain,President,Gary Johnson,LIB,440016,4,0,35,39,
Mcclain,President,Hillary Clinton,DEM,440016,18,11,158,187,
Mcclain,U.S. Senate,James Lankford,REP,440016,51,50,728,829,
Mcclain,U.S. Senate,Robert Murphy,LIB,440016,2,1,20,23,
Mcclain,U.S. Senate,Mike Workman,DEM,440016,16,6,138,160,
Mcclain,U.S. Senate,Mark Beard,IND,440016,1,1,10,12,
Mcclain,U.S. Senate,Sean Braddy,IND,440016,0,2,21,23,
Mcclain,U.S. House,Tom Cole,REP,440016,51,49,724,824,04
Mcclain,U.S. House,Sevier White,LIB,440016,1,1,39,41,04
Mcclain,U.S. House,Christina Owen,DEM,440016,18,9,153,180,04
Mcclain,State Senate,Paul Scott,REP,440016,45,50,652,747,43
Mcclain,State Senate,Leah Pollan,DEM,440016,25,10,257,292,43
Mcclain,State House,Tim Downing,REP,440016,33,42,509,584,42
Mcclain,State House,Liz George,DEM,440016,37,18,407,462,42
Mcclain,President,Donald Trump,REP,440017,11,6,154,171,
Mcclain,President,Gary Johnson,LIB,440017,0,0,10,10,
Mcclain,President,Hillary Clinton,DEM,440017,2,3,27,32,
Mcclain,U.S. Senate,James Lankford,REP,440017,12,5,155,172,
Mcclain,U.S. Senate,Robert Murphy,LIB,440017,0,0,4,4,
Mcclain,U.S. Senate,Mike Workman,DEM,440017,0,3,23,26,
Mcclain,U.S. Senate,Mark Beard,IND,440017,0,0,0,0,
Mcclain,U.S. Senate,Sean Braddy,IND,440017,1,1,8,10,
Mcclain,U.S. House,Tom Cole,REP,440017,13,5,156,174,04
Mcclain,U.S. House,Sevier White,LIB,440017,0,0,8,8,04
Mcclain,U.S. House,Christina Owen,DEM,440017,0,4,26,30,04
Mcclain,State Senate,Paul Scott,REP,440017,10,5,145,160,43
Mcclain,State Senate,Leah Pollan,DEM,440017,3,4,43,50,43
Mcclain,State House,Bobby Cleveland,REP,440017,11,6,143,160,20
Mcclain,State House,Matt Failing,DEM,440017,2,3,44,49,20
Mcclain,President,Donald Trump,REP,440018,37,8,432,477,
Mcclain,President,Gary Johnson,LIB,440018,1,1,22,24,
Mcclain,President,Hillary Clinton,DEM,440018,9,1,73,83,
Mcclain,U.S. Senate,James Lankford,REP,440018,41,8,447,496,
Mcclain,U.S. Senate,Robert Murphy,LIB,440018,1,1,9,11,
Mcclain,U.S. Senate,Mike Workman,DEM,440018,5,1,56,62,
Mcclain,U.S. Senate,Mark Beard,IND,440018,0,0,5,5,
Mcclain,U.S. Senate,Sean Braddy,IND,440018,0,0,14,14,
Mcclain,U.S. House,Tom Cole,REP,440018,39,9,437,485,04
Mcclain,U.S. House,Sevier White,LIB,440018,1,0,18,19,04
Mcclain,U.S. House,Christina Owen,DEM,440018,6,1,73,80,04
Mcclain,State Senate,Paul Scott,REP,440018,38,9,425,472,43
Mcclain,State Senate,Leah Pollan,DEM,440018,7,1,104,112,43
Mcclain,State House,Bobby Cleveland,REP,440018,35,8,418,461,20
Mcclain,State House,Matt Failing,DEM,440018,11,2,105,118,20
Mcclain,President,Donald Trump,REP,440019,35,35,545,615,
Mcclain,President,Gary Johnson,LIB,440019,1,0,37,38,
Mcclain,President,Hillary Clinton,DEM,440019,7,5,101,113,
Mcclain,U.S. Senate,James Lankford,REP,440019,37,34,546,617,
Mcclain,U.S. Senate,Robert Murphy,LIB,440019,0,0,25,25,
Mcclain,U.S. Senate,Mike Workman,DEM,440019,7,4,80,91,
Mcclain,U.S. Senate,Mark Beard,IND,440019,0,2,16,18,
Mcclain,U.S. Senate,Sean Braddy,IND,440019,0,0,17,17,
Mcclain,U.S. House,Tom Cole,REP,440019,36,35,540,611,04
Mcclain,U.S. House,Sevier White,LIB,440019,0,1,35,36,04
Mcclain,U.S. House,Christina Owen,DEM,440019,8,4,108,120,04
Mcclain,State Senate,Paul Scott,REP,440019,33,34,510,577,43
Mcclain,State Senate,Leah Pollan,DEM,440019,11,6,165,182,43
Mcclain,State House,Tim Downing,REP,440019,30,33,502,565,42
Mcclain,State House,Liz George,DEM,440019,14,7,177,198,42
Mcclain,President,Donald Trump,REP,440020,29,40,425,494,
Mcclain,President,Gary Johnson,LIB,440020,0,1,19,20,
Mcclain,President,Hillary Clinton,DEM,440020,1,8,74,83,
Mcclain,U.S. Senate,James Lankford,REP,440020,27,43,432,502,
Mcclain,U.S. Senate,Robert Murphy,LIB,440020,2,0,13,15,
Mcclain,U.S. Senate,Mike Workman,DEM,440020,1,6,57,64,
Mcclain,U.S. Senate,Mark Beard,IND,440020,0,0,5,5,
Mcclain,U.S. Senate,Sean Braddy,IND,440020,0,1,10,11,
Mcclain,U.S. House,Tom Cole,REP,440020,26,40,434,500,04
Mcclain,U.S. House,Sevier White,LIB,440020,1,1,25,27,04
Mcclain,U.S. House,Christina Owen,DEM,440020,2,8,62,72,04
Mcclain,State Senate,Paul Scott,REP,440020,26,37,406,469,43
Mcclain,State Senate,Leah Pollan,DEM,440020,3,12,105,120,43
Mcclain,State House,Bobby Cleveland,REP,440020,26,39,419,484,20
Mcclain,State House,Matt Failing,DEM,440020,4,10,95,109,20
Mcclain,President,Donald Trump,REP,440021,7,78,343,428,
Mcclain,President,Gary Johnson,LIB,440021,1,8,32,41,
Mcclain,President,Hillary Clinton,DEM,440021,10,38,117,165,
Mcclain,U.S. Senate,James Lankford,REP,440021,8,79,345,432,
Mcclain,U.S. Senate,Robert Murphy,LIB,440021,0,6,20,26,
Mcclain,U.S. Senate,Mike Workman,DEM,440021,9,36,104,149,
Mcclain,U.S. Senate,Mark Beard,IND,440021,0,3,5,8,
Mcclain,U.S. Senate,Sean Braddy,IND,440021,1,0,13,14,
Mcclain,U.S. House,Tom Cole,REP,440021,7,86,339,432,04
Mcclain,U.S. House,Sevier White,LIB,440021,1,2,31,34,04
Mcclain,U.S. House,Christina Owen,DEM,440021,10,37,118,165,04
Mcclain,State Senate,Paul Scott,REP,440021,5,72,297,374,43
Mcclain,State Senate,Leah Pollan,DEM,440021,12,53,191,256,43
Mcclain,State House,Tim Downing,REP,440021,6,69,288,363,42
Mcclain,State House,Liz George,DEM,440021,12,56,199,267,42
Mcclain,President,Donald Trump,REP,440023,16,114,388,518,
Mcclain,President,Gary Johnson,LIB,440023,0,4,22,26,
Mcclain,President,Hillary Clinton,DEM,440023,9,22,97,128,
Mcclain,U.S. Senate,James Lankford,REP,440023,17,116,405,538,
Mcclain,U.S. Senate,Robert Murphy,LIB,440023,0,3,13,16,
Mcclain,U.S. Senate,Mike Workman,DEM,440023,4,24,72,100,
Mcclain,U.S. Senate,Mark Beard,IND,440023,2,0,6,8,
Mcclain,U.S. Senate,Sean Braddy,IND,440023,1,0,10,11,
Mcclain,U.S. House,Tom Cole,REP,440023,16,109,410,535,04
Mcclain,U.S. House,Sevier White,LIB,440023,2,3,21,26,04
Mcclain,U.S. House,Christina Owen,DEM,440023,7,29,77,113,04
Mcclain,State Senate,Paul Scott,REP,440023,15,98,350,463,43
Mcclain,State Senate,Leah Pollan,DEM,440023,10,41,155,206,43
Mcclain,State House,Bobby Cleveland,REP,440023,19,105,372,496,20
Mcclain,State House,Matt Failing,DEM,440023,6,35,127,168,20
Mcclain,President,Donald Trump,REP,440024,26,79,426,531,
Mcclain,President,Gary Johnson,LIB,440024,4,6,32,42,
Mcclain,President,Hillary Clinton,DEM,440024,14,34,150,198,
Mcclain,U.S. Senate,James Lankford,REP,440024,29,90,455,574,
Mcclain,U.S. Senate,Robert Murphy,LIB,440024,2,1,11,14,
Mcclain,U.S. Senate,Mike Workman,DEM,440024,10,30,115,155,
Mcclain,U.S. Senate,Mark Beard,IND,440024,0,0,13,13,
Mcclain,U.S. Senate,Sean Braddy,IND,440024,1,0,13,14,
Mcclain,U.S. House,Tom Cole,REP,440024,28,85,465,578,04
Mcclain,U.S. House,Sevier White,LIB,440024,2,0,13,15,04
Mcclain,U.S. House,Christina Owen,DEM,440024,12,34,127,173,04
Mcclain,State Senate,Paul Scott,REP,440024,25,70,391,486,43
Mcclain,State Senate,Leah Pollan,DEM,440024,16,49,209,274,43
Mcclain,State House,Tim Downing,REP,440024,23,69,388,480,42
Mcclain,State House,Liz George,DEM,440024,18,51,210,279,42
Mcclain,President,Donald Trump,REP,440026,7,35,158,200,
Mcclain,President,Gary Johnson,LIB,440026,0,3,9,12,
Mcclain,President,Hillary Clinton,DEM,440026,2,4,25,31,
Mcclain,U.S. Senate,James Lankford,REP,440026,7,33,161,201,
Mcclain,U.S. Senate,Robert Murphy,LIB,440026,0,1,8,9,
Mcclain,U.S. Senate,Mike Workman,DEM,440026,2,5,17,24,
Mcclain,U.S. Senate,Mark Beard,IND,440026,0,0,3,3,
Mcclain,U.S. Senate,Sean Braddy,IND,440026,0,3,5,8,
Mcclain,U.S. House,Tom Cole,REP,440026,7,29,156,192,04
Mcclain,U.S. House,Sevier White,LIB,440026,0,5,11,16,04
Mcclain,U.S. House,Christina Owen,DEM,440026,2,8,25,35,04
Mcclain,State Senate,Paul Scott,REP,440026,7,28,151,186,43
Mcclain,State Senate,Leah Pollan,DEM,440026,2,12,40,54,43
Mcclain,State House,Tim Downing,REP,440026,7,31,158,196,42
Mcclain,State House,Liz George,DEM,440026,2,10,35,47,42
Mcclain,President,Donald Trump,REP,440027,23,6,310,339,
Mcclain,President,Gary Johnson,LIB,440027,2,0,18,20,
Mcclain,President,Hillary Clinton,DEM,440027,1,0,58,59,
Mcclain,U.S. Senate,James Lankford,REP,440027,25,5,316,346,
Mcclain,U.S. Senate,Robert Murphy,LIB,440027,0,0,14,14,
Mcclain,U.S. Senate,Mike Workman,DEM,440027,1,0,42,43,
Mcclain,U.S. Senate,Mark Beard,IND,440027,1,0,9,10,
Mcclain,U.S. Senate,Sean Braddy,IND,440027,0,0,5,5,
Mcclain,U.S. House,Tom Cole,REP,440027,25,5,318,348,04
Mcclain,U.S. House,Sevier White,LIB,440027,1,0,18,19,04
Mcclain,U.S. House,Christina Owen,DEM,440027,1,0,50,51,04
Mcclain,State Senate,Paul Scott,REP,440027,24,5,302,331,43
Mcclain,State Senate,Leah Pollan,DEM,440027,3,0,80,83,43
Mcclain,State House,Bobby Cleveland,REP,440027,25,5,305,335,20
Mcclain,State House,Matt Failing,DEM,440027,2,0,75,77,20
Mcclain,President,Donald Trump,REP,440028,27,34,310,371,
Mcclain,President,Gary Johnson,LIB,440028,1,0,25,26,
Mcclain,President,Hillary Clinton,DEM,440028,16,9,91,116,
Mcclain,U.S. Senate,James Lankford,REP,440028,32,34,329,395,
Mcclain,U.S. Senate,Robert Murphy,LIB,440028,0,0,20,20,
Mcclain,U.S. Senate,Mike Workman,DEM,440028,11,8,67,86,
Mcclain,U.S. Senate,Mark Beard,IND,440028,0,0,4,4,
Mcclain,U.S. Senate,Sean Braddy,IND,440028,2,1,15,18,
Mcclain,U.S. House,Tom Cole,REP,440028,34,36,334,404,04
Mcclain,U.S. House,Sevier White,LIB,440028,0,0,21,21,04
Mcclain,U.S. House,Christina Owen,DEM,440028,11,7,80,98,04
Mcclain,State Senate,Paul Scott,REP,440028,29,34,313,376,43
Mcclain,State Senate,Leah Pollan,DEM,440028,14,9,117,140,43
Mcclain,State House,Bobby Cleveland,REP,440028,27,32,307,366,20
Mcclain,State House,Matt Failing,DEM,440028,16,10,121,147,20
Mccurtain,President,Donald Trump,REP,450002,6,17,102,125,
Mccurtain,President,Gary Johnson,LIB,450002,0,0,0,0,
Mccurtain,President,Hillary Clinton,DEM,450002,1,12,76,89,
Mccurtain,U.S. Senate,James Lankford,REP,450002,4,13,84,101,
Mccurtain,U.S. Senate,Robert Murphy,LIB,450002,0,0,2,2,
Mccurtain,U.S. Senate,Mike Workman,DEM,450002,3,14,84,101,
Mccurtain,U.S. Senate,Mark Beard,IND,450002,0,0,4,4,
Mccurtain,U.S. Senate,Sean Braddy,IND,450002,0,1,3,4,
Mccurtain,U.S. House,Markwayne Mullin,REP,450002,4,15,88,107,02
Mccurtain,U.S. House,Joshua Harris-Till,DEM,450002,2,13,76,91,02
Mccurtain,U.S. House,John Mccarthy,IND,450002,0,1,12,13,02
Mccurtain,State Senate,Joseph Silk,REP,450002,4,13,69,86,5
Mccurtain,State Senate,Stacey Allen Ebert,DEM,450002,3,16,108,127,5
Mccurtain,State House,Steven Mcgowen,REP,450002,5,9,53,67,1
Mccurtain,State House,Johnny Tadlock,DEM,450002,2,20,126,148,1
Mccurtain,President,Donald Trump,REP,450004,21,118,291,430,
Mccurtain,President,Gary Johnson,LIB,450004,1,5,8,14,
Mccurtain,President,Hillary Clinton,DEM,450004,3,48,98,149,
Mccurtain,U.S. Senate,James Lankford,REP,450004,19,110,252,381,
Mccurtain,U.S. Senate,Robert Murphy,LIB,450004,1,7,6,14,
Mccurtain,U.S. Senate,Mike Workman,DEM,450004,3,44,107,154,
Mccurtain,U.S. Senate,Mark Beard,IND,450004,0,1,13,14,
Mccurtain,U.S. Senate,Sean Braddy,IND,450004,0,5,14,19,
Mccurtain,U.S. House,Markwayne Mullin,REP,450004,20,120,264,404,02
Mccurtain,U.S. House,Joshua Harris-Till,DEM,450004,3,42,96,141,02
Mccurtain,U.S. House,John Mccarthy,IND,450004,1,5,30,36,02
Mccurtain,State Senate,Joseph Silk,REP,450004,14,54,165,233,5
Mccurtain,State Senate,Stacey Allen Ebert,DEM,450004,10,117,231,358,5
Mccurtain,State House,Steven Mcgowen,REP,450004,9,44,111,164,1
Mccurtain,State House,Johnny Tadlock,DEM,450004,15,127,286,428,1
Mccurtain,President,Donald Trump,REP,450005,1,9,32,42,
Mccurtain,President,Gary Johnson,LIB,450005,0,3,4,7,
Mccurtain,President,Hillary Clinton,DEM,450005,0,7,155,162,
Mccurtain,U.S. Senate,James Lankford,REP,450005,1,6,26,33,
Mccurtain,U.S. Senate,Robert Murphy,LIB,450005,0,2,7,9,
Mccurtain,U.S. Senate,Mike Workman,DEM,450005,0,8,144,152,
Mccurtain,U.S. Senate,Mark Beard,IND,450005,0,0,6,6,
Mccurtain,U.S. Senate,Sean Braddy,IND,450005,0,2,4,6,
Mccurtain,U.S. House,Markwayne Mullin,REP,450005,1,8,30,39,02
Mccurtain,U.S. House,Joshua Harris-Till,DEM,450005,0,10,137,147,02
Mccurtain,U.S. House,John Mccarthy,IND,450005,0,0,18,18,02
Mccurtain,State Senate,Joseph Silk,REP,450005,1,9,35,45,5
Mccurtain,State Senate,Stacey Allen Ebert,DEM,450005,0,9,153,162,5
Mccurtain,State House,Steven Mcgowen,REP,450005,1,10,40,51,1
Mccurtain,State House,Johnny Tadlock,DEM,450005,0,8,149,157,1
Mccurtain,President,Donald Trump,REP,450006,20,100,286,406,
Mccurtain,President,Gary Johnson,LIB,450006,1,5,16,22,
Mccurtain,President,Hillary Clinton,DEM,450006,5,36,86,127,
Mccurtain,U.S. Senate,James Lankford,REP,450006,16,82,249,347,
Mccurtain,U.S. Senate,Robert Murphy,LIB,450006,1,1,12,14,
Mccurtain,U.S. Senate,Mike Workman,DEM,450006,4,52,96,152,
Mccurtain,U.S. Senate,Mark Beard,IND,450006,1,1,11,13,
Mccurtain,U.S. Senate,Sean Braddy,IND,450006,1,1,16,18,
Mccurtain,U.S. House,Markwayne Mullin,REP,450006,14,88,257,359,02
Mccurtain,U.S. House,Joshua Harris-Till,DEM,450006,6,44,90,140,02
Mccurtain,U.S. House,John Mccarthy,IND,450006,2,5,40,47,02
Mccurtain,State Senate,Joseph Silk,REP,450006,9,54,161,224,5
Mccurtain,State Senate,Stacey Allen Ebert,DEM,450006,15,85,228,328,5
Mccurtain,State House,Steven Mcgowen,REP,450006,6,34,116,156,1
Mccurtain,State House,Johnny Tadlock,DEM,450006,19,105,275,399,1
Mccurtain,President,Donald Trump,REP,450008,17,70,362,449,
Mccurtain,President,Gary Johnson,LIB,450008,1,0,10,11,
Mccurtain,President,Hillary Clinton,DEM,450008,6,18,51,75,
Mccurtain,U.S. Senate,James Lankford,REP,450008,16,62,326,404,
Mccurtain,U.S. Senate,Robert Murphy,LIB,450008,1,2,3,6,
Mccurtain,U.S. Senate,Mike Workman,DEM,450008,6,21,67,94,
Mccurtain,U.S. Senate,Mark Beard,IND,450008,0,1,9,10,
Mccurtain,U.S. Senate,Sean Braddy,IND,450008,1,1,4,6,
Mccurtain,U.S. House,Markwayne Mullin,REP,450008,17,65,335,417,02
Mccurtain,U.S. House,Joshua Harris-Till,DEM,450008,6,21,60,87,02
Mccurtain,U.S. House,John Mccarthy,IND,450008,1,1,16,18,02
Mccurtain,State Senate,Joseph Silk,REP,450008,7,32,184,223,5
Mccurtain,State Senate,Stacey Allen Ebert,DEM,450008,17,56,236,309,5
Mccurtain,State House,Steven Mcgowen,REP,450008,8,30,111,149,1
Mccurtain,State House,Johnny Tadlock,DEM,450008,16,58,309,383,1
Mccurtain,President,Donald Trump,REP,450009,14,65,287,366,
Mccurtain,President,Gary Johnson,LIB,450009,0,2,12,14,
Mccurtain,President,Hillary Clinton,DEM,450009,7,18,112,137,
Mccurtain,U.S. Senate,James Lankford,REP,450009,14,54,259,327,
Mccurtain,U.S. Senate,Robert Murphy,LIB,450009,0,2,4,6,
Mccurtain,U.S. Senate,Mike Workman,DEM,450009,5,25,123,153,
Mccurtain,U.S. Senate,Mark Beard,IND,450009,0,0,6,6,
Mccurtain,U.S. Senate,Sean Braddy,IND,450009,2,2,11,15,
Mccurtain,U.S. House,Markwayne Mullin,REP,450009,10,54,269,333,02
Mccurtain,U.S. House,Joshua Harris-Till,DEM,450009,7,26,109,142,02
Mccurtain,U.S. House,John Mccarthy,IND,450009,4,5,27,36,02
Mccurtain,State Senate,Joseph Silk,REP,450009,11,33,173,217,5
Mccurtain,State Senate,Stacey Allen Ebert,DEM,450009,9,53,235,297,5
Mccurtain,State House,Steven Mcgowen,REP,450009,10,23,130,163,1
Mccurtain,State House,Johnny Tadlock,DEM,450009,11,63,283,357,1
Mccurtain,President,Donald Trump,REP,450011,11,24,109,144,
Mccurtain,President,Gary Johnson,LIB,450011,0,0,2,2,
Mccurtain,President,Hillary Clinton,DEM,450011,4,9,31,44,
Mccurtain,U.S. Senate,James Lankford,REP,450011,9,18,90,117,
Mccurtain,U.S. Senate,Robert Murphy,LIB,450011,0,2,1,3,
Mccurtain,U.S. Senate,Mike Workman,DEM,450011,4,10,43,57,
Mccurtain,U.S. Senate,Mark Beard,IND,450011,0,1,4,5,
Mccurtain,U.S. Senate,Sean Braddy,IND,450011,0,1,0,1,
Mccurtain,U.S. House,Markwayne Mullin,REP,450011,9,20,99,128,02
Mccurtain,U.S. House,Joshua Harris-Till,DEM,450011,4,10,35,49,02
Mccurtain,U.S. House,John Mccarthy,IND,450011,0,2,4,6,02
Mccurtain,State Senate,Joseph Silk,REP,450011,8,8,50,66,5
Mccurtain,State Senate,Stacey Allen Ebert,DEM,450011,7,25,90,122,5
Mccurtain,State House,Steven Mcgowen,REP,450011,6,8,35,49,1
Mccurtain,State House,Johnny Tadlock,DEM,450011,9,24,106,139,1
Mccurtain,President,Donald Trump,REP,450012,1,3,76,80,
Mccurtain,President,Gary Johnson,LIB,450012,0,0,3,3,
Mccurtain,President,Hillary Clinton,DEM,450012,1,4,55,60,
Mccurtain,U.S. Senate,James Lankford,REP,450012,1,1,56,58,
Mccurtain,U.S. Senate,Robert Murphy,LIB,450012,0,0,3,3,
Mccurtain,U.S. Senate,Mike Workman,DEM,450012,1,5,56,62,
Mccurtain,U.S. Senate,Mark Beard,IND,450012,0,0,1,1,
Mccurtain,U.S. Senate,Sean Braddy,IND,450012,0,1,7,8,
Mccurtain,U.S. House,Markwayne Mullin,REP,450012,1,2,56,59,02
Mccurtain,U.S. House,Joshua Harris-Till,DEM,450012,1,5,52,58,02
Mccurtain,U.S. House,John Mccarthy,IND,450012,0,0,14,14,02
Mccurtain,State Senate,Joseph Silk,REP,450012,0,0,34,34,5
Mccurtain,State Senate,Stacey Allen Ebert,DEM,450012,2,7,96,105,5
Mccurtain,State House,Steven Mcgowen,REP,450012,0,0,37,37,1
Mccurtain,State House,Johnny Tadlock,DEM,450012,2,7,93,102,1
Mccurtain,President,Donald Trump,REP,450013,11,29,269,309,
Mccurtain,President,Gary Johnson,LIB,450013,0,2,5,7,
Mccurtain,President,Hillary Clinton,DEM,450013,1,11,36,48,
Mccurtain,U.S. Senate,James Lankford,REP,450013,10,23,198,231,
Mccurtain,U.S. Senate,Robert Murphy,LIB,450013,0,0,7,7,
Mccurtain,U.S. Senate,Mike Workman,DEM,450013,2,15,68,85,
Mccurtain,U.S. Senate,Mark Beard,IND,450013,0,1,7,8,
Mccurtain,U.S. Senate,Sean Braddy,IND,450013,0,0,10,10,
Mccurtain,U.S. House,Markwayne Mullin,REP,450013,11,25,214,250,02
Mccurtain,U.S. House,Joshua Harris-Till,DEM,450013,1,13,55,69,02
Mccurtain,U.S. House,John Mccarthy,IND,450013,0,1,22,23,02
Mccurtain,State Senate,Joseph Silk,REP,450013,5,7,111,123,5
Mccurtain,State Senate,Stacey Allen Ebert,DEM,450013,6,34,201,241,5
Mccurtain,State House,Steven Mcgowen,REP,450013,5,3,97,105,1
Mccurtain,State House,Johnny Tadlock,DEM,450013,7,37,211,255,1
Mccurtain,President,Donald Trump,REP,450014,4,16,122,142,
Mccurtain,President,Gary Johnson,LIB,450014,0,0,3,3,
Mccurtain,President,Hillary Clinton,DEM,450014,2,3,16,21,
Mccurtain,U.S. Senate,James Lankford,REP,450014,4,11,100,115,
Mccurtain,U.S. Senate,Robert Murphy,LIB,450014,0,0,5,5,
Mccurtain,U.S. Senate,Mike Workman,DEM,450014,2,5,27,34,
Mccurtain,U.S. Senate,Mark Beard,IND,450014,0,1,3,4,
Mccurtain,U.S. Senate,Sean Braddy,IND,450014,0,0,2,2,
Mccurtain,U.S. House,Markwayne Mullin,REP,450014,4,11,114,129,02
Mccurtain,U.S. House,Joshua Harris-Till,DEM,450014,2,4,20,26,02
Mccurtain,U.S. House,John Mccarthy,IND,450014,0,2,5,7,02
Mccurtain,State Senate,Joseph Silk,REP,450014,1,6,46,53,5
Mccurtain,State Senate,Stacey Allen Ebert,DEM,450014,5,13,95,113,5
Mccurtain,State House,Steven Mcgowen,REP,450014,1,5,34,40,1
Mccurtain,State House,Johnny Tadlock,DEM,450014,5,14,105,124,1
Mccurtain,President,Donald Trump,REP,450015,1,18,152,171,
Mccurtain,President,Gary Johnson,LIB,450015,0,0,3,3,
Mccurtain,President,Hillary Clinton,DEM,450015,2,1,12,15,
Mccurtain,U.S. Senate,James Lankford,REP,450015,1,15,122,138,
Mccurtain,U.S. Senate,Robert Murphy,LIB,450015,0,0,2,2,
Mccurtain,U.S. Senate,Mike Workman,DEM,450015,2,2,24,28,
Mccurtain,U.S. Senate,Mark Beard,IND,450015,0,0,4,4,
Mccurtain,U.S. Senate,Sean Braddy,IND,450015,0,1,1,2,
Mccurtain,U.S. House,Markwayne Mullin,REP,450015,1,17,134,152,02
Mccurtain,U.S. House,Joshua Harris-Till,DEM,450015,2,1,19,22,02
Mccurtain,U.S. House,John Mccarthy,IND,450015,0,1,6,7,02
Mccurtain,State Senate,Joseph Silk,REP,450015,1,13,71,85,5
Mccurtain,State Senate,Stacey Allen Ebert,DEM,450015,2,6,95,103,5
Mccurtain,State House,Steven Mcgowen,REP,450015,0,5,42,47,1
Mccurtain,State House,Johnny Tadlock,DEM,450015,3,14,124,141,1
Mccurtain,President,Donald Trump,REP,450017,7,27,272,306,
Mccurtain,President,Gary Johnson,LIB,450017,1,1,10,12,
Mccurtain,President,Hillary Clinton,DEM,450017,2,13,89,104,
Mccurtain,U.S. Senate,James Lankford,REP,450017,8,25,238,271,
Mccurtain,U.S. Senate,Robert Murphy,LIB,450017,0,0,7,7,
Mccurtain,U.S. Senate,Mike Workman,DEM,450017,2,13,90,105,
Mccurtain,U.S. Senate,Mark Beard,IND,450017,0,1,7,8,
Mccurtain,U.S. Senate,Sean Braddy,IND,450017,0,2,19,21,
Mccurtain,U.S. House,Markwayne Mullin,REP,450017,7,22,229,258,02
Mccurtain,U.S. House,Joshua Harris-Till,DEM,450017,2,15,92,109,02
Mccurtain,U.S. House,John Mccarthy,IND,450017,1,4,37,42,02
Mccurtain,State Senate,Joseph Silk,REP,450017,8,20,194,222,5
Mccurtain,State Senate,Stacey Allen Ebert,DEM,450017,2,21,172,195,5
Mccurtain,State House,Steven Mcgowen,REP,450017,5,14,138,157,1
Mccurtain,State House,Johnny Tadlock,DEM,450017,4,27,223,254,1
Mccurtain,President,Donald Trump,REP,450018,14,43,489,546,
Mccurtain,President,Gary Johnson,LIB,450018,4,1,19,24,
Mccurtain,President,Hillary Clinton,DEM,450018,10,18,84,112,
Mccurtain,U.S. Senate,James Lankford,REP,450018,15,37,455,507,
Mccurtain,U.S. Senate,Robert Murphy,LIB,450018,0,0,8,8,
Mccurtain,U.S. Senate,Mike Workman,DEM,450018,7,15,92,114,
Mccurtain,U.S. Senate,Mark Beard,IND,450018,0,1,9,10,
Mccurtain,U.S. Senate,Sean Braddy,IND,450018,5,4,16,25,
Mccurtain,U.S. House,Markwayne Mullin,REP,450018,14,41,454,509,02
Mccurtain,U.S. House,Joshua Harris-Till,DEM,450018,6,14,83,103,02
Mccurtain,U.S. House,John Mccarthy,IND,450018,7,3,38,48,02
Mccurtain,State Senate,Joseph Silk,REP,450018,12,26,330,368,5
Mccurtain,State Senate,Stacey Allen Ebert,DEM,450018,16,34,260,310,5
Mccurtain,State House,Steven Mcgowen,REP,450018,9,25,250,284,1
Mccurtain,State House,Johnny Tadlock,DEM,450018,19,37,339,395,1
Mccurtain,President,Donald Trump,REP,450019,13,33,423,469,
Mccurtain,President,Gary Johnson,LIB,450019,0,1,8,9,
Mccurtain,President,Hillary Clinton,DEM,450019,0,3,48,51,
Mccurtain,U.S. Senate,James Lankford,REP,450019,12,30,387,429,
Mccurtain,U.S. Senate,Robert Murphy,LIB,450019,0,0,6,6,
Mccurtain,U.S. Senate,Mike Workman,DEM,450019,1,4,55,60,
Mccurtain,U.S. Senate,Mark Beard,IND,450019,0,0,3,3,
Mccurtain,U.S. Senate,Sean Braddy,IND,450019,0,2,16,18,
Mccurtain,U.S. House,Markwayne Mullin,REP,450019,13,28,392,433,02
Mccurtain,U.S. House,Joshua Harris-Till,DEM,450019,0,6,47,53,02
Mccurtain,U.S. House,John Mccarthy,IND,450019,0,2,28,30,02
Mccurtain,State Senate,Joseph Silk,REP,450019,12,21,268,301,5
Mccurtain,State Senate,Stacey Allen Ebert,DEM,450019,1,16,207,224,5
Mccurtain,State House,Steven Mcgowen,REP,450019,11,15,239,265,1
Mccurtain,State House,Johnny Tadlock,DEM,450019,2,22,236,260,1
Mccurtain,President,Donald Trump,REP,450020,8,29,343,380,
Mccurtain,President,Gary Johnson,LIB,450020,0,0,10,10,
Mccurtain,President,Hillary Clinton,DEM,450020,3,4,38,45,
Mccurtain,U.S. Senate,James Lankford,REP,450020,9,25,307,341,
Mccurtain,U.S. Senate,Robert Murphy,LIB,450020,0,0,8,8,
Mccurtain,U.S. Senate,Mike Workman,DEM,450020,2,6,53,61,
Mccurtain,U.S. Senate,Mark Beard,IND,450020,0,0,4,4,
Mccurtain,U.S. Senate,Sean Braddy,IND,450020,0,1,7,8,
Mccurtain,U.S. House,Markwayne Mullin,REP,450020,8,25,321,354,02
Mccurtain,U.S. House,Joshua Harris-Till,DEM,450020,3,7,49,59,02
Mccurtain,U.S. House,John Mccarthy,IND,450020,0,0,15,15,02
Mccurtain,State Senate,Joseph Silk,REP,450020,7,14,238,259,5
Mccurtain,State Senate,Stacey Allen Ebert,DEM,450020,4,18,153,175,5
Mccurtain,State House,Steven Mcgowen,REP,450020,6,10,183,199,1
Mccurtain,State House,Johnny Tadlock,DEM,450020,5,23,209,237,1
Mccurtain,President,Donald Trump,REP,450022,13,15,273,301,
Mccurtain,President,Gary Johnson,LIB,450022,0,1,6,7,
Mccurtain,President,Hillary Clinton,DEM,450022,1,1,29,31,
Mccurtain,U.S. Senate,James Lankford,REP,450022,10,15,242,267,
Mccurtain,U.S. Senate,Robert Murphy,LIB,450022,0,0,5,5,
Mccurtain,U.S. Senate,Mike Workman,DEM,450022,3,1,41,45,
Mccurtain,U.S. Senate,Mark Beard,IND,450022,0,0,6,6,
Mccurtain,U.S. Senate,Sean Braddy,IND,450022,1,0,8,9,
Mccurtain,U.S. House,Markwayne Mullin,REP,450022,10,15,247,272,02
Mccurtain,U.S. House,Joshua Harris-Till,DEM,450022,2,1,35,38,02
Mccurtain,U.S. House,John Mccarthy,IND,450022,2,0,18,20,02
Mccurtain,State Senate,Joseph Silk,REP,450022,7,12,160,179,5
Mccurtain,State Senate,Stacey Allen Ebert,DEM,450022,6,4,144,154,5
Mccurtain,State House,Steven Mcgowen,REP,450022,5,9,138,152,1
Mccurtain,State House,Johnny Tadlock,DEM,450022,9,8,165,182,1
Mccurtain,President,Donald Trump,REP,450023,5,16,209,230,
Mccurtain,President,Gary Johnson,LIB,450023,0,0,9,9,
Mccurtain,President,Hillary Clinton,DEM,450023,1,1,60,62,
Mccurtain,U.S. Senate,James Lankford,REP,450023,5,13,170,188,
Mccurtain,U.S. Senate,Robert Murphy,LIB,450023,0,0,13,13,
Mccurtain,U.S. Senate,Mike Workman,DEM,450023,1,3,74,78,
Mccurtain,U.S. Senate,Mark Beard,IND,450023,0,0,5,5,
Mccurtain,U.S. Senate,Sean Braddy,IND,450023,0,1,8,9,
Mccurtain,U.S. House,Markwayne Mullin,REP,450023,4,14,173,191,02
Mccurtain,U.S. House,Joshua Harris-Till,DEM,450023,1,1,70,72,02
Mccurtain,U.S. House,John Mccarthy,IND,450023,0,2,26,28,02
Mccurtain,State Senate,Joseph Silk,REP,450023,4,10,118,132,5
Mccurtain,State Senate,Stacey Allen Ebert,DEM,450023,2,7,159,168,5
Mccurtain,State House,Steven Mcgowen,REP,450023,3,9,115,127,1
Mccurtain,State House,Johnny Tadlock,DEM,450023,3,8,157,168,1
Mccurtain,President,Donald Trump,REP,450024,6,7,149,162,
Mccurtain,President,Gary Johnson,LIB,450024,0,0,5,5,
Mccurtain,President,Hillary Clinton,DEM,450024,5,2,23,30,
Mccurtain,U.S. Senate,James Lankford,REP,450024,3,5,111,119,
Mccurtain,U.S. Senate,Robert Murphy,LIB,450024,0,0,0,0,
Mccurtain,U.S. Senate,Mike Workman,DEM,450024,8,3,41,52,
Mccurtain,U.S. Senate,Mark Beard,IND,450024,0,0,6,6,
Mccurtain,U.S. Senate,Sean Braddy,IND,450024,0,0,6,6,
Mccurtain,U.S. House,Markwayne Mullin,REP,450024,2,5,118,125,02
Mccurtain,U.S. House,Joshua Harris-Till,DEM,450024,8,1,39,48,02
Mccurtain,U.S. House,John Mccarthy,IND,450024,1,2,13,16,02
Mccurtain,State Senate,Joseph Silk,REP,450024,4,3,80,87,5
Mccurtain,State Senate,Stacey Allen Ebert,DEM,450024,7,6,96,109,5
Mccurtain,State House,Steven Mcgowen,REP,450024,3,1,58,62,1
Mccurtain,State House,Johnny Tadlock,DEM,450024,7,8,118,133,1
Mccurtain,President,Donald Trump,REP,450025,6,6,190,202,
Mccurtain,President,Gary Johnson,LIB,450025,0,1,4,5,
Mccurtain,President,Hillary Clinton,DEM,450025,0,1,18,19,
Mccurtain,U.S. Senate,James Lankford,REP,450025,6,6,163,175,
Mccurtain,U.S. Senate,Robert Murphy,LIB,450025,0,1,4,5,
Mccurtain,U.S. Senate,Mike Workman,DEM,450025,0,1,30,31,
Mccurtain,U.S. Senate,Mark Beard,IND,450025,0,0,4,4,
Mccurtain,U.S. Senate,Sean Braddy,IND,450025,0,0,7,7,
Mccurtain,U.S. House,Markwayne Mullin,REP,450025,5,6,150,161,02
Mccurtain,U.S. House,Joshua Harris-Till,DEM,450025,0,1,25,26,02
Mccurtain,U.S. House,John Mccarthy,IND,450025,0,1,31,32,02
Mccurtain,State Senate,Joseph Silk,REP,450025,5,6,140,151,5
Mccurtain,State Senate,Stacey Allen Ebert,DEM,450025,1,2,71,74,5
Mccurtain,State House,Steven Mcgowen,REP,450025,3,7,133,143,1
Mccurtain,State House,Johnny Tadlock,DEM,450025,3,1,78,82,1
Mccurtain,President,Donald Trump,REP,450026,12,5,164,181,
Mccurtain,President,Gary Johnson,LIB,450026,0,0,2,2,
Mccurtain,President,Hillary Clinton,DEM,450026,0,0,13,13,
Mccurtain,U.S. Senate,James Lankford,REP,450026,12,5,146,163,
Mccurtain,U.S. Senate,Robert Murphy,LIB,450026,0,0,1,1,
Mccurtain,U.S. Senate,Mike Workman,DEM,450026,0,0,20,20,
Mccurtain,U.S. Senate,Mark Beard,IND,450026,0,0,4,4,
Mccurtain,U.S. Senate,Sean Braddy,IND,450026,0,0,1,1,
Mccurtain,U.S. House,Markwayne Mullin,REP,450026,12,5,142,159,02
Mccurtain,U.S. House,Joshua Harris-Till,DEM,450026,0,0,18,18,02
Mccurtain,U.S. House,John Mccarthy,IND,450026,0,0,11,11,02
Mccurtain,State Senate,Joseph Silk,REP,450026,10,4,139,153,5
Mccurtain,State Senate,Stacey Allen Ebert,DEM,450026,2,1,37,40,5
Mccurtain,State House,Steven Mcgowen,REP,450026,10,3,126,139,1
Mccurtain,State House,Johnny Tadlock,DEM,450026,2,2,49,53,1
Mccurtain,President,Donald Trump,REP,450027,3,4,113,120,
Mccurtain,President,Gary Johnson,LIB,450027,0,0,3,3,
Mccurtain,President,Hillary Clinton,DEM,450027,0,0,8,8,
Mccurtain,U.S. Senate,James Lankford,REP,450027,3,3,97,103,
Mccurtain,U.S. Senate,Robert Murphy,LIB,450027,0,0,2,2,
Mccurtain,U.S. Senate,Mike Workman,DEM,450027,0,0,16,16,
Mccurtain,U.S. Senate,Mark Beard,IND,450027,0,0,1,1,
Mccurtain,U.S. Senate,Sean Braddy,IND,450027,0,1,4,5,
Mccurtain,U.S. House,Markwayne Mullin,REP,450027,3,4,95,102,02
Mccurtain,U.S. House,Joshua Harris-Till,DEM,450027,0,0,12,12,02
Mccurtain,U.S. House,John Mccarthy,IND,450027,0,0,13,13,02
Mccurtain,State Senate,Joseph Silk,REP,450027,1,2,50,53,5
Mccurtain,State Senate,Stacey Allen Ebert,DEM,450027,2,2,73,77,5
Mccurtain,State House,Steven Mcgowen,REP,450027,1,3,43,47,1
Mccurtain,State House,Johnny Tadlock,DEM,450027,2,1,79,82,1
Mccurtain,President,Donald Trump,REP,450028,6,5,89,100,
Mccurtain,President,Gary Johnson,LIB,450028,0,0,1,1,
Mccurtain,President,Hillary Clinton,DEM,450028,1,0,4,5,
Mccurtain,U.S. Senate,James Lankford,REP,450028,6,4,70,80,
Mccurtain,U.S. Senate,Robert Murphy,LIB,450028,0,0,0,0,
Mccurtain,U.S. Senate,Mike Workman,DEM,450028,1,0,12,13,
Mccurtain,U.S. Senate,Mark Beard,IND,450028,0,0,1,1,
Mccurtain,U.S. Senate,Sean Braddy,IND,450028,0,1,3,4,
Mccurtain,U.S. House,Markwayne Mullin,REP,450028,6,5,76,87,02
Mccurtain,U.S. House,Joshua Harris-Till,DEM,450028,1,0,8,9,02
Mccurtain,U.S. House,John Mccarthy,IND,450028,0,0,6,6,02
Mccurtain,State Senate,Joseph Silk,REP,450028,3,3,42,48,5
Mccurtain,State Senate,Stacey Allen Ebert,DEM,450028,4,2,53,59,5
Mccurtain,State House,Steven Mcgowen,REP,450028,2,1,28,31,1
Mccurtain,State House,Johnny Tadlock,DEM,450028,5,4,66,75,1
Mccurtain,President,Donald Trump,REP,450029,14,14,233,261,
Mccurtain,President,Gary Johnson,LIB,450029,1,0,12,13,
Mccurtain,President,Hillary Clinton,DEM,450029,0,2,21,23,
Mccurtain,U.S. Senate,James Lankford,REP,450029,13,13,187,213,
Mccurtain,U.S. Senate,Robert Murphy,LIB,450029,1,0,5,6,
Mccurtain,U.S. Senate,Mike Workman,DEM,450029,0,2,41,43,
Mccurtain,U.S. Senate,Mark Beard,IND,450029,1,0,10,11,
Mccurtain,U.S. Senate,Sean Braddy,IND,450029,0,0,10,10,
Mccurtain,U.S. House,Markwayne Mullin,REP,450029,13,13,206,232,02
Mccurtain,U.S. House,Joshua Harris-Till,DEM,450029,0,2,36,38,02
Mccurtain,U.S. House,John Mccarthy,IND,450029,2,0,12,14,02
Mccurtain,State Senate,Joseph Silk,REP,450029,15,6,146,167,5
Mccurtain,State Senate,Stacey Allen Ebert,DEM,450029,0,9,119,128,5
Mccurtain,State House,Steven Mcgowen,REP,450029,6,6,111,123,1
Mccurtain,State House,Johnny Tadlock,DEM,450029,9,10,151,170,1
Mccurtain,President,Donald Trump,REP,450031,13,73,478,564,
Mccurtain,President,Gary Johnson,LIB,450031,0,0,23,23,
Mccurtain,President,Hillary Clinton,DEM,450031,3,7,52,62,
Mccurtain,U.S. Senate,James Lankford,REP,450031,15,63,417,495,
Mccurtain,U.S. Senate,Robert Murphy,LIB,450031,0,4,8,12,
Mccurtain,U.S. Senate,Mike Workman,DEM,450031,1,7,76,84,
Mccurtain,U.S. Senate,Mark Beard,IND,450031,0,4,8,12,
Mccurtain,U.S. Senate,Sean Braddy,IND,450031,0,1,16,17,
Mccurtain,U.S. House,Markwayne Mullin,REP,450031,15,65,433,513,02
Mccurtain,U.S. House,Joshua Harris-Till,DEM,450031,1,8,60,69,02
Mccurtain,U.S. House,John Mccarthy,IND,450031,0,5,37,42,02
Mccurtain,State Senate,Joseph Silk,REP,450031,9,47,282,338,5
Mccurtain,State Senate,Stacey Allen Ebert,DEM,450031,7,33,261,301,5
Mccurtain,State House,Steven Mcgowen,REP,450031,5,33,231,269,1
Mccurtain,State House,Johnny Tadlock,DEM,450031,11,46,317,374,1
Mccurtain,President,Donald Trump,REP,450033,16,38,233,287,
Mccurtain,President,Gary Johnson,LIB,450033,0,0,5,5,
Mccurtain,President,Hillary Clinton,DEM,450033,4,9,35,48,
Mccurtain,U.S. Senate,James Lankford,REP,450033,14,37,190,241,
Mccurtain,U.S. Senate,Robert Murphy,LIB,450033,1,1,10,12,
Mccurtain,U.S. Senate,Mike Workman,DEM,450033,5,9,50,64,
Mccurtain,U.S. Senate,Mark Beard,IND,450033,0,0,6,6,
Mccurtain,U.S. Senate,Sean Braddy,IND,450033,2,0,7,9,
Mccurtain,U.S. House,Markwayne Mullin,REP,450033,12,39,214,265,02
Mccurtain,U.S. House,Joshua Harris-Till,DEM,450033,7,7,35,49,02
Mccurtain,U.S. House,John Mccarthy,IND,450033,3,2,13,18,02
Mccurtain,State Senate,Joseph Silk,REP,450033,6,23,110,139,5
Mccurtain,State Senate,Stacey Allen Ebert,DEM,450033,16,25,160,201,5
Mccurtain,State House,Steven Mcgowen,REP,450033,6,12,83,101,1
Mccurtain,State House,Johnny Tadlock,DEM,450033,16,36,186,238,1
Mccurtain,President,Donald Trump,REP,450034,7,23,298,328,
Mccurtain,President,Gary Johnson,LIB,450034,0,1,7,8,
Mccurtain,President,Hillary Clinton,DEM,450034,1,5,33,39,
Mccurtain,U.S. Senate,James Lankford,REP,450034,4,18,233,255,
Mccurtain,U.S. Senate,Robert Murphy,LIB,450034,1,0,12,13,
Mccurtain,U.S. Senate,Mike Workman,DEM,450034,4,7,63,74,
Mccurtain,U.S. Senate,Mark Beard,IND,450034,0,1,6,7,
Mccurtain,U.S. Senate,Sean Braddy,IND,450034,0,0,16,16,
Mccurtain,U.S. House,Markwayne Mullin,REP,450034,6,19,256,281,02
Mccurtain,U.S. House,Joshua Harris-Till,DEM,450034,2,6,47,55,02
Mccurtain,U.S. House,John Mccarthy,IND,450034,1,2,29,32,02
Mccurtain,State Senate,Joseph Silk,REP,450034,1,15,184,200,5
Mccurtain,State Senate,Stacey Allen Ebert,DEM,450034,8,13,155,176,5
Mccurtain,State House,Steven Mcgowen,REP,450034,1,11,128,140,1
Mccurtain,State House,Johnny Tadlock,DEM,450034,8,18,209,235,1
Mccurtain,President,Donald Trump,REP,450035,19,25,488,532,
Mccurtain,President,Gary Johnson,LIB,450035,1,2,11,14,
Mccurtain,President,Hillary Clinton,DEM,450035,4,7,84,95,
Mccurtain,U.S. Senate,James Lankford,REP,450035,16,19,414,449,
Mccurtain,U.S. Senate,Robert Murphy,LIB,450035,0,2,9,11,
Mccurtain,U.S. Senate,Mike Workman,DEM,450035,6,9,115,130,
Mccurtain,U.S. Senate,Mark Beard,IND,450035,1,0,5,6,
Mccurtain,U.S. Senate,Sean Braddy,IND,450035,0,2,22,24,
Mccurtain,U.S. House,Markwayne Mullin,REP,450035,18,22,430,470,02
Mccurtain,U.S. House,Joshua Harris-Till,DEM,450035,5,9,100,114,02
Mccurtain,U.S. House,John Mccarthy,IND,450035,1,1,38,40,02
Mccurtain,State Senate,Joseph Silk,REP,450035,13,17,321,351,5
Mccurtain,State Senate,Stacey Allen Ebert,DEM,450035,11,16,258,285,5
Mccurtain,State House,Steven Mcgowen,REP,450035,6,9,235,250,1
Mccurtain,State House,Johnny Tadlock,DEM,450035,18,25,346,389,1
Mccurtain,President,Donald Trump,REP,450036,11,29,393,433,
Mccurtain,President,Gary Johnson,LIB,450036,0,3,5,8,
Mccurtain,President,Hillary Clinton,DEM,450036,0,4,31,35,
Mccurtain,U.S. Senate,James Lankford,REP,450036,8,22,311,341,
Mccurtain,U.S. Senate,Robert Murphy,LIB,450036,0,1,7,8,
Mccurtain,U.S. Senate,Mike Workman,DEM,450036,2,9,66,77,
Mccurtain,U.S. Senate,Mark Beard,IND,450036,0,1,3,4,
Mccurtain,U.S. Senate,Sean Braddy,IND,450036,1,0,19,20,
Mccurtain,U.S. House,Markwayne Mullin,REP,450036,11,26,330,367,02
Mccurtain,U.S. House,Joshua Harris-Till,DEM,450036,0,6,49,55,02
Mccurtain,U.S. House,John Mccarthy,IND,450036,0,1,30,31,02
Mccurtain,State Senate,Joseph Silk,REP,450036,4,12,236,252,5
Mccurtain,State Senate,Stacey Allen Ebert,DEM,450036,7,24,189,220,5
Mccurtain,State House,Steven Mcgowen,REP,450036,0,9,174,183,1
Mccurtain,State House,Johnny Tadlock,DEM,450036,11,27,251,289,1
Mccurtain,President,Donald Trump,REP,450037,1,6,88,95,
Mccurtain,President,Gary Johnson,LIB,450037,1,0,6,7,
Mccurtain,President,Hillary Clinton,DEM,450037,2,0,16,18,
Mccurtain,U.S. Senate,James Lankford,REP,450037,1,4,68,73,
Mccurtain,U.S. Senate,Robert Murphy,LIB,450037,0,0,1,1,
Mccurtain,U.S. Senate,Mike Workman,DEM,450037,2,0,32,34,
Mccurtain,U.S. Senate,Mark Beard,IND,450037,0,1,3,4,
Mccurtain,U.S. Senate,Sean Braddy,IND,450037,1,1,4,6,
Mccurtain,U.S. House,Markwayne Mullin,REP,450037,2,5,75,82,02
Mccurtain,U.S. House,Joshua Harris-Till,DEM,450037,2,0,28,30,02
Mccurtain,U.S. House,John Mccarthy,IND,450037,0,1,5,6,02
Mccurtain,State Senate,Joseph Silk,REP,450037,0,4,63,67,5
Mccurtain,State Senate,Stacey Allen Ebert,DEM,450037,4,2,48,54,5
Mccurtain,State House,Steven Mcgowen,REP,450037,0,4,50,54,1
Mccurtain,State House,Johnny Tadlock,DEM,450037,4,1,60,65,1
Mccurtain,President,Donald Trump,REP,450038,7,29,459,495,
Mccurtain,President,Gary Johnson,LIB,450038,0,0,17,17,
Mccurtain,President,Hillary Clinton,DEM,450038,3,4,68,75,
Mccurtain,U.S. Senate,James Lankford,REP,450038,6,23,339,368,
Mccurtain,U.S. Senate,Robert Murphy,LIB,450038,0,0,18,18,
Mccurtain,U.S. Senate,Mike Workman,DEM,450038,2,6,140,148,
Mccurtain,U.S. Senate,Mark Beard,IND,450038,0,0,14,14,
Mccurtain,U.S. Senate,Sean Braddy,IND,450038,1,1,18,20,
Mccurtain,U.S. House,Markwayne Mullin,REP,450038,8,26,382,416,02
Mccurtain,U.S. House,Joshua Harris-Till,DEM,450038,2,2,109,113,02
Mccurtain,U.S. House,John Mccarthy,IND,450038,0,2,38,40,02
Mccurtain,State Senate,Joseph Silk,REP,450038,3,15,239,257,5
Mccurtain,State Senate,Stacey Allen Ebert,DEM,450038,7,16,303,326,5
Mccurtain,State House,Steven Mcgowen,REP,450038,3,10,164,177,1
Mccurtain,State House,Johnny Tadlock,DEM,450038,7,21,376,404,1
Mcintosh,President,Donald Trump,REP,460102,13,18,466,497,
Mcintosh,President,Gary Johnson,LIB,460102,1,4,30,35,
Mcintosh,President,Hillary Clinton,DEM,460102,6,8,227,241,
Mcintosh,U.S. Senate,James Lankford,REP,460102,15,19,449,483,
Mcintosh,U.S. Senate,Robert Murphy,LIB,460102,0,0,9,9,
Mcintosh,U.S. Senate,Mike Workman,DEM,460102,4,10,231,245,
Mcintosh,U.S. Senate,Mark Beard,IND,460102,1,0,10,11,
Mcintosh,U.S. Senate,Sean Braddy,IND,460102,0,2,16,18,
Mcintosh,U.S. House,Markwayne Mullin,REP,460102,15,18,462,495,02
Mcintosh,U.S. House,Joshua Harris-Till,DEM,460102,5,10,222,237,02
Mcintosh,U.S. House,John Mccarthy,IND,460102,1,3,33,37,02
Mcintosh,State House,Avery Carl Frix,REP,460102,11,17,410,438,13
Mcintosh,State House,Wayne Herriman,DEM,460102,10,13,308,331,13
Mcintosh,President,Donald Trump,REP,460103,30,49,763,842,
Mcintosh,President,Gary Johnson,LIB,460103,2,4,48,54,
Mcintosh,President,Hillary Clinton,DEM,460103,13,29,290,332,
Mcintosh,U.S. Senate,James Lankford,REP,460103,29,48,712,789,
Mcintosh,U.S. Senate,Robert Murphy,LIB,460103,0,2,22,24,
Mcintosh,U.S. Senate,Mike Workman,DEM,460103,15,30,321,366,
Mcintosh,U.S. Senate,Mark Beard,IND,460103,0,1,14,15,
Mcintosh,U.S. Senate,Sean Braddy,IND,460103,0,3,19,22,
Mcintosh,U.S. House,Markwayne Mullin,REP,460103,28,51,743,822,02
Mcintosh,U.S. House,Joshua Harris-Till,DEM,460103,16,26,299,341,02
Mcintosh,U.S. House,John Mccarthy,IND,460103,0,6,47,53,02
Mcintosh,State House,Avery Carl Frix,REP,460103,27,49,733,809,13
Mcintosh,State House,Wayne Herriman,DEM,460103,17,34,362,413,13
Mcintosh,President,Donald Trump,REP,460104,12,35,358,405,
Mcintosh,President,Gary Johnson,LIB,460104,1,4,27,32,
Mcintosh,President,Hillary Clinton,DEM,460104,3,7,129,139,
Mcintosh,U.S. Senate,James Lankford,REP,460104,12,30,355,397,
Mcintosh,U.S. Senate,Robert Murphy,LIB,460104,0,2,8,10,
Mcintosh,U.S. Senate,Mike Workman,DEM,460104,4,10,122,136,
Mcintosh,U.S. Senate,Mark Beard,IND,460104,0,2,10,12,
Mcintosh,U.S. Senate,Sean Braddy,IND,460104,0,1,12,13,
Mcintosh,U.S. House,Markwayne Mullin,REP,460104,12,32,366,410,02
Mcintosh,U.S. House,Joshua Harris-Till,DEM,460104,4,10,121,135,02
Mcintosh,U.S. House,John Mccarthy,IND,460104,0,3,23,26,02
Mcintosh,State House,Don Herrold,REP,460104,7,18,168,193,15
Mcintosh,State House,Ed Cannaday,DEM,460104,9,27,344,380,15
Mcintosh,President,Donald Trump,REP,460201,25,100,560,685,
Mcintosh,President,Gary Johnson,LIB,460201,1,3,40,44,
Mcintosh,President,Hillary Clinton,DEM,460201,11,78,230,319,
Mcintosh,U.S. Senate,James Lankford,REP,460201,21,100,558,679,
Mcintosh,U.S. Senate,Robert Murphy,LIB,460201,3,1,15,19,
Mcintosh,U.S. Senate,Mike Workman,DEM,460201,9,71,226,306,
Mcintosh,U.S. Senate,Mark Beard,IND,460201,1,4,15,20,
Mcintosh,U.S. Senate,Sean Braddy,IND,460201,1,3,15,19,
Mcintosh,U.S. House,Markwayne Mullin,REP,460201,23,106,555,684,02
Mcintosh,U.S. House,Joshua Harris-Till,DEM,460201,10,61,218,289,02
Mcintosh,U.S. House,John Mccarthy,IND,460201,3,12,56,71,02
Mcintosh,President,Donald Trump,REP,460203,18,56,197,271,
Mcintosh,President,Gary Johnson,LIB,460203,0,4,16,20,
Mcintosh,President,Hillary Clinton,DEM,460203,2,41,137,180,
Mcintosh,U.S. Senate,James Lankford,REP,460203,17,60,197,274,
Mcintosh,U.S. Senate,Robert Murphy,LIB,460203,0,2,11,13,
Mcintosh,U.S. Senate,Mike Workman,DEM,460203,2,36,127,165,
Mcintosh,U.S. Senate,Mark Beard,IND,460203,0,1,7,8,
Mcintosh,U.S. Senate,Sean Braddy,IND,460203,1,2,8,11,
Mcintosh,U.S. House,Markwayne Mullin,REP,460203,17,58,202,277,02
Mcintosh,U.S. House,Joshua Harris-Till,DEM,460203,2,39,124,165,02
Mcintosh,U.S. House,John Mccarthy,IND,460203,1,2,23,26,02
Mcintosh,State House,Don Herrold,REP,460203,13,38,144,195,15
Mcintosh,State House,Ed Cannaday,DEM,460203,7,59,200,266,15
Mcintosh,President,Donald Trump,REP,460205,64,120,756,940,
Mcintosh,President,Gary Johnson,LIB,460205,4,5,38,47,
Mcintosh,President,Hillary Clinton,DEM,460205,7,48,181,236,
Mcintosh,U.S. Senate,James Lankford,REP,460205,64,118,739,921,
Mcintosh,U.S. Senate,Robert Murphy,LIB,460205,2,1,15,18,
Mcintosh,U.S. Senate,Mike Workman,DEM,460205,7,50,182,239,
Mcintosh,U.S. Senate,Mark Beard,IND,460205,1,1,20,22,
Mcintosh,U.S. Senate,Sean Braddy,IND,460205,1,2,18,21,
Mcintosh,U.S. House,Markwayne Mullin,REP,460205,64,115,736,915,02
Mcintosh,U.S. House,Joshua Harris-Till,DEM,460205,7,52,170,229,02
Mcintosh,U.S. House,John Mccarthy,IND,460205,4,5,65,74,02
Mcintosh,State House,Don Herrold,REP,460205,46,84,517,647,15
Mcintosh,State House,Ed Cannaday,DEM,460205,29,87,449,565,15
Mcintosh,President,Donald Trump,REP,460307,4,34,313,351,
Mcintosh,President,Gary Johnson,LIB,460307,2,1,14,17,
Mcintosh,President,Hillary Clinton,DEM,460307,2,9,103,114,
Mcintosh,U.S. Senate,James Lankford,REP,460307,6,30,290,326,
Mcintosh,U.S. Senate,Robert Murphy,LIB,460307,1,1,10,12,
Mcintosh,U.S. Senate,Mike Workman,DEM,460307,1,11,108,120,
Mcintosh,U.S. Senate,Mark Beard,IND,460307,0,1,8,9,
Mcintosh,U.S. Senate,Sean Braddy,IND,460307,0,1,8,9,
Mcintosh,U.S. House,Markwayne Mullin,REP,460307,5,29,287,321,02
Mcintosh,U.S. House,Joshua Harris-Till,DEM,460307,2,12,107,121,02
Mcintosh,U.S. House,John Mccarthy,IND,460307,1,2,24,27,02
Mcintosh,President,Donald Trump,REP,460310,3,6,126,135,
Mcintosh,President,Gary Johnson,LIB,460310,0,0,12,12,
Mcintosh,President,Hillary Clinton,DEM,460310,2,2,53,57,
Mcintosh,U.S. Senate,James Lankford,REP,460310,3,6,114,123,
Mcintosh,U.S. Senate,Robert Murphy,LIB,460310,0,0,4,4,
Mcintosh,U.S. Senate,Mike Workman,DEM,460310,1,1,63,65,
Mcintosh,U.S. Senate,Mark Beard,IND,460310,0,0,1,1,
Mcintosh,U.S. Senate,Sean Braddy,IND,460310,0,0,7,7,
Mcintosh,U.S. House,Markwayne Mullin,REP,460310,3,7,112,122,02
Mcintosh,U.S. House,Joshua Harris-Till,DEM,460310,2,0,55,57,02
Mcintosh,U.S. House,John Mccarthy,IND,460310,0,0,19,19,02
Mcintosh,President,Donald Trump,REP,460311,4,7,182,193,
Mcintosh,President,Gary Johnson,LIB,460311,1,0,11,12,
Mcintosh,President,Hillary Clinton,DEM,460311,2,7,73,82,
Mcintosh,U.S. Senate,James Lankford,REP,460311,5,8,173,186,
Mcintosh,U.S. Senate,Robert Murphy,LIB,460311,0,1,3,4,
Mcintosh,U.S. Senate,Mike Workman,DEM,460311,2,5,72,79,
Mcintosh,U.S. Senate,Mark Beard,IND,460311,1,0,7,8,
Mcintosh,U.S. Senate,Sean Braddy,IND,460311,0,0,5,5,
Mcintosh,U.S. House,Markwayne Mullin,REP,460311,5,10,171,186,02
Mcintosh,U.S. House,Joshua Harris-Till,DEM,460311,2,5,72,79,02
Mcintosh,U.S. House,John Mccarthy,IND,460311,1,0,18,19,02
Mcintosh,President,Donald Trump,REP,460312,0,1,62,63,
Mcintosh,President,Gary Johnson,LIB,460312,0,0,6,6,
Mcintosh,President,Hillary Clinton,DEM,460312,0,1,28,29,
Mcintosh,U.S. Senate,James Lankford,REP,460312,0,2,68,70,
Mcintosh,U.S. Senate,Robert Murphy,LIB,460312,0,0,2,2,
Mcintosh,U.S. Senate,Mike Workman,DEM,460312,0,0,22,22,
Mcintosh,U.S. Senate,Mark Beard,IND,460312,0,0,1,1,
Mcintosh,U.S. Senate,Sean Braddy,IND,460312,0,0,3,3,
Mcintosh,U.S. House,Markwayne Mullin,REP,460312,0,2,60,62,02
Mcintosh,U.S. House,Joshua Harris-Till,DEM,460312,0,0,26,26,02
Mcintosh,U.S. House,John Mccarthy,IND,460312,0,0,10,10,02
Mcintosh,President,Donald Trump,REP,460313,6,3,71,80,
Mcintosh,President,Gary Johnson,LIB,460313,2,0,3,5,
Mcintosh,President,Hillary Clinton,DEM,460313,2,1,21,24,
Mcintosh,U.S. Senate,James Lankford,REP,460313,6,4,67,77,
Mcintosh,U.S. Senate,Robert Murphy,LIB,460313,0,0,2,2,
Mcintosh,U.S. Senate,Mike Workman,DEM,460313,2,0,24,26,
Mcintosh,U.S. Senate,Mark Beard,IND,460313,0,0,2,2,
Mcintosh,U.S. Senate,Sean Braddy,IND,460313,2,0,1,3,
Mcintosh,U.S. House,Markwayne Mullin,REP,460313,6,4,65,75,02
Mcintosh,U.S. House,Joshua Harris-Till,DEM,460313,2,0,23,25,02
Mcintosh,U.S. House,John Mccarthy,IND,460313,2,0,7,9,02
Mcintosh,President,Donald Trump,REP,460314,25,49,464,538,
Mcintosh,President,Gary Johnson,LIB,460314,1,2,18,21,
Mcintosh,President,Hillary Clinton,DEM,460314,7,24,192,223,
Mcintosh,U.S. Senate,James Lankford,REP,460314,26,52,433,511,
Mcintosh,U.S. Senate,Robert Murphy,LIB,460314,1,0,13,14,
Mcintosh,U.S. Senate,Mike Workman,DEM,460314,7,20,196,223,
Mcintosh,U.S. Senate,Mark Beard,IND,460314,0,0,12,12,
Mcintosh,U.S. Senate,Sean Braddy,IND,460314,0,1,12,13,
Mcintosh,U.S. House,Markwayne Mullin,REP,460314,25,51,436,512,02
Mcintosh,U.S. House,Joshua Harris-Till,DEM,460314,6,18,190,214,02
Mcintosh,U.S. House,John Mccarthy,IND,460314,2,3,36,41,02
Mcintosh,President,Donald Trump,REP,460315,3,4,177,184,
Mcintosh,President,Gary Johnson,LIB,460315,0,0,12,12,
Mcintosh,President,Hillary Clinton,DEM,460315,4,2,57,63,
Mcintosh,U.S. Senate,James Lankford,REP,460315,2,3,164,169,
Mcintosh,U.S. Senate,Robert Murphy,LIB,460315,0,0,6,6,
Mcintosh,U.S. Senate,Mike Workman,DEM,460315,4,2,65,71,
Mcintosh,U.S. Senate,Mark Beard,IND,460315,0,1,3,4,
Mcintosh,U.S. Senate,Sean Braddy,IND,460315,1,0,7,8,
Mcintosh,U.S. House,Markwayne Mullin,REP,460315,2,4,161,167,02
Mcintosh,U.S. House,Joshua Harris-Till,DEM,460315,5,2,65,72,02
Mcintosh,U.S. House,John Mccarthy,IND,460315,0,0,19,19,02
Mcintosh,President,Donald Trump,REP,460316,6,11,304,321,
Mcintosh,President,Gary Johnson,LIB,460316,0,1,17,18,
Mcintosh,President,Hillary Clinton,DEM,460316,1,2,81,84,
Mcintosh,U.S. Senate,James Lankford,REP,460316,5,13,276,294,
Mcintosh,U.S. Senate,Robert Murphy,LIB,460316,0,1,10,11,
Mcintosh,U.S. Senate,Mike Workman,DEM,460316,1,0,99,100,
Mcintosh,U.S. Senate,Mark Beard,IND,460316,1,0,9,10,
Mcintosh,U.S. Senate,Sean Braddy,IND,460316,0,0,7,7,
Mcintosh,U.S. House,Markwayne Mullin,REP,460316,6,13,274,293,02
Mcintosh,U.S. House,Joshua Harris-Till,DEM,460316,0,1,100,101,02
Mcintosh,U.S. House,John Mccarthy,IND,460316,1,0,24,25,02
Mcintosh,State House,Avery Carl Frix,REP,460316,6,11,262,279,13
Mcintosh,State House,Wayne Herriman,DEM,460316,1,3,139,143,13
Major,President,Donald Trump,REP,470002,33,58,641,732,
Major,President,Gary Johnson,LIB,470002,2,4,33,39,
Major,President,Hillary Clinton,DEM,470002,4,8,53,65,
Major,U.S. Senate,James Lankford,REP,470002,35,58,651,744,
Major,U.S. Senate,Robert Murphy,LIB,470002,1,0,12,13,
Major,U.S. Senate,Mike Workman,DEM,470002,3,6,44,53,
Major,U.S. Senate,Mark Beard,IND,470002,0,3,8,11,
Major,U.S. Senate,Sean Braddy,IND,470002,0,2,15,17,
Major,U.S. House,Frank Lucas,REP,470002,35,56,646,737,03
Major,U.S. House,Frankie Robbins,DEM,470002,4,12,75,91,03
Major,President,Donald Trump,REP,470004,0,13,165,178,
Major,President,Gary Johnson,LIB,470004,0,1,7,8,
Major,President,Hillary Clinton,DEM,470004,0,2,11,13,
Major,U.S. Senate,James Lankford,REP,470004,0,14,165,179,
Major,U.S. Senate,Robert Murphy,LIB,470004,0,0,5,5,
Major,U.S. Senate,Mike Workman,DEM,470004,0,2,8,10,
Major,U.S. Senate,Mark Beard,IND,470004,0,0,4,4,
Major,U.S. Senate,Sean Braddy,IND,470004,0,0,0,0,
Major,U.S. House,Frank Lucas,REP,470004,0,14,165,179,03
Major,U.S. House,Frankie Robbins,DEM,470004,0,2,12,14,03
Major,President,Donald Trump,REP,470009,4,6,43,53,
Major,President,Gary Johnson,LIB,470009,0,0,3,3,
Major,President,Hillary Clinton,DEM,470009,0,1,2,3,
Major,U.S. Senate,James Lankford,REP,470009,4,7,46,57,
Major,U.S. Senate,Robert Murphy,LIB,470009,0,0,1,1,
Major,U.S. Senate,Mike Workman,DEM,470009,0,1,2,3,
Major,U.S. Senate,Mark Beard,IND,470009,0,0,0,0,
Major,U.S. Senate,Sean Braddy,IND,470009,0,0,0,0,
Major,U.S. House,Frank Lucas,REP,470009,4,7,46,57,03
Major,U.S. House,Frankie Robbins,DEM,470009,0,1,2,3,03
Major,President,Donald Trump,REP,470010,7,20,193,220,
Major,President,Gary Johnson,LIB,470010,0,0,6,6,
Major,President,Hillary Clinton,DEM,470010,1,0,7,8,
Major,U.S. Senate,James Lankford,REP,470010,7,20,192,219,
Major,U.S. Senate,Robert Murphy,LIB,470010,0,0,1,1,
Major,U.S. Senate,Mike Workman,DEM,470010,0,0,9,9,
Major,U.S. Senate,Mark Beard,IND,470010,0,0,1,1,
Major,U.S. Senate,Sean Braddy,IND,470010,1,0,1,2,
Major,U.S. House,Frank Lucas,REP,470010,7,20,188,215,03
Major,U.S. House,Frankie Robbins,DEM,470010,1,0,15,16,03
Major,President,Donald Trump,REP,470015,4,9,197,210,
Major,President,Gary Johnson,LIB,470015,0,0,6,6,
Major,President,Hillary Clinton,DEM,470015,1,0,15,16,
Major,U.S. Senate,James Lankford,REP,470015,5,9,201,215,
Major,U.S. Senate,Robert Murphy,LIB,470015,0,0,2,2,
Major,U.S. Senate,Mike Workman,DEM,470015,0,0,9,9,
Major,U.S. Senate,Mark Beard,IND,470015,0,0,2,2,
Major,U.S. Senate,Sean Braddy,IND,470015,0,0,3,3,
Major,U.S. House,Frank Lucas,REP,470015,4,9,196,209,03
Major,U.S. House,Frankie Robbins,DEM,470015,1,0,18,19,03
Major,President,Donald Trump,REP,470016,4,1,86,91,
Major,President,Gary Johnson,LIB,470016,0,0,3,3,
Major,President,Hillary Clinton,DEM,470016,0,0,7,7,
Major,U.S. Senate,James Lankford,REP,470016,3,1,89,93,
Major,U.S. Senate,Robert Murphy,LIB,470016,0,0,1,1,
Major,U.S. Senate,Mike Workman,DEM,470016,0,0,6,6,
Major,U.S. Senate,Mark Beard,IND,470016,0,0,0,0,
Major,U.S. Senate,Sean Braddy,IND,470016,1,0,0,1,
Major,U.S. House,Frank Lucas,REP,470016,3,1,85,89,03
Major,U.S. House,Frankie Robbins,DEM,470016,1,0,10,11,03
Major,President,Donald Trump,REP,470020,47,111,615,773,
Major,President,Gary Johnson,LIB,470020,8,7,23,38,
Major,President,Hillary Clinton,DEM,470020,16,21,77,114,
Major,U.S. Senate,James Lankford,REP,470020,52,113,650,815,
Major,U.S. Senate,Robert Murphy,LIB,470020,1,4,14,19,
Major,U.S. Senate,Mike Workman,DEM,470020,10,14,45,69,
Major,U.S. Senate,Mark Beard,IND,470020,0,3,5,8,
Major,U.S. Senate,Sean Braddy,IND,470020,2,0,7,9,
Major,U.S. House,Frank Lucas,REP,470020,50,107,646,803,03
Major,U.S. House,Frankie Robbins,DEM,470020,18,24,67,109,03
Major,President,Donald Trump,REP,470022,19,126,546,691,
Major,President,Gary Johnson,LIB,470022,3,10,33,46,
Major,President,Hillary Clinton,DEM,470022,9,26,49,84,
Major,U.S. Senate,James Lankford,REP,470022,22,133,555,710,
Major,U.S. Senate,Robert Murphy,LIB,470022,1,4,16,21,
Major,U.S. Senate,Mike Workman,DEM,470022,6,19,42,67,
Major,U.S. Senate,Mark Beard,IND,470022,0,3,8,11,
Major,U.S. Senate,Sean Braddy,IND,470022,1,3,11,15,
Major,U.S. House,Frank Lucas,REP,470022,23,135,548,706,03
Major,U.S. House,Frankie Robbins,DEM,470022,6,27,68,101,03
Marshall,President,Donald Trump,REP,480101,11,109,430,550,
Marshall,President,Gary Johnson,LIB,480101,0,6,25,31,
Marshall,President,Hillary Clinton,DEM,480101,4,24,109,137,
Marshall,U.S. Senate,James Lankford,REP,480101,10,99,395,504,
Marshall,U.S. Senate,Robert Murphy,LIB,480101,0,1,19,20,
Marshall,U.S. Senate,Mike Workman,DEM,480101,5,38,124,167,
Marshall,U.S. Senate,Mark Beard,IND,480101,0,1,7,8,
Marshall,U.S. Senate,Sean Braddy,IND,480101,0,1,15,16,
Marshall,U.S. House,Markwayne Mullin,REP,480101,11,103,392,506,02
Marshall,U.S. House,Joshua Harris-Till,DEM,480101,4,33,121,158,02
Marshall,U.S. House,John Mccarthy,IND,480101,0,3,42,45,02
Marshall,State House,Tommy Hardin,REP,480101,11,106,400,517,49
Marshall,State House,Michelle Bray,DEM,480101,4,36,162,202,49
Marshall,President,Donald Trump,REP,480102,7,58,217,282,
Marshall,President,Gary Johnson,LIB,480102,1,1,13,15,
Marshall,President,Hillary Clinton,DEM,480102,4,11,83,98,
Marshall,U.S. Senate,James Lankford,REP,480102,6,54,185,245,
Marshall,U.S. Senate,Robert Murphy,LIB,480102,0,3,11,14,
Marshall,U.S. Senate,Mike Workman,DEM,480102,4,10,86,100,
Marshall,U.S. Senate,Mark Beard,IND,480102,0,0,12,12,
Marshall,U.S. Senate,Sean Braddy,IND,480102,1,1,8,10,
Marshall,U.S. House,Markwayne Mullin,REP,480102,7,56,203,266,02
Marshall,U.S. House,Joshua Harris-Till,DEM,480102,3,12,81,96,02
Marshall,U.S. House,John Mccarthy,IND,480102,1,2,19,22,02
Marshall,State House,Tommy Hardin,REP,480102,7,61,207,275,49
Marshall,State House,Michelle Bray,DEM,480102,4,10,101,115,49
Marshall,President,Donald Trump,REP,480105,20,30,228,278,
Marshall,President,Gary Johnson,LIB,480105,0,1,12,13,
Marshall,President,Hillary Clinton,DEM,480105,1,19,52,72,
Marshall,U.S. Senate,James Lankford,REP,480105,20,30,214,264,
Marshall,U.S. Senate,Robert Murphy,LIB,480105,0,2,7,9,
Marshall,U.S. Senate,Mike Workman,DEM,480105,1,17,54,72,
Marshall,U.S. Senate,Mark Beard,IND,480105,0,0,4,4,
Marshall,U.S. Senate,Sean Braddy,IND,480105,0,0,9,9,
Marshall,U.S. House,Markwayne Mullin,REP,480105,18,32,219,269,02
Marshall,U.S. House,Joshua Harris-Till,DEM,480105,1,17,52,70,02
Marshall,U.S. House,John Mccarthy,IND,480105,2,1,21,24,02
Marshall,State House,Tommy Hardin,REP,480105,19,27,228,274,49
Marshall,State House,Michelle Bray,DEM,480105,2,22,66,90,49
Marshall,President,Donald Trump,REP,480106,5,33,149,187,
Marshall,President,Gary Johnson,LIB,480106,0,1,5,6,
Marshall,President,Hillary Clinton,DEM,480106,3,4,47,54,
Marshall,U.S. Senate,James Lankford,REP,480106,6,31,119,156,
Marshall,U.S. Senate,Robert Murphy,LIB,480106,0,0,2,2,
Marshall,U.S. Senate,Mike Workman,DEM,480106,2,6,59,67,
Marshall,U.S. Senate,Mark Beard,IND,480106,0,0,8,8,
Marshall,U.S. Senate,Sean Braddy,IND,480106,0,1,11,12,
Marshall,U.S. House,Markwayne Mullin,REP,480106,5,32,127,164,02
Marshall,U.S. House,Joshua Harris-Till,DEM,480106,3,4,59,66,02
Marshall,U.S. House,John Mccarthy,IND,480106,0,2,14,16,02
Marshall,State House,Tommy Hardin,REP,480106,5,32,149,186,49
Marshall,State House,Michelle Bray,DEM,480106,3,6,51,60,49
Marshall,President,Donald Trump,REP,480201,7,52,172,231,
Marshall,President,Gary Johnson,LIB,480201,0,2,11,13,
Marshall,President,Hillary Clinton,DEM,480201,1,9,56,66,
Marshall,U.S. Senate,James Lankford,REP,480201,7,49,165,221,
Marshall,U.S. Senate,Robert Murphy,LIB,480201,0,3,7,10,
Marshall,U.S. Senate,Mike Workman,DEM,480201,1,8,54,63,
Marshall,U.S. Senate,Mark Beard,IND,480201,0,1,4,5,
Marshall,U.S. Senate,Sean Braddy,IND,480201,1,1,5,7,
Marshall,U.S. House,Markwayne Mullin,REP,480201,6,49,173,228,02
Marshall,U.S. House,Joshua Harris-Till,DEM,480201,1,11,49,61,02
Marshall,U.S. House,John Mccarthy,IND,480201,1,2,13,16,02
Marshall,State House,Tommy Hardin,REP,480201,7,47,162,216,49
Marshall,State House,Michelle Bray,DEM,480201,2,16,73,91,49
Marshall,President,Donald Trump,REP,480202,9,44,175,228,
Marshall,President,Gary Johnson,LIB,480202,0,6,16,22,
Marshall,President,Hillary Clinton,DEM,480202,3,29,77,109,
Marshall,U.S. Senate,James Lankford,REP,480202,9,48,167,224,
Marshall,U.S. Senate,Robert Murphy,LIB,480202,0,4,10,14,
Marshall,U.S. Senate,Mike Workman,DEM,480202,3,25,74,102,
Marshall,U.S. Senate,Mark Beard,IND,480202,0,0,8,8,
Marshall,U.S. Senate,Sean Braddy,IND,480202,0,2,6,8,
Marshall,U.S. House,Markwayne Mullin,REP,480202,9,47,172,228,02
Marshall,U.S. House,Joshua Harris-Till,DEM,480202,3,30,76,109,02
Marshall,U.S. House,John Mccarthy,IND,480202,0,3,17,20,02
Marshall,State House,Tommy Hardin,REP,480202,9,46,168,223,49
Marshall,State House,Michelle Bray,DEM,480202,3,33,100,136,49
Marshall,President,Donald Trump,REP,480204,20,79,362,461,
Marshall,President,Gary Johnson,LIB,480204,0,4,15,19,
Marshall,President,Hillary Clinton,DEM,480204,2,22,75,99,
Marshall,U.S. Senate,James Lankford,REP,480204,19,74,310,403,
Marshall,U.S. Senate,Robert Murphy,LIB,480204,0,1,14,15,
Marshall,U.S. Senate,Mike Workman,DEM,480204,3,26,98,127,
Marshall,U.S. Senate,Mark Beard,IND,480204,0,2,10,12,
Marshall,U.S. Senate,Sean Braddy,IND,480204,0,2,13,15,
Marshall,U.S. House,Markwayne Mullin,REP,480204,20,77,321,418,02
Marshall,U.S. House,Joshua Harris-Till,DEM,480204,2,25,88,115,02
Marshall,U.S. House,John Mccarthy,IND,480204,0,3,36,39,02
Marshall,State House,Tommy Hardin,REP,480204,21,76,336,433,49
Marshall,State House,Michelle Bray,DEM,480204,1,29,113,143,49
Marshall,President,Donald Trump,REP,480206,15,36,247,298,
Marshall,President,Gary Johnson,LIB,480206,1,0,15,16,
Marshall,President,Hillary Clinton,DEM,480206,1,6,62,69,
Marshall,U.S. Senate,James Lankford,REP,480206,14,34,241,289,
Marshall,U.S. Senate,Robert Murphy,LIB,480206,0,0,9,9,
Marshall,U.S. Senate,Mike Workman,DEM,480206,1,7,54,62,
Marshall,U.S. Senate,Mark Beard,IND,480206,1,0,7,8,
Marshall,U.S. Senate,Sean Braddy,IND,480206,1,0,10,11,
Marshall,U.S. House,Markwayne Mullin,REP,480206,15,33,249,297,02
Marshall,U.S. House,Joshua Harris-Till,DEM,480206,1,8,52,61,02
Marshall,U.S. House,John Mccarthy,IND,480206,1,1,20,22,02
Marshall,State House,Tommy Hardin,REP,480206,15,31,245,291,49
Marshall,State House,Michelle Bray,DEM,480206,2,11,76,89,49
Marshall,President,Donald Trump,REP,480302,17,46,282,345,
Marshall,President,Gary Johnson,LIB,480302,3,1,7,11,
Marshall,President,Hillary Clinton,DEM,480302,5,20,61,86,
Marshall,U.S. Senate,James Lankford,REP,480302,17,40,245,302,
Marshall,U.S. Senate,Robert Murphy,LIB,480302,4,1,12,17,
Marshall,U.S. Senate,Mike Workman,DEM,480302,3,21,72,96,
Marshall,U.S. Senate,Mark Beard,IND,480302,0,3,10,13,
Marshall,U.S. Senate,Sean Braddy,IND,480302,1,1,6,8,
Marshall,U.S. House,Markwayne Mullin,REP,480302,15,46,252,313,02
Marshall,U.S. House,Joshua Harris-Till,DEM,480302,8,18,70,96,02
Marshall,U.S. House,John Mccarthy,IND,480302,1,3,21,25,02
Marshall,State House,Tommy Hardin,REP,480302,18,47,263,328,49
Marshall,State House,Michelle Bray,DEM,480302,6,20,84,110,49
Marshall,President,Donald Trump,REP,480303,22,124,458,604,
Marshall,President,Gary Johnson,LIB,480303,1,1,18,20,
Marshall,President,Hillary Clinton,DEM,480303,10,17,104,131,
Marshall,U.S. Senate,James Lankford,REP,480303,22,108,417,547,
Marshall,U.S. Senate,Robert Murphy,LIB,480303,1,5,11,17,
Marshall,U.S. Senate,Mike Workman,DEM,480303,10,26,114,150,
Marshall,U.S. Senate,Mark Beard,IND,480303,0,1,14,15,
Marshall,U.S. Senate,Sean Braddy,IND,480303,0,0,16,16,
Marshall,U.S. House,Markwayne Mullin,REP,480303,21,110,413,544,02
Marshall,U.S. House,Joshua Harris-Till,DEM,480303,11,26,111,148,02
Marshall,U.S. House,John Mccarthy,IND,480303,1,3,48,52,02
Marshall,State House,Tommy Hardin,REP,480303,19,111,424,554,49
Marshall,State House,Michelle Bray,DEM,480303,14,26,142,182,49
Marshall,President,Donald Trump,REP,480304,60,101,581,742,
Marshall,President,Gary Johnson,LIB,480304,1,3,20,24,
Marshall,President,Hillary Clinton,DEM,480304,7,23,145,175,
Marshall,U.S. Senate,James Lankford,REP,480304,63,97,509,669,
Marshall,U.S. Senate,Robert Murphy,LIB,480304,2,1,23,26,
Marshall,U.S. Senate,Mike Workman,DEM,480304,2,24,165,191,
Marshall,U.S. Senate,Mark Beard,IND,480304,0,2,29,31,
Marshall,U.S. Senate,Sean Braddy,IND,480304,0,2,15,17,
Marshall,U.S. House,Markwayne Mullin,REP,480304,63,92,521,676,02
Marshall,U.S. House,Joshua Harris-Till,DEM,480304,3,26,164,193,02
Marshall,U.S. House,John Mccarthy,IND,480304,2,8,56,66,02
Marshall,State House,Tommy Hardin,REP,480304,63,97,548,708,49
Marshall,State House,Michelle Bray,DEM,480304,5,30,190,225,49
Mayes,President,Donald Trump,REP,490011,20,46,433,499,
Mayes,President,Gary Johnson,LIB,490011,2,1,29,32,
Mayes,President,Hillary Clinton,DEM,490011,3,24,107,134,
Mayes,U.S. Senate,James Lankford,REP,490011,20,47,422,489,
Mayes,U.S. Senate,Robert Murphy,LIB,490011,1,0,17,18,
Mayes,U.S. Senate,Mike Workman,DEM,490011,4,21,112,137,
Mayes,U.S. Senate,Mark Beard,IND,490011,0,0,8,8,
Mayes,U.S. Senate,Sean Braddy,IND,490011,0,3,6,9,
Mayes,U.S. House,Markwayne Mullin,REP,490011,20,45,432,497,02
Mayes,U.S. House,Joshua Harris-Till,DEM,490011,4,24,106,134,02
Mayes,U.S. House,John Mccarthy,IND,490011,1,2,25,28,02
Mayes,State Senate,Micheal Bergstrom,REP,490011,21,42,391,454,1
Mayes,State Senate,John Myers,DEM,490011,4,28,166,198,1
Mayes,President,Donald Trump,REP,490012,16,41,464,521,
Mayes,President,Gary Johnson,LIB,490012,1,3,26,30,
Mayes,President,Hillary Clinton,DEM,490012,6,12,116,134,
Mayes,U.S. Senate,James Lankford,REP,490012,15,42,448,505,
Mayes,U.S. Senate,Robert Murphy,LIB,490012,1,1,16,18,
Mayes,U.S. Senate,Mike Workman,DEM,490012,5,9,124,138,
Mayes,U.S. Senate,Mark Beard,IND,490012,1,2,8,11,
Mayes,U.S. Senate,Sean Braddy,IND,490012,0,1,6,7,
Mayes,U.S. House,Markwayne Mullin,REP,490012,16,44,471,531,02
Mayes,U.S. House,Joshua Harris-Till,DEM,490012,7,11,104,122,02
Mayes,U.S. House,John Mccarthy,IND,490012,0,0,26,26,02
Mayes,State Senate,Micheal Bergstrom,REP,490012,12,37,397,446,1
Mayes,State Senate,John Myers,DEM,490012,11,18,205,234,1
Mayes,President,Donald Trump,REP,490014,2,5,120,127,
Mayes,President,Gary Johnson,LIB,490014,0,0,13,13,
Mayes,President,Hillary Clinton,DEM,490014,0,3,51,54,
Mayes,U.S. Senate,James Lankford,REP,490014,2,5,130,137,
Mayes,U.S. Senate,Robert Murphy,LIB,490014,0,1,3,4,
Mayes,U.S. Senate,Mike Workman,DEM,490014,0,2,38,40,
Mayes,U.S. Senate,Mark Beard,IND,490014,0,0,3,3,
Mayes,U.S. Senate,Sean Braddy,IND,490014,0,0,9,9,
Mayes,U.S. House,Markwayne Mullin,REP,490014,2,5,134,141,02
Mayes,U.S. House,Joshua Harris-Till,DEM,490014,0,2,37,39,02
Mayes,U.S. House,John Mccarthy,IND,490014,0,1,12,13,02
Mayes,State Senate,Micheal Bergstrom,REP,490014,2,5,108,115,1
Mayes,State Senate,John Myers,DEM,490014,0,3,73,76,1
Mayes,State House,Josh West,REP,490014,2,3,112,117,5
Mayes,State House,Matt Nowlin,DEM,490014,0,4,67,71,5
Mayes,President,Donald Trump,REP,490015,12,48,288,348,
Mayes,President,Gary Johnson,LIB,490015,1,3,14,18,
Mayes,President,Hillary Clinton,DEM,490015,5,24,92,121,
Mayes,U.S. Senate,James Lankford,REP,490015,13,45,284,342,
Mayes,U.S. Senate,Robert Murphy,LIB,490015,0,1,7,8,
Mayes,U.S. Senate,Mike Workman,DEM,490015,5,26,90,121,
Mayes,U.S. Senate,Mark Beard,IND,490015,0,1,10,11,
Mayes,U.S. Senate,Sean Braddy,IND,490015,0,1,6,7,
Mayes,U.S. House,Markwayne Mullin,REP,490015,12,44,281,337,02
Mayes,U.S. House,Joshua Harris-Till,DEM,490015,6,26,87,119,02
Mayes,U.S. House,John Mccarthy,IND,490015,0,5,27,32,02
Mayes,State Senate,Micheal Bergstrom,REP,490015,13,39,261,313,1
Mayes,State Senate,John Myers,DEM,490015,5,37,130,172,1
Mayes,State House,Josh West,REP,490015,13,43,255,311,5
Mayes,State House,Matt Nowlin,DEM,490015,5,29,135,169,5
Mayes,President,Donald Trump,REP,490016,14,44,257,315,
Mayes,President,Gary Johnson,LIB,490016,0,0,11,11,
Mayes,President,Hillary Clinton,DEM,490016,5,21,60,86,
Mayes,U.S. Senate,James Lankford,REP,490016,16,41,249,306,
Mayes,U.S. Senate,Robert Murphy,LIB,490016,0,0,1,1,
Mayes,U.S. Senate,Mike Workman,DEM,490016,4,21,67,92,
Mayes,U.S. Senate,Mark Beard,IND,490016,0,1,4,5,
Mayes,U.S. Senate,Sean Braddy,IND,490016,0,0,6,6,
Mayes,U.S. House,Markwayne Mullin,REP,490016,16,38,253,307,02
Mayes,U.S. House,Joshua Harris-Till,DEM,490016,4,21,63,88,02
Mayes,U.S. House,John Mccarthy,IND,490016,0,4,13,17,02
Mayes,State Senate,Micheal Bergstrom,REP,490016,14,35,228,277,1
Mayes,State Senate,John Myers,DEM,490016,6,29,96,131,1
Mayes,President,Donald Trump,REP,490020,21,122,569,712,
Mayes,President,Gary Johnson,LIB,490020,5,4,35,44,
Mayes,President,Hillary Clinton,DEM,490020,5,33,146,184,
Mayes,U.S. Senate,James Lankford,REP,490020,24,125,559,708,
Mayes,U.S. Senate,Robert Murphy,LIB,490020,1,7,18,26,
Mayes,U.S. Senate,Mike Workman,DEM,490020,7,23,151,181,
Mayes,U.S. Senate,Mark Beard,IND,490020,0,0,10,10,
Mayes,U.S. Senate,Sean Braddy,IND,490020,0,5,9,14,
Mayes,U.S. House,Markwayne Mullin,REP,490020,22,127,582,731,02
Mayes,U.S. House,Joshua Harris-Till,DEM,490020,5,28,131,164,02
Mayes,U.S. House,John Mccarthy,IND,490020,5,6,41,52,02
Mayes,State House,Tom Gann,REP,490020,21,83,443,547,8
Mayes,State House,Darrell Moore,DEM,490020,11,77,308,396,8
Mayes,President,Donald Trump,REP,490021,18,49,244,311,
Mayes,President,Gary Johnson,LIB,490021,2,1,17,20,
Mayes,President,Hillary Clinton,DEM,490021,9,18,50,77,
Mayes,U.S. Senate,James Lankford,REP,490021,20,53,234,307,
Mayes,U.S. Senate,Robert Murphy,LIB,490021,0,0,9,9,
Mayes,U.S. Senate,Mike Workman,DEM,490021,7,15,55,77,
Mayes,U.S. Senate,Mark Beard,IND,490021,0,0,10,10,
Mayes,U.S. Senate,Sean Braddy,IND,490021,2,0,4,6,
Mayes,U.S. House,Markwayne Mullin,REP,490021,19,52,243,314,02
Mayes,U.S. House,Joshua Harris-Till,DEM,490021,6,15,49,70,02
Mayes,U.S. House,John Mccarthy,IND,490021,4,1,19,24,02
Mayes,State Senate,Micheal Bergstrom,REP,490021,19,47,223,289,1
Mayes,State Senate,John Myers,DEM,490021,9,19,87,115,1
Mayes,State House,Tom Gann,REP,490021,17,37,184,238,8
Mayes,State House,Darrell Moore,DEM,490021,10,32,128,170,8
Mayes,President,Donald Trump,REP,490022,16,37,445,498,
Mayes,President,Gary Johnson,LIB,490022,0,0,20,20,
Mayes,President,Hillary Clinton,DEM,490022,6,7,72,85,
Mayes,U.S. Senate,James Lankford,REP,490022,16,36,419,471,
Mayes,U.S. Senate,Robert Murphy,LIB,490022,0,0,13,13,
Mayes,U.S. Senate,Mike Workman,DEM,490022,5,6,80,91,
Mayes,U.S. Senate,Mark Beard,IND,490022,0,0,9,9,
Mayes,U.S. Senate,Sean Braddy,IND,490022,1,2,12,15,
Mayes,U.S. House,Markwayne Mullin,REP,490022,16,36,427,479,02
Mayes,U.S. House,Joshua Harris-Till,DEM,490022,6,7,73,86,02
Mayes,U.S. House,John Mccarthy,IND,490022,0,1,33,34,02
Mayes,State Senate,Wayne Shaw,REP,490022,12,32,358,402,3
Mayes,State Senate,Rhonda Cox,DEM,490022,10,12,173,195,3
Mayes,State House,Tom Gann,REP,490022,15,29,323,367,8
Mayes,State House,Darrell Moore,DEM,490022,7,15,214,236,8
Mayes,President,Donald Trump,REP,490023,10,62,584,656,
Mayes,President,Gary Johnson,LIB,490023,1,4,26,31,
Mayes,President,Hillary Clinton,DEM,490023,6,23,135,164,
Mayes,U.S. Senate,James Lankford,REP,490023,8,66,575,649,
Mayes,U.S. Senate,Robert Murphy,LIB,490023,0,1,11,12,
Mayes,U.S. Senate,Mike Workman,DEM,490023,6,18,128,152,
Mayes,U.S. Senate,Mark Beard,IND,490023,1,1,15,17,
Mayes,U.S. Senate,Sean Braddy,IND,490023,1,2,12,15,
Mayes,U.S. House,Markwayne Mullin,REP,490023,10,68,573,651,02
Mayes,U.S. House,Joshua Harris-Till,DEM,490023,4,18,138,160,02
Mayes,U.S. House,John Mccarthy,IND,490023,2,3,29,34,02
Mayes,State Senate,Wayne Shaw,REP,490023,7,53,493,553,3
Mayes,State Senate,Rhonda Cox,DEM,490023,9,35,242,286,3
Mayes,State House,Tom Gann,REP,490023,5,46,446,497,8
Mayes,State House,Darrell Moore,DEM,490023,11,43,291,345,8
Mayes,President,Donald Trump,REP,490024,8,27,373,408,
Mayes,President,Gary Johnson,LIB,490024,0,0,20,20,
Mayes,President,Hillary Clinton,DEM,490024,10,7,68,85,
Mayes,U.S. Senate,James Lankford,REP,490024,6,27,345,378,
Mayes,U.S. Senate,Robert Murphy,LIB,490024,1,0,8,9,
Mayes,U.S. Senate,Mike Workman,DEM,490024,11,6,83,100,
Mayes,U.S. Senate,Mark Beard,IND,490024,0,0,9,9,
Mayes,U.S. Senate,Sean Braddy,IND,490024,0,0,10,10,
Mayes,U.S. House,Markwayne Mullin,REP,490024,4,25,339,368,02
Mayes,U.S. House,Joshua Harris-Till,DEM,490024,12,4,74,90,02
Mayes,U.S. House,John Mccarthy,IND,490024,2,4,43,49,02
Mayes,State Senate,Wayne Shaw,REP,490024,7,23,308,338,3
Mayes,State Senate,Rhonda Cox,DEM,490024,11,10,141,162,3
Mayes,State House,Tom Gann,REP,490024,6,22,315,343,8
Mayes,State House,Darrell Moore,DEM,490024,12,11,139,162,8
Mayes,President,Donald Trump,REP,490025,6,17,272,295,
Mayes,President,Gary Johnson,LIB,490025,0,1,11,12,
Mayes,President,Hillary Clinton,DEM,490025,2,4,74,80,
Mayes,U.S. Senate,James Lankford,REP,490025,4,20,258,282,
Mayes,U.S. Senate,Robert Murphy,LIB,490025,1,0,10,11,
Mayes,U.S. Senate,Mike Workman,DEM,490025,2,2,69,73,
Mayes,U.S. Senate,Mark Beard,IND,490025,0,0,8,8,
Mayes,U.S. Senate,Sean Braddy,IND,490025,0,0,11,11,
Mayes,U.S. House,Markwayne Mullin,REP,490025,4,18,269,291,02
Mayes,U.S. House,Joshua Harris-Till,DEM,490025,2,3,71,76,02
Mayes,U.S. House,John Mccarthy,IND,490025,1,1,21,23,02
Mayes,State House,Tom Gann,REP,490025,5,16,231,252,8
Mayes,State House,Darrell Moore,DEM,490025,2,6,121,129,8
Mayes,President,Donald Trump,REP,490026,3,1,42,46,
Mayes,President,Gary Johnson,LIB,490026,0,0,2,2,
Mayes,President,Hillary Clinton,DEM,490026,0,0,8,8,
Mayes,U.S. Senate,James Lankford,REP,490026,3,0,40,43,
Mayes,U.S. Senate,Robert Murphy,LIB,490026,0,0,2,2,
Mayes,U.S. Senate,Mike Workman,DEM,490026,0,1,10,11,
Mayes,U.S. Senate,Mark Beard,IND,490026,0,0,0,0,
Mayes,U.S. Senate,Sean Braddy,IND,490026,0,0,0,0,
Mayes,U.S. House,Markwayne Mullin,REP,490026,3,0,44,47,02
Mayes,U.S. House,Joshua Harris-Till,DEM,490026,0,1,7,8,02
Mayes,U.S. House,John Mccarthy,IND,490026,0,0,2,2,02
Mayes,State Senate,Wayne Shaw,REP,490026,3,0,37,40,3
Mayes,State Senate,Rhonda Cox,DEM,490026,0,1,16,17,3
Mayes,State House,Tom Gann,REP,490026,3,0,41,44,8
Mayes,State House,Darrell Moore,DEM,490026,0,1,11,12,8
Mayes,President,Donald Trump,REP,490027,1,0,56,57,
Mayes,President,Gary Johnson,LIB,490027,0,0,5,5,
Mayes,President,Hillary Clinton,DEM,490027,0,0,10,10,
Mayes,U.S. Senate,James Lankford,REP,490027,1,0,56,57,
Mayes,U.S. Senate,Robert Murphy,LIB,490027,0,0,4,4,
Mayes,U.S. Senate,Mike Workman,DEM,490027,0,0,8,8,
Mayes,U.S. Senate,Mark Beard,IND,490027,0,0,2,2,
Mayes,U.S. Senate,Sean Braddy,IND,490027,0,0,1,1,
Mayes,U.S. House,Markwayne Mullin,REP,490027,1,0,55,56,02
Mayes,U.S. House,Joshua Harris-Till,DEM,490027,0,0,8,8,02
Mayes,U.S. House,John Mccarthy,IND,490027,0,0,7,7,02
Mayes,State House,Tom Gann,REP,490027,1,0,42,43,8
Mayes,State House,Darrell Moore,DEM,490027,0,0,28,28,8
Mayes,President,Donald Trump,REP,490031,19,26,565,610,
Mayes,President,Gary Johnson,LIB,490031,1,0,23,24,
Mayes,President,Hillary Clinton,DEM,490031,6,20,181,207,
Mayes,U.S. Senate,James Lankford,REP,490031,19,27,561,607,
Mayes,U.S. Senate,Robert Murphy,LIB,490031,1,1,13,15,
Mayes,U.S. Senate,Mike Workman,DEM,490031,5,15,162,182,
Mayes,U.S. Senate,Mark Beard,IND,490031,0,1,12,13,
Mayes,U.S. Senate,Sean Braddy,IND,490031,1,2,12,15,
Mayes,U.S. House,Markwayne Mullin,REP,490031,20,30,568,618,02
Mayes,U.S. House,Joshua Harris-Till,DEM,490031,6,15,151,172,02
Mayes,U.S. House,John Mccarthy,IND,490031,0,1,43,44,02
Mayes,State Senate,Micheal Bergstrom,REP,490031,20,25,493,538,1
Mayes,State Senate,John Myers,DEM,490031,6,21,264,291,1
Mayes,State House,Josh West,REP,490031,20,30,516,566,5
Mayes,State House,Matt Nowlin,DEM,490031,6,15,235,256,5
Mayes,President,Donald Trump,REP,490034,12,15,295,322,
Mayes,President,Gary Johnson,LIB,490034,1,0,15,16,
Mayes,President,Hillary Clinton,DEM,490034,8,5,88,101,
Mayes,U.S. Senate,James Lankford,REP,490034,13,11,280,304,
Mayes,U.S. Senate,Robert Murphy,LIB,490034,0,0,9,9,
Mayes,U.S. Senate,Mike Workman,DEM,490034,8,4,95,107,
Mayes,U.S. Senate,Mark Beard,IND,490034,1,2,8,11,
Mayes,U.S. Senate,Sean Braddy,IND,490034,0,1,4,5,
Mayes,U.S. House,Markwayne Mullin,REP,490034,13,14,283,310,02
Mayes,U.S. House,Joshua Harris-Till,DEM,490034,8,4,86,98,02
Mayes,U.S. House,John Mccarthy,IND,490034,1,2,26,29,02
Mayes,State Senate,Micheal Bergstrom,REP,490034,5,9,242,256,1
Mayes,State Senate,John Myers,DEM,490034,15,9,151,175,1
Mayes,State House,Josh West,REP,490034,9,12,263,284,5
Mayes,State House,Matt Nowlin,DEM,490034,11,7,128,146,5
Mayes,President,Donald Trump,REP,490036,35,67,857,959,
Mayes,President,Gary Johnson,LIB,490036,2,4,73,79,
Mayes,President,Hillary Clinton,DEM,490036,14,25,256,295,
Mayes,U.S. Senate,James Lankford,REP,490036,36,62,802,900,
Mayes,U.S. Senate,Robert Murphy,LIB,490036,2,1,34,37,
Mayes,U.S. Senate,Mike Workman,DEM,490036,9,29,289,327,
Mayes,U.S. Senate,Mark Beard,IND,490036,1,1,27,29,
Mayes,U.S. Senate,Sean Braddy,IND,490036,2,4,27,33,
Mayes,U.S. House,Markwayne Mullin,REP,490036,37,70,834,941,02
Mayes,U.S. House,Joshua Harris-Till,DEM,490036,11,22,270,303,02
Mayes,U.S. House,John Mccarthy,IND,490036,2,5,72,79,02
Mayes,State Senate,Micheal Bergstrom,REP,490036,33,49,717,799,1
Mayes,State Senate,John Myers,DEM,490036,16,45,448,509,1
Mayes,State House,Josh West,REP,490036,33,56,752,841,5
Mayes,State House,Matt Nowlin,DEM,490036,16,38,408,462,5
Mayes,President,Donald Trump,REP,490037,16,45,556,617,
Mayes,President,Gary Johnson,LIB,490037,0,1,26,27,
Mayes,President,Hillary Clinton,DEM,490037,8,17,109,134,
Mayes,U.S. Senate,James Lankford,REP,490037,17,47,521,585,
Mayes,U.S. Senate,Robert Murphy,LIB,490037,1,1,12,14,
Mayes,U.S. Senate,Mike Workman,DEM,490037,6,13,135,154,
Mayes,U.S. Senate,Mark Beard,IND,490037,0,0,19,19,
Mayes,U.S. Senate,Sean Braddy,IND,490037,0,1,9,10,
Mayes,U.S. House,Markwayne Mullin,REP,490037,18,46,535,599,02
Mayes,U.S. House,Joshua Harris-Till,DEM,490037,6,14,116,136,02
Mayes,U.S. House,John Mccarthy,IND,490037,0,2,47,49,02
Mayes,State Senate,Wayne Shaw,REP,490037,15,35,391,441,3
Mayes,State Senate,Rhonda Cox,DEM,490037,9,28,300,337,3
Mayes,State House,Tom Gann,REP,490037,13,41,450,504,8
Mayes,State House,Darrell Moore,DEM,490037,11,22,246,279,8
Mayes,President,Donald Trump,REP,490038,9,10,156,175,
Mayes,President,Gary Johnson,LIB,490038,1,0,8,9,
Mayes,President,Hillary Clinton,DEM,490038,4,6,54,64,
Mayes,U.S. Senate,James Lankford,REP,490038,9,12,154,175,
Mayes,U.S. Senate,Robert Murphy,LIB,490038,0,0,3,3,
Mayes,U.S. Senate,Mike Workman,DEM,490038,5,4,57,66,
Mayes,U.S. Senate,Mark Beard,IND,490038,0,0,1,1,
Mayes,U.S. Senate,Sean Braddy,IND,490038,0,0,2,2,
Mayes,U.S. House,Markwayne Mullin,REP,490038,8,12,156,176,02
Mayes,U.S. House,Joshua Harris-Till,DEM,490038,6,4,50,60,02
Mayes,U.S. House,John Mccarthy,IND,490038,0,0,11,11,02
Mayes,State Senate,Micheal Bergstrom,REP,490038,7,10,131,148,1
Mayes,State Senate,John Myers,DEM,490038,7,6,86,99,1
Mayes,State House,Tom Gann,REP,490038,6,10,135,151,8
Mayes,State House,Darrell Moore,DEM,490038,8,6,84,98,8
Mayes,President,Donald Trump,REP,490039,10,51,475,536,
Mayes,President,Gary Johnson,LIB,490039,1,2,51,54,
Mayes,President,Hillary Clinton,DEM,490039,7,12,177,196,
Mayes,U.S. Senate,James Lankford,REP,490039,11,51,460,522,
Mayes,U.S. Senate,Robert Murphy,LIB,490039,0,2,16,18,
Mayes,U.S. Senate,Mike Workman,DEM,490039,4,9,193,206,
Mayes,U.S. Senate,Mark Beard,IND,490039,1,1,17,19,
Mayes,U.S. Senate,Sean Braddy,IND,490039,0,0,19,19,
Mayes,U.S. House,Markwayne Mullin,REP,490039,11,48,497,556,02
Mayes,U.S. House,Joshua Harris-Till,DEM,490039,4,11,177,192,02
Mayes,U.S. House,John Mccarthy,IND,490039,1,5,35,41,02
Mayes,State Senate,Wayne Shaw,REP,490039,10,41,318,369,3
Mayes,State Senate,Rhonda Cox,DEM,490039,6,23,387,416,3
Mayes,State House,Tom Gann,REP,490039,10,49,375,434,8
Mayes,State House,Darrell Moore,DEM,490039,7,15,329,351,8
Mayes,President,Donald Trump,REP,490101,9,49,267,325,
Mayes,President,Gary Johnson,LIB,490101,0,4,21,25,
Mayes,President,Hillary Clinton,DEM,490101,7,24,102,133,
Mayes,U.S. Senate,James Lankford,REP,490101,8,51,267,326,
Mayes,U.S. Senate,Robert Murphy,LIB,490101,0,2,16,18,
Mayes,U.S. Senate,Mike Workman,DEM,490101,8,22,86,116,
Mayes,U.S. Senate,Mark Beard,IND,490101,0,1,7,8,
Mayes,U.S. Senate,Sean Braddy,IND,490101,0,1,14,15,
Mayes,U.S. House,Markwayne Mullin,REP,490101,8,54,271,333,02
Mayes,U.S. House,Joshua Harris-Till,DEM,490101,8,18,90,116,02
Mayes,U.S. House,John Mccarthy,IND,490101,0,5,28,33,02
Mayes,State House,Tom Gann,REP,490101,4,34,183,221,8
Mayes,State House,Darrell Moore,DEM,490101,11,45,203,259,8
Mayes,President,Donald Trump,REP,490121,23,113,490,626,
Mayes,President,Gary Johnson,LIB,490121,3,10,41,54,
Mayes,President,Hillary Clinton,DEM,490121,9,42,134,185,
Mayes,U.S. Senate,James Lankford,REP,490121,24,112,470,606,
Mayes,U.S. Senate,Robert Murphy,LIB,490121,2,3,14,19,
Mayes,U.S. Senate,Mike Workman,DEM,490121,7,46,141,194,
Mayes,U.S. Senate,Mark Beard,IND,490121,0,2,18,20,
Mayes,U.S. Senate,Sean Braddy,IND,490121,0,3,18,21,
Mayes,U.S. House,Markwayne Mullin,REP,490121,24,117,492,633,02
Mayes,U.S. House,Joshua Harris-Till,DEM,490121,7,37,135,179,02
Mayes,U.S. House,John Mccarthy,IND,490121,2,10,35,47,02
Mayes,State House,Tom Gann,REP,490121,16,78,332,426,8
Mayes,State House,Darrell Moore,DEM,490121,17,89,331,437,8
Mayes,President,Donald Trump,REP,490122,0,16,66,82,
Mayes,President,Gary Johnson,LIB,490122,0,1,4,5,
Mayes,President,Hillary Clinton,DEM,490122,0,4,15,19,
Mayes,U.S. Senate,James Lankford,REP,490122,0,17,69,86,
Mayes,U.S. Senate,Robert Murphy,LIB,490122,0,1,1,2,
Mayes,U.S. Senate,Mike Workman,DEM,490122,0,2,15,17,
Mayes,U.S. Senate,Mark Beard,IND,490122,0,1,0,1,
Mayes,U.S. Senate,Sean Braddy,IND,490122,0,0,0,0,
Mayes,U.S. House,Markwayne Mullin,REP,490122,0,17,73,90,02
Mayes,U.S. House,Joshua Harris-Till,DEM,490122,0,3,11,14,02
Mayes,U.S. House,John Mccarthy,IND,490122,0,0,2,2,02
Mayes,State Senate,Micheal Bergstrom,REP,490122,0,16,53,69,1
Mayes,State Senate,John Myers,DEM,490122,0,4,31,35,1
Mayes,State House,Tom Gann,REP,490122,0,12,37,49,8
Mayes,State House,Darrell Moore,DEM,490122,0,9,49,58,8
Mayes,President,Donald Trump,REP,490130,14,41,330,385,
Mayes,President,Gary Johnson,LIB,490130,1,0,18,19,
Mayes,President,Hillary Clinton,DEM,490130,6,14,104,124,
Mayes,U.S. Senate,James Lankford,REP,490130,13,41,322,376,
Mayes,U.S. Senate,Robert Murphy,LIB,490130,1,0,8,9,
Mayes,U.S. Senate,Mike Workman,DEM,490130,7,14,109,130,
Mayes,U.S. Senate,Mark Beard,IND,490130,0,0,2,2,
Mayes,U.S. Senate,Sean Braddy,IND,490130,0,0,9,9,
Mayes,U.S. House,Markwayne Mullin,REP,490130,14,40,325,379,02
Mayes,U.S. House,Joshua Harris-Till,DEM,490130,7,12,100,119,02
Mayes,U.S. House,John Mccarthy,IND,490130,0,3,24,27,02
Mayes,State Senate,Micheal Bergstrom,REP,490130,13,34,278,325,1
Mayes,State Senate,John Myers,DEM,490130,8,21,170,199,1
Mayes,State House,Josh West,REP,490130,14,39,293,346,5
Mayes,State House,Matt Nowlin,DEM,490130,7,16,148,171,5
Mayes,President,Donald Trump,REP,490132,16,78,349,443,
Mayes,President,Gary Johnson,LIB,490132,2,6,30,38,
Mayes,President,Hillary Clinton,DEM,490132,14,25,136,175,
Mayes,U.S. Senate,James Lankford,REP,490132,19,80,362,461,
Mayes,U.S. Senate,Robert Murphy,LIB,490132,2,0,10,12,
Mayes,U.S. Senate,Mike Workman,DEM,490132,12,26,113,151,
Mayes,U.S. Senate,Mark Beard,IND,490132,0,1,11,12,
Mayes,U.S. Senate,Sean Braddy,IND,490132,0,2,13,15,
Mayes,U.S. House,Markwayne Mullin,REP,490132,16,83,354,453,02
Mayes,U.S. House,Joshua Harris-Till,DEM,490132,12,23,117,152,02
Mayes,U.S. House,John Mccarthy,IND,490132,5,3,39,47,02
Mayes,State House,Tom Gann,REP,490132,15,48,234,297,8
Mayes,State House,Darrell Moore,DEM,490132,18,64,275,357,8
Mayes,President,Donald Trump,REP,490241,37,169,682,888,
Mayes,President,Gary Johnson,LIB,490241,8,6,55,69,
Mayes,President,Hillary Clinton,DEM,490241,28,69,221,318,
Mayes,U.S. Senate,James Lankford,REP,490241,46,174,701,921,
Mayes,U.S. Senate,Robert Murphy,LIB,490241,3,3,14,20,
Mayes,U.S. Senate,Mike Workman,DEM,490241,23,65,203,291,
Mayes,U.S. Senate,Mark Beard,IND,490241,1,0,15,16,
Mayes,U.S. Senate,Sean Braddy,IND,490241,2,1,20,23,
Mayes,U.S. House,Markwayne Mullin,REP,490241,43,171,704,918,02
Mayes,U.S. House,Joshua Harris-Till,DEM,490241,24,63,211,298,02
Mayes,U.S. House,John Mccarthy,IND,490241,7,10,41,58,02
Mayes,State House,Tom Gann,REP,490241,22,114,445,581,8
Mayes,State House,Darrell Moore,DEM,490241,48,129,509,686,8
Mayes,President,Donald Trump,REP,490242,9,73,417,499,
Mayes,President,Gary Johnson,LIB,490242,3,6,33,42,
Mayes,President,Hillary Clinton,DEM,490242,10,34,116,160,
Mayes,U.S. Senate,James Lankford,REP,490242,10,78,405,493,
Mayes,U.S. Senate,Robert Murphy,LIB,490242,1,3,21,25,
Mayes,U.S. Senate,Mike Workman,DEM,490242,10,27,109,146,
Mayes,U.S. Senate,Mark Beard,IND,490242,0,4,10,14,
Mayes,U.S. Senate,Sean Braddy,IND,490242,1,1,13,15,
Mayes,U.S. House,Markwayne Mullin,REP,490242,10,78,410,498,02
Mayes,U.S. House,Joshua Harris-Till,DEM,490242,12,25,112,149,02
Mayes,U.S. House,John Mccarthy,IND,490242,1,9,40,50,02
Mayes,State House,Tom Gann,REP,490242,9,48,259,316,8
Mayes,State House,Darrell Moore,DEM,490242,14,65,302,381,8
Mayes,President,Donald Trump,REP,490311,8,19,268,295,
Mayes,President,Gary Johnson,LIB,490311,1,2,17,20,
Mayes,President,Hillary Clinton,DEM,490311,1,5,84,90,
Mayes,U.S. Senate,James Lankford,REP,490311,8,18,244,270,
Mayes,U.S. Senate,Robert Murphy,LIB,490311,0,2,8,10,
Mayes,U.S. Senate,Mike Workman,DEM,490311,2,5,94,101,
Mayes,U.S. Senate,Mark Beard,IND,490311,0,1,12,13,
Mayes,U.S. Senate,Sean Braddy,IND,490311,0,0,7,7,
Mayes,U.S. House,Markwayne Mullin,REP,490311,8,18,256,282,02
Mayes,U.S. House,Joshua Harris-Till,DEM,490311,1,4,81,86,02
Mayes,U.S. House,John Mccarthy,IND,490311,1,4,28,33,02
Mayes,State House,Tom Gann,REP,490311,6,18,227,251,8
Mayes,State House,Darrell Moore,DEM,490311,4,8,139,151,8
Murray,President,Donald Trump,REP,500004,27,86,485,598,
Murray,President,Gary Johnson,LIB,500004,1,3,24,28,
Murray,President,Hillary Clinton,DEM,500004,9,27,88,124,
Murray,U.S. Senate,James Lankford,REP,500004,26,88,471,585,
Murray,U.S. Senate,Robert Murphy,LIB,500004,0,0,19,19,
Murray,U.S. Senate,Mike Workman,DEM,500004,10,24,85,119,
Murray,U.S. Senate,Mark Beard,IND,500004,1,0,9,10,
Murray,U.S. Senate,Sean Braddy,IND,500004,0,1,10,11,
Murray,U.S. House,Tom Cole,REP,500004,30,87,493,610,04
Murray,U.S. House,Sevier White,LIB,500004,0,1,19,20,04
Murray,U.S. House,Christina Owen,DEM,500004,7,27,83,117,04
Murray,President,Donald Trump,REP,500005,22,83,699,804,
Murray,President,Gary Johnson,LIB,500005,4,3,50,57,
Murray,President,Hillary Clinton,DEM,500005,11,14,205,230,
Murray,U.S. Senate,James Lankford,REP,500005,28,77,705,810,
Murray,U.S. Senate,Robert Murphy,LIB,500005,1,5,31,37,
Murray,U.S. Senate,Mike Workman,DEM,500005,6,15,180,201,
Murray,U.S. Senate,Mark Beard,IND,500005,1,1,15,17,
Murray,U.S. Senate,Sean Braddy,IND,500005,1,2,21,24,
Murray,U.S. House,Tom Cole,REP,500005,30,81,736,847,04
Murray,U.S. House,Sevier White,LIB,500005,1,3,29,33,04
Murray,U.S. House,Christina Owen,DEM,500005,6,16,187,209,04
Murray,President,Donald Trump,REP,500007,7,19,232,258,
Murray,President,Gary Johnson,LIB,500007,1,0,11,12,
Murray,President,Hillary Clinton,DEM,500007,3,8,66,77,
Murray,U.S. Senate,James Lankford,REP,500007,6,17,230,253,
Murray,U.S. Senate,Robert Murphy,LIB,500007,1,0,8,9,
Murray,U.S. Senate,Mike Workman,DEM,500007,4,9,61,74,
Murray,U.S. Senate,Mark Beard,IND,500007,0,1,4,5,
Murray,U.S. Senate,Sean Braddy,IND,500007,0,0,6,6,
Murray,U.S. House,Tom Cole,REP,500007,8,17,232,257,04
Murray,U.S. House,Sevier White,LIB,500007,0,2,17,19,04
Murray,U.S. House,Christina Owen,DEM,500007,3,9,60,72,04
Murray,President,Donald Trump,REP,500009,10,36,263,309,
Murray,President,Gary Johnson,LIB,500009,1,3,10,14,
Murray,President,Hillary Clinton,DEM,500009,5,13,57,75,
Murray,U.S. Senate,James Lankford,REP,500009,12,43,268,323,
Murray,U.S. Senate,Robert Murphy,LIB,500009,0,1,6,7,
Murray,U.S. Senate,Mike Workman,DEM,500009,4,8,47,59,
Murray,U.S. Senate,Mark Beard,IND,500009,0,1,6,7,
Murray,U.S. Senate,Sean Braddy,IND,500009,0,0,2,2,
Murray,U.S. House,Tom Cole,REP,500009,12,41,279,332,04
Murray,U.S. House,Sevier White,LIB,500009,0,2,6,8,04
Murray,U.S. House,Christina Owen,DEM,500009,4,10,42,56,04
Murray,President,Donald Trump,REP,500012,11,19,227,257,
Murray,President,Gary Johnson,LIB,500012,0,0,14,14,
Murray,President,Hillary Clinton,DEM,500012,4,6,35,45,
Murray,U.S. Senate,James Lankford,REP,500012,11,20,227,258,
Murray,U.S. Senate,Robert Murphy,LIB,500012,0,0,5,5,
Murray,U.S. Senate,Mike Workman,DEM,500012,4,5,34,43,
Murray,U.S. Senate,Mark Beard,IND,500012,0,0,9,9,
Murray,U.S. Senate,Sean Braddy,IND,500012,0,0,1,1,
Murray,U.S. House,Tom Cole,REP,500012,11,20,229,260,04
Murray,U.S. House,Sevier White,LIB,500012,0,0,6,6,04
Murray,U.S. House,Christina Owen,DEM,500012,4,5,40,49,04
Murray,President,Donald Trump,REP,500014,5,9,124,138,
Murray,President,Gary Johnson,LIB,500014,0,2,10,12,
Murray,President,Hillary Clinton,DEM,500014,3,1,31,35,
Murray,U.S. Senate,James Lankford,REP,500014,5,10,110,125,
Murray,U.S. Senate,Robert Murphy,LIB,500014,0,1,3,4,
Murray,U.S. Senate,Mike Workman,DEM,500014,3,1,44,48,
Murray,U.S. Senate,Mark Beard,IND,500014,0,0,2,2,
Murray,U.S. Senate,Sean Braddy,IND,500014,0,0,4,4,
Murray,U.S. House,Tom Cole,REP,500014,5,9,121,135,04
Murray,U.S. House,Sevier White,LIB,500014,0,1,6,7,04
Murray,U.S. House,Christina Owen,DEM,500014,3,2,36,41,04
Murray,President,Donald Trump,REP,500015,34,144,544,722,
Murray,President,Gary Johnson,LIB,500015,0,7,27,34,
Murray,President,Hillary Clinton,DEM,500015,14,53,143,210,
Murray,U.S. Senate,James Lankford,REP,500015,32,138,536,706,
Murray,U.S. Senate,Robert Murphy,LIB,500015,0,4,21,25,
Murray,U.S. Senate,Mike Workman,DEM,500015,14,48,131,193,
Murray,U.S. Senate,Mark Beard,IND,500015,1,8,14,23,
Murray,U.S. Senate,Sean Braddy,IND,500015,1,4,7,12,
Murray,U.S. House,Tom Cole,REP,500015,35,150,546,731,04
Murray,U.S. House,Sevier White,LIB,500015,0,9,21,30,04
Murray,U.S. House,Christina Owen,DEM,500015,12,46,143,201,04
Murray,President,Donald Trump,REP,500017,3,7,68,78,
Murray,President,Gary Johnson,LIB,500017,0,1,6,7,
Murray,President,Hillary Clinton,DEM,500017,0,1,13,14,
Murray,U.S. Senate,James Lankford,REP,500017,3,8,72,83,
Murray,U.S. Senate,Robert Murphy,LIB,500017,0,0,1,1,
Murray,U.S. Senate,Mike Workman,DEM,500017,0,1,11,12,
Murray,U.S. Senate,Mark Beard,IND,500017,0,0,2,2,
Murray,U.S. Senate,Sean Braddy,IND,500017,0,0,1,1,
Murray,U.S. House,Tom Cole,REP,500017,3,8,75,86,04
Murray,U.S. House,Sevier White,LIB,500017,0,0,2,2,04
Murray,U.S. House,Christina Owen,DEM,500017,0,1,10,11,04
Murray,President,Donald Trump,REP,500018,7,52,302,361,
Murray,President,Gary Johnson,LIB,500018,0,3,24,27,
Murray,President,Hillary Clinton,DEM,500018,3,21,69,93,
Murray,U.S. Senate,James Lankford,REP,500018,8,52,296,356,
Murray,U.S. Senate,Robert Murphy,LIB,500018,0,0,13,13,
Murray,U.S. Senate,Mike Workman,DEM,500018,2,19,62,83,
Murray,U.S. Senate,Mark Beard,IND,500018,0,0,8,8,
Murray,U.S. Senate,Sean Braddy,IND,500018,0,2,9,11,
Murray,U.S. House,Tom Cole,REP,500018,8,56,316,380,04
Murray,U.S. House,Sevier White,LIB,500018,0,0,15,15,04
Murray,U.S. House,Christina Owen,DEM,500018,2,20,57,79,04
Murray,President,Donald Trump,REP,500020,30,104,516,650,
Murray,President,Gary Johnson,LIB,500020,3,11,47,61,
Murray,President,Hillary Clinton,DEM,500020,14,29,141,184,
Murray,U.S. Senate,James Lankford,REP,500020,33,107,523,663,
Murray,U.S. Senate,Robert Murphy,LIB,500020,1,4,21,26,
Murray,U.S. Senate,Mike Workman,DEM,500020,12,26,129,167,
Murray,U.S. Senate,Mark Beard,IND,500020,0,3,11,14,
Murray,U.S. Senate,Sean Braddy,IND,500020,1,2,16,19,
Murray,U.S. House,Tom Cole,REP,500020,35,116,528,679,04
Murray,U.S. House,Sevier White,LIB,500020,2,2,27,31,04
Murray,U.S. House,Christina Owen,DEM,500020,10,25,143,178,04
Muskogee,President,Donald Trump,REP,510005,16,77,652,745,
Muskogee,President,Gary Johnson,LIB,510005,4,17,98,119,
Muskogee,President,Hillary Clinton,DEM,510005,13,73,436,522,
Muskogee,U.S. Senate,James Lankford,REP,510005,17,91,651,759,
Muskogee,U.S. Senate,Robert Murphy,LIB,510005,1,8,42,51,
Muskogee,U.S. Senate,Mike Workman,DEM,510005,12,57,395,464,
Muskogee,U.S. Senate,Mark Beard,IND,510005,2,2,36,40,
Muskogee,U.S. Senate,Sean Braddy,IND,510005,1,7,52,60,
Muskogee,U.S. House,Markwayne Mullin,REP,510005,16,86,694,796,02
Muskogee,U.S. House,Joshua Harris-Till,DEM,510005,12,71,380,463,02
Muskogee,U.S. House,John Mccarthy,IND,510005,4,9,108,121,02
Muskogee,State Senate,Dewayne Pemberton,REP,510005,16,75,604,695,9
Muskogee,State Senate,Jack Reavis,DEM,510005,16,91,574,681,9
Muskogee,State House,George Faught,REP,510005,19,91,659,769,14
Muskogee,State House,Lee Ann Langston,DEM,510005,14,73,512,599,14
Muskogee,President,Donald Trump,REP,510007,39,131,797,967,
Muskogee,President,Gary Johnson,LIB,510007,3,6,77,86,
Muskogee,President,Hillary Clinton,DEM,510007,35,71,399,505,
Muskogee,U.S. Senate,James Lankford,REP,510007,46,135,829,1010,
Muskogee,U.S. Senate,Robert Murphy,LIB,510007,2,3,29,34,
Muskogee,U.S. Senate,Mike Workman,DEM,510007,25,60,365,450,
Muskogee,U.S. Senate,Mark Beard,IND,510007,0,2,24,26,
Muskogee,U.S. Senate,Sean Braddy,IND,510007,2,3,15,20,
Muskogee,U.S. House,Markwayne Mullin,REP,510007,41,133,825,999,02
Muskogee,U.S. House,Joshua Harris-Till,DEM,510007,30,61,368,459,02
Muskogee,U.S. House,John Mccarthy,IND,510007,4,9,70,83,02
Muskogee,State Senate,Dewayne Pemberton,REP,510007,42,120,695,857,9
Muskogee,State Senate,Jack Reavis,DEM,510007,32,82,568,682,9
Muskogee,State House,George Faught,REP,510007,40,135,791,966,14
Muskogee,State House,Lee Ann Langston,DEM,510007,35,68,470,573,14
Muskogee,President,Donald Trump,REP,510009,37,186,895,1118,
Muskogee,President,Gary Johnson,LIB,510009,1,6,75,82,
Muskogee,President,Hillary Clinton,DEM,510009,25,73,400,498,
Muskogee,U.S. Senate,James Lankford,REP,510009,35,188,945,1168,
Muskogee,U.S. Senate,Robert Murphy,LIB,510009,1,4,28,33,
Muskogee,U.S. Senate,Mike Workman,DEM,510009,25,64,353,442,
Muskogee,U.S. Senate,Mark Beard,IND,510009,2,4,19,25,
Muskogee,U.S. Senate,Sean Braddy,IND,510009,1,3,20,24,
Muskogee,U.S. House,Markwayne Mullin,REP,510009,39,178,941,1158,02
Muskogee,U.S. House,Joshua Harris-Till,DEM,510009,23,74,366,463,02
Muskogee,U.S. House,John Mccarthy,IND,510009,1,9,56,66,02
Muskogee,State Senate,Dewayne Pemberton,REP,510009,34,169,788,991,9
Muskogee,State Senate,Jack Reavis,DEM,510009,29,95,580,704,9
Muskogee,State House,George Faught,REP,510009,37,176,908,1121,14
Muskogee,State House,Lee Ann Langston,DEM,510009,25,84,452,561,14
Muskogee,President,Donald Trump,REP,510011,9,34,316,359,
Muskogee,President,Gary Johnson,LIB,510011,0,0,33,33,
Muskogee,President,Hillary Clinton,DEM,510011,5,30,194,229,
Muskogee,U.S. Senate,James Lankford,REP,510011,10,37,308,355,
Muskogee,U.S. Senate,Robert Murphy,LIB,510011,0,1,15,16,
Muskogee,U.S. Senate,Mike Workman,DEM,510011,4,23,171,198,
Muskogee,U.S. Senate,Mark Beard,IND,510011,0,0,18,18,
Muskogee,U.S. Senate,Sean Braddy,IND,510011,0,3,26,29,
Muskogee,U.S. House,Markwayne Mullin,REP,510011,10,32,328,370,02
Muskogee,U.S. House,Joshua Harris-Till,DEM,510011,4,26,166,196,02
Muskogee,U.S. House,John Mccarthy,IND,510011,0,6,47,53,02
Muskogee,State Senate,Dewayne Pemberton,REP,510011,8,28,281,317,9
Muskogee,State Senate,Jack Reavis,DEM,510011,6,36,259,301,9
Muskogee,State House,George Faught,REP,510011,10,34,325,369,14
Muskogee,State House,Lee Ann Langston,DEM,510011,4,30,215,249,14
Muskogee,President,Donald Trump,REP,510013,22,56,447,525,
Muskogee,President,Gary Johnson,LIB,510013,1,5,52,58,
Muskogee,President,Hillary Clinton,DEM,510013,11,26,245,282,
Muskogee,U.S. Senate,James Lankford,REP,510013,21,60,453,534,
Muskogee,U.S. Senate,Robert Murphy,LIB,510013,0,2,13,15,
Muskogee,U.S. Senate,Mike Workman,DEM,510013,13,26,241,280,
Muskogee,U.S. Senate,Mark Beard,IND,510013,0,0,15,15,
Muskogee,U.S. Senate,Sean Braddy,IND,510013,0,2,19,21,
Muskogee,U.S. House,Markwayne Mullin,REP,510013,22,62,473,557,02
Muskogee,U.S. House,Joshua Harris-Till,DEM,510013,12,24,235,271,02
Muskogee,U.S. House,John Mccarthy,IND,510013,0,2,36,38,02
Muskogee,State Senate,Dewayne Pemberton,REP,510013,18,51,402,471,9
Muskogee,State Senate,Jack Reavis,DEM,510013,15,39,340,394,9
Muskogee,State House,George Faught,REP,510013,17,62,447,526,14
Muskogee,State House,Lee Ann Langston,DEM,510013,17,27,296,340,14
Muskogee,President,Donald Trump,REP,510017,3,14,77,94,
Muskogee,President,Gary Johnson,LIB,510017,1,1,14,16,
Muskogee,President,Hillary Clinton,DEM,510017,8,28,241,277,
Muskogee,U.S. Senate,James Lankford,REP,510017,3,15,75,93,
Muskogee,U.S. Senate,Robert Murphy,LIB,510017,1,1,9,11,
Muskogee,U.S. Senate,Mike Workman,DEM,510017,8,27,221,256,
Muskogee,U.S. Senate,Mark Beard,IND,510017,0,0,8,8,
Muskogee,U.S. Senate,Sean Braddy,IND,510017,0,0,11,11,
Muskogee,U.S. House,Markwayne Mullin,REP,510017,3,18,74,95,02
Muskogee,U.S. House,Joshua Harris-Till,DEM,510017,9,23,226,258,02
Muskogee,U.S. House,John Mccarthy,IND,510017,0,2,27,29,02
Muskogee,State Senate,Dewayne Pemberton,REP,510017,4,14,70,88,9
Muskogee,State Senate,Jack Reavis,DEM,510017,8,29,259,296,9
Muskogee,State House,Avery Carl Frix,REP,510017,2,18,113,133,13
Muskogee,State House,Wayne Herriman,DEM,510017,10,25,214,249,13
Muskogee,President,Donald Trump,REP,510021,11,31,217,259,
Muskogee,President,Gary Johnson,LIB,510021,2,0,44,46,
Muskogee,President,Hillary Clinton,DEM,510021,18,50,432,500,
Muskogee,U.S. Senate,James Lankford,REP,510021,12,34,254,300,
Muskogee,U.S. Senate,Robert Murphy,LIB,510021,3,0,20,23,
Muskogee,U.S. Senate,Mike Workman,DEM,510021,17,45,375,437,
Muskogee,U.S. Senate,Mark Beard,IND,510021,0,0,16,16,
Muskogee,U.S. Senate,Sean Braddy,IND,510021,0,1,26,27,
Muskogee,U.S. House,Markwayne Mullin,REP,510021,10,35,257,302,02
Muskogee,U.S. House,Joshua Harris-Till,DEM,510021,17,42,388,447,02
Muskogee,U.S. House,John Mccarthy,IND,510021,3,3,46,52,02
Muskogee,State Senate,Dewayne Pemberton,REP,510021,11,32,223,266,9
Muskogee,State Senate,Jack Reavis,DEM,510021,20,47,466,533,9
Muskogee,State House,Avery Carl Frix,REP,510021,14,44,295,353,13
Muskogee,State House,Wayne Herriman,DEM,510021,17,36,394,447,13
Muskogee,President,Donald Trump,REP,510022,23,69,477,569,
Muskogee,President,Gary Johnson,LIB,510022,2,4,48,54,
Muskogee,President,Hillary Clinton,DEM,510022,21,53,348,422,
Muskogee,U.S. Senate,James Lankford,REP,510022,28,71,491,590,
Muskogee,U.S. Senate,Robert Murphy,LIB,510022,0,3,24,27,
Muskogee,U.S. Senate,Mike Workman,DEM,510022,12,45,306,363,
Muskogee,U.S. Senate,Mark Beard,IND,510022,3,1,24,28,
Muskogee,U.S. Senate,Sean Braddy,IND,510022,1,5,20,26,
Muskogee,U.S. House,Markwayne Mullin,REP,510022,25,72,507,604,02
Muskogee,U.S. House,Joshua Harris-Till,DEM,510022,12,46,302,360,02
Muskogee,U.S. House,John Mccarthy,IND,510022,6,7,52,65,02
Muskogee,State Senate,Dewayne Pemberton,REP,510022,27,62,443,532,9
Muskogee,State Senate,Jack Reavis,DEM,510022,16,62,421,499,9
Muskogee,State House,Avery Carl Frix,REP,510022,28,74,531,633,13
Muskogee,State House,Wayne Herriman,DEM,510022,16,50,332,398,13
Muskogee,President,Donald Trump,REP,510023,11,30,149,190,
Muskogee,President,Gary Johnson,LIB,510023,0,2,27,29,
Muskogee,President,Hillary Clinton,DEM,510023,28,97,535,660,
Muskogee,U.S. Senate,James Lankford,REP,510023,11,31,171,213,
Muskogee,U.S. Senate,Robert Murphy,LIB,510023,0,0,21,21,
Muskogee,U.S. Senate,Mike Workman,DEM,510023,27,95,485,607,
Muskogee,U.S. Senate,Mark Beard,IND,510023,0,0,14,14,
Muskogee,U.S. Senate,Sean Braddy,IND,510023,1,1,15,17,
Muskogee,U.S. House,Markwayne Mullin,REP,510023,12,32,176,220,02
Muskogee,U.S. House,Joshua Harris-Till,DEM,510023,25,93,479,597,02
Muskogee,U.S. House,John Mccarthy,IND,510023,2,1,51,54,02
Muskogee,State Senate,Dewayne Pemberton,REP,510023,9,28,169,206,9
Muskogee,State Senate,Jack Reavis,DEM,510023,30,98,539,667,9
Muskogee,State House,Avery Carl Frix,REP,510023,12,37,245,294,13
Muskogee,State House,Wayne Herriman,DEM,510023,27,89,459,575,13
Muskogee,President,Donald Trump,REP,510028,3,16,185,204,
Muskogee,President,Gary Johnson,LIB,510028,1,2,24,27,
Muskogee,President,Hillary Clinton,DEM,510028,13,26,215,254,
Muskogee,U.S. Senate,James Lankford,REP,510028,6,18,200,224,
Muskogee,U.S. Senate,Robert Murphy,LIB,510028,0,1,14,15,
Muskogee,U.S. Senate,Mike Workman,DEM,510028,13,23,197,233,
Muskogee,U.S. Senate,Mark Beard,IND,510028,0,0,8,8,
Muskogee,U.S. Senate,Sean Braddy,IND,510028,0,2,5,7,
Muskogee,U.S. House,Markwayne Mullin,REP,510028,8,15,200,223,02
Muskogee,U.S. House,Joshua Harris-Till,DEM,510028,11,26,199,236,02
Muskogee,U.S. House,John Mccarthy,IND,510028,0,3,23,26,02
Muskogee,State Senate,Dewayne Pemberton,REP,510028,4,21,173,198,9
Muskogee,State Senate,Jack Reavis,DEM,510028,15,23,249,287,9
Muskogee,State House,Avery Carl Frix,REP,510028,6,23,213,242,13
Muskogee,State House,Wayne Herriman,DEM,510028,13,21,212,246,13
Muskogee,President,Donald Trump,REP,510033,44,27,772,843,
Muskogee,President,Gary Johnson,LIB,510033,3,2,33,38,
Muskogee,President,Hillary Clinton,DEM,510033,10,15,241,266,
Muskogee,U.S. Senate,James Lankford,REP,510033,47,28,724,799,
Muskogee,U.S. Senate,Robert Murphy,LIB,510033,0,1,15,16,
Muskogee,U.S. Senate,Mike Workman,DEM,510033,9,14,252,275,
Muskogee,U.S. Senate,Mark Beard,IND,510033,0,0,19,19,
Muskogee,U.S. Senate,Sean Braddy,IND,510033,0,0,24,24,
Muskogee,U.S. House,Markwayne Mullin,REP,510033,46,29,720,795,02
Muskogee,U.S. House,Joshua Harris-Till,DEM,510033,7,14,244,265,02
Muskogee,U.S. House,John Mccarthy,IND,510033,2,0,69,71,02
Muskogee,State House,Scott Fetgatter,REP,510033,32,20,543,595,16
Muskogee,State House,Ronnie Kell,DEM,510033,23,23,490,536,16
Muskogee,President,Donald Trump,REP,510036,3,1,44,48,
Muskogee,President,Gary Johnson,LIB,510036,0,0,3,3,
Muskogee,President,Hillary Clinton,DEM,510036,0,5,122,127,
Muskogee,U.S. Senate,James Lankford,REP,510036,3,1,46,50,
Muskogee,U.S. Senate,Robert Murphy,LIB,510036,0,0,3,3,
Muskogee,U.S. Senate,Mike Workman,DEM,510036,0,5,110,115,
Muskogee,U.S. Senate,Mark Beard,IND,510036,0,0,3,3,
Muskogee,U.S. Senate,Sean Braddy,IND,510036,0,0,7,7,
Muskogee,U.S. House,Markwayne Mullin,REP,510036,3,1,42,46,02
Muskogee,U.S. House,Joshua Harris-Till,DEM,510036,0,5,117,122,02
Muskogee,U.S. House,John Mccarthy,IND,510036,0,0,10,10,02
Muskogee,State Senate,Dewayne Pemberton,REP,510036,3,1,46,50,9
Muskogee,State Senate,Jack Reavis,DEM,510036,0,5,123,128,9
Muskogee,State House,Avery Carl Frix,REP,510036,3,1,65,69,13
Muskogee,State House,Wayne Herriman,DEM,510036,0,5,103,108,13
Muskogee,President,Donald Trump,REP,510037,9,48,421,478,
Muskogee,President,Gary Johnson,LIB,510037,0,0,33,33,
Muskogee,President,Hillary Clinton,DEM,510037,11,21,188,220,
Muskogee,U.S. Senate,James Lankford,REP,510037,9,49,440,498,
Muskogee,U.S. Senate,Robert Murphy,LIB,510037,2,0,14,16,
Muskogee,U.S. Senate,Mike Workman,DEM,510037,9,19,163,191,
Muskogee,U.S. Senate,Mark Beard,IND,510037,0,0,10,10,
Muskogee,U.S. Senate,Sean Braddy,IND,510037,0,0,13,13,
Muskogee,U.S. House,Markwayne Mullin,REP,510037,10,51,446,507,02
Muskogee,U.S. House,Joshua Harris-Till,DEM,510037,9,17,160,186,02
Muskogee,U.S. House,John Mccarthy,IND,510037,1,0,33,34,02
Muskogee,State Senate,Dewayne Pemberton,REP,510037,8,37,373,418,9
Muskogee,State Senate,Jack Reavis,DEM,510037,12,30,262,304,9
Muskogee,State House,Avery Carl Frix,REP,510037,11,41,401,453,13
Muskogee,State House,Wayne Herriman,DEM,510037,9,26,231,266,13
Muskogee,President,Donald Trump,REP,510038,34,74,546,654,
Muskogee,President,Gary Johnson,LIB,510038,3,5,58,66,
Muskogee,President,Hillary Clinton,DEM,510038,23,58,315,396,
Muskogee,U.S. Senate,James Lankford,REP,510038,43,75,609,727,
Muskogee,U.S. Senate,Robert Murphy,LIB,510038,0,5,15,20,
Muskogee,U.S. Senate,Mike Workman,DEM,510038,18,54,268,340,
Muskogee,U.S. Senate,Mark Beard,IND,510038,1,2,20,23,
Muskogee,U.S. Senate,Sean Braddy,IND,510038,0,2,14,16,
Muskogee,U.S. House,Markwayne Mullin,REP,510038,42,76,587,705,02
Muskogee,U.S. House,Joshua Harris-Till,DEM,510038,15,56,295,366,02
Muskogee,U.S. House,John Mccarthy,IND,510038,5,7,41,53,02
Muskogee,State Senate,Dewayne Pemberton,REP,510038,38,64,503,605,9
Muskogee,State Senate,Jack Reavis,DEM,510038,24,74,417,515,9
Muskogee,State House,George Faught,REP,510038,41,77,563,681,14
Muskogee,State House,Lee Ann Langston,DEM,510038,21,60,356,437,14
Muskogee,President,Donald Trump,REP,510040,11,21,210,242,
Muskogee,President,Gary Johnson,LIB,510040,0,2,13,15,
Muskogee,President,Hillary Clinton,DEM,510040,12,9,44,65,
Muskogee,U.S. Senate,James Lankford,REP,510040,16,21,213,250,
Muskogee,U.S. Senate,Robert Murphy,LIB,510040,0,0,8,8,
Muskogee,U.S. Senate,Mike Workman,DEM,510040,7,11,40,58,
Muskogee,U.S. Senate,Mark Beard,IND,510040,0,0,2,2,
Muskogee,U.S. Senate,Sean Braddy,IND,510040,0,0,3,3,
Muskogee,U.S. House,Markwayne Mullin,REP,510040,18,22,207,247,02
Muskogee,U.S. House,Joshua Harris-Till,DEM,510040,5,10,45,60,02
Muskogee,U.S. House,John Mccarthy,IND,510040,0,0,14,14,02
Muskogee,State Senate,Dewayne Pemberton,REP,510040,14,18,188,220,9
Muskogee,State Senate,Jack Reavis,DEM,510040,8,14,77,99,9
Muskogee,State House,George Faught,REP,510040,16,21,185,222,14
Muskogee,State House,Lee Ann Langston,DEM,510040,6,11,79,96,14
Muskogee,President,Donald Trump,REP,510041,60,146,1168,1374,
Muskogee,President,Gary Johnson,LIB,510041,4,8,79,91,
Muskogee,President,Hillary Clinton,DEM,510041,30,58,404,492,
Muskogee,U.S. Senate,James Lankford,REP,510041,61,145,1172,1378,
Muskogee,U.S. Senate,Robert Murphy,LIB,510041,2,5,46,53,
Muskogee,U.S. Senate,Mike Workman,DEM,510041,27,50,372,449,
Muskogee,U.S. Senate,Mark Beard,IND,510041,2,3,26,31,
Muskogee,U.S. Senate,Sean Braddy,IND,510041,2,8,33,43,
Muskogee,U.S. House,Markwayne Mullin,REP,510041,61,138,1195,1394,02
Muskogee,U.S. House,Joshua Harris-Till,DEM,510041,28,64,370,462,02
Muskogee,U.S. House,John Mccarthy,IND,510041,4,10,76,90,02
Muskogee,State House,George Faught,REP,510041,52,145,1148,1345,14
Muskogee,State House,Lee Ann Langston,DEM,510041,41,66,496,603,14
Muskogee,President,Donald Trump,REP,510044,6,9,349,364,
Muskogee,President,Gary Johnson,LIB,510044,0,1,16,17,
Muskogee,President,Hillary Clinton,DEM,510044,0,2,87,89,
Muskogee,U.S. Senate,James Lankford,REP,510044,6,8,321,335,
Muskogee,U.S. Senate,Robert Murphy,LIB,510044,0,0,7,7,
Muskogee,U.S. Senate,Mike Workman,DEM,510044,0,3,103,106,
Muskogee,U.S. Senate,Mark Beard,IND,510044,0,0,9,9,
Muskogee,U.S. Senate,Sean Braddy,IND,510044,0,0,5,5,
Muskogee,U.S. House,Markwayne Mullin,REP,510044,5,10,331,346,02
Muskogee,U.S. House,Joshua Harris-Till,DEM,510044,0,1,93,94,02
Muskogee,U.S. House,John Mccarthy,IND,510044,1,0,23,24,02
Muskogee,State Senate,Dewayne Pemberton,REP,510044,5,9,263,277,9
Muskogee,State Senate,Jack Reavis,DEM,510044,1,3,185,189,9
Muskogee,State House,George Faught,REP,510044,5,9,320,334,14
Muskogee,State House,Lee Ann Langston,DEM,510044,1,3,125,129,14
Muskogee,President,Donald Trump,REP,510045,10,21,366,397,
Muskogee,President,Gary Johnson,LIB,510045,0,3,23,26,
Muskogee,President,Hillary Clinton,DEM,510045,3,8,135,146,
Muskogee,U.S. Senate,James Lankford,REP,510045,9,25,369,403,
Muskogee,U.S. Senate,Robert Murphy,LIB,510045,0,0,11,11,
Muskogee,U.S. Senate,Mike Workman,DEM,510045,3,6,135,144,
Muskogee,U.S. Senate,Mark Beard,IND,510045,0,0,7,7,
Muskogee,U.S. Senate,Sean Braddy,IND,510045,0,0,3,3,
Muskogee,U.S. House,Markwayne Mullin,REP,510045,9,24,368,401,02
Muskogee,U.S. House,Joshua Harris-Till,DEM,510045,3,6,130,139,02
Muskogee,U.S. House,John Mccarthy,IND,510045,0,1,25,26,02
Muskogee,State Senate,Dewayne Pemberton,REP,510045,8,19,325,352,9
Muskogee,State Senate,Jack Reavis,DEM,510045,4,12,198,214,9
Muskogee,State House,George Faught,REP,510045,9,20,351,380,14
Muskogee,State House,Lee Ann Langston,DEM,510045,3,9,170,182,14
Muskogee,President,Donald Trump,REP,510046,15,86,664,765,
Muskogee,President,Gary Johnson,LIB,510046,2,3,51,56,
Muskogee,President,Hillary Clinton,DEM,510046,10,18,238,266,
Muskogee,U.S. Senate,James Lankford,REP,510046,16,88,675,779,
Muskogee,U.S. Senate,Robert Murphy,LIB,510046,0,0,20,20,
Muskogee,U.S. Senate,Mike Workman,DEM,510046,9,20,219,248,
Muskogee,U.S. Senate,Mark Beard,IND,510046,0,0,12,12,
Muskogee,U.S. Senate,Sean Braddy,IND,510046,2,0,20,22,
Muskogee,U.S. House,Markwayne Mullin,REP,510046,17,86,681,784,02
Muskogee,U.S. House,Joshua Harris-Till,DEM,510046,9,20,222,251,02
Muskogee,U.S. House,John Mccarthy,IND,510046,1,2,42,45,02
Muskogee,State Senate,Dewayne Pemberton,REP,510046,18,80,679,777,9
Muskogee,State Senate,Jack Reavis,DEM,510046,9,28,267,304,9
Muskogee,State House,Avery Carl Frix,REP,510046,16,65,613,694,13
Muskogee,State House,Wayne Herriman,DEM,510046,10,41,332,383,13
Muskogee,President,Donald Trump,REP,510047,13,24,369,406,
Muskogee,President,Gary Johnson,LIB,510047,1,1,30,32,
Muskogee,President,Hillary Clinton,DEM,510047,12,26,235,273,
Muskogee,U.S. Senate,James Lankford,REP,510047,12,24,381,417,
Muskogee,U.S. Senate,Robert Murphy,LIB,510047,1,0,16,17,
Muskogee,U.S. Senate,Mike Workman,DEM,510047,13,25,215,253,
Muskogee,U.S. Senate,Mark Beard,IND,510047,0,1,8,9,
Muskogee,U.S. Senate,Sean Braddy,IND,510047,0,1,12,13,
Muskogee,U.S. House,Markwayne Mullin,REP,510047,11,27,380,418,02
Muskogee,U.S. House,Joshua Harris-Till,DEM,510047,13,24,225,262,02
Muskogee,U.S. House,John Mccarthy,IND,510047,2,1,27,30,02
Muskogee,State Senate,Dewayne Pemberton,REP,510047,16,25,372,413,9
Muskogee,State Senate,Jack Reavis,DEM,510047,11,27,262,300,9
Muskogee,State House,Avery Carl Frix,REP,510047,13,27,371,411,13
Muskogee,State House,Wayne Herriman,DEM,510047,14,24,264,302,13
Muskogee,President,Donald Trump,REP,510049,7,24,162,193,
Muskogee,President,Gary Johnson,LIB,510049,0,3,18,21,
Muskogee,President,Hillary Clinton,DEM,510049,0,10,68,78,
Muskogee,U.S. Senate,James Lankford,REP,510049,6,27,171,204,
Muskogee,U.S. Senate,Robert Murphy,LIB,510049,1,0,8,9,
Muskogee,U.S. Senate,Mike Workman,DEM,510049,0,10,57,67,
Muskogee,U.S. Senate,Mark Beard,IND,510049,0,0,5,5,
Muskogee,U.S. Senate,Sean Braddy,IND,510049,0,0,7,7,
Muskogee,U.S. House,Markwayne Mullin,REP,510049,7,24,173,204,02
Muskogee,U.S. House,Joshua Harris-Till,DEM,510049,0,12,57,69,02
Muskogee,U.S. House,John Mccarthy,IND,510049,0,1,16,17,02
Muskogee,State Senate,Dewayne Pemberton,REP,510049,5,24,141,170,9
Muskogee,State Senate,Jack Reavis,DEM,510049,2,13,107,122,9
Muskogee,State House,George Faught,REP,510049,7,22,157,186,14
Muskogee,State House,Lee Ann Langston,DEM,510049,0,15,88,103,14
Muskogee,President,Donald Trump,REP,510050,8,1,113,122,
Muskogee,President,Gary Johnson,LIB,510050,0,0,10,10,
Muskogee,President,Hillary Clinton,DEM,510050,2,0,101,103,
Muskogee,U.S. Senate,James Lankford,REP,510050,8,1,117,126,
Muskogee,U.S. Senate,Robert Murphy,LIB,510050,0,0,6,6,
Muskogee,U.S. Senate,Mike Workman,DEM,510050,2,0,95,97,
Muskogee,U.S. Senate,Mark Beard,IND,510050,0,0,3,3,
Muskogee,U.S. Senate,Sean Braddy,IND,510050,0,0,3,3,
Muskogee,U.S. House,Markwayne Mullin,REP,510050,8,1,113,122,02
Muskogee,U.S. House,Joshua Harris-Till,DEM,510050,2,0,103,105,02
Muskogee,U.S. House,John Mccarthy,IND,510050,0,0,7,7,02
Muskogee,State House,Scott Fetgatter,REP,510050,6,0,59,65,16
Muskogee,State House,Ronnie Kell,DEM,510050,4,1,163,168,16
Muskogee,President,Donald Trump,REP,510051,0,0,87,87,
Muskogee,President,Gary Johnson,LIB,510051,0,1,5,6,
Muskogee,President,Hillary Clinton,DEM,510051,1,0,29,30,
Muskogee,U.S. Senate,James Lankford,REP,510051,0,1,84,85,
Muskogee,U.S. Senate,Robert Murphy,LIB,510051,0,0,0,0,
Muskogee,U.S. Senate,Mike Workman,DEM,510051,1,0,35,36,
Muskogee,U.S. Senate,Mark Beard,IND,510051,0,0,2,2,
Muskogee,U.S. Senate,Sean Braddy,IND,510051,0,0,0,0,
Muskogee,U.S. House,Markwayne Mullin,REP,510051,1,1,88,90,02
Muskogee,U.S. House,Joshua Harris-Till,DEM,510051,0,0,31,31,02
Muskogee,U.S. House,John Mccarthy,IND,510051,0,0,1,1,02
Muskogee,State House,Scott Fetgatter,REP,510051,0,0,48,48,16
Muskogee,State House,Ronnie Kell,DEM,510051,1,1,70,72,16
Muskogee,President,Donald Trump,REP,510052,8,19,168,195,
Muskogee,President,Gary Johnson,LIB,510052,0,0,12,12,
Muskogee,President,Hillary Clinton,DEM,510052,2,5,58,65,
Muskogee,U.S. Senate,James Lankford,REP,510052,5,18,154,177,
Muskogee,U.S. Senate,Robert Murphy,LIB,510052,0,0,2,2,
Muskogee,U.S. Senate,Mike Workman,DEM,510052,5,5,68,78,
Muskogee,U.S. Senate,Mark Beard,IND,510052,0,0,8,8,
Muskogee,U.S. Senate,Sean Braddy,IND,510052,0,1,3,4,
Muskogee,U.S. House,Markwayne Mullin,REP,510052,7,18,164,189,02
Muskogee,U.S. House,Joshua Harris-Till,DEM,510052,3,6,59,68,02
Muskogee,U.S. House,John Mccarthy,IND,510052,0,0,11,11,02
Muskogee,State House,Avery Carl Frix,REP,510052,5,17,133,155,13
Muskogee,State House,Wayne Herriman,DEM,510052,5,7,102,114,13
Muskogee,President,Donald Trump,REP,510053,11,26,395,432,
Muskogee,President,Gary Johnson,LIB,510053,0,0,18,18,
Muskogee,President,Hillary Clinton,DEM,510053,2,3,118,123,
Muskogee,U.S. Senate,James Lankford,REP,510053,11,25,375,411,
Muskogee,U.S. Senate,Robert Murphy,LIB,510053,0,1,9,10,
Muskogee,U.S. Senate,Mike Workman,DEM,510053,2,3,125,130,
Muskogee,U.S. Senate,Mark Beard,IND,510053,0,0,13,13,
Muskogee,U.S. Senate,Sean Braddy,IND,510053,0,0,5,5,
Muskogee,U.S. House,Markwayne Mullin,REP,510053,11,25,385,421,02
Muskogee,U.S. House,Joshua Harris-Till,DEM,510053,2,3,114,119,02
Muskogee,U.S. House,John Mccarthy,IND,510053,0,1,28,29,02
Muskogee,State Senate,Dewayne Pemberton,REP,510053,11,27,347,385,9
Muskogee,State Senate,Jack Reavis,DEM,510053,2,2,180,184,9
Muskogee,State House,Avery Carl Frix,REP,510053,11,24,328,363,13
Muskogee,State House,Wayne Herriman,DEM,510053,2,5,200,207,13
Muskogee,President,Donald Trump,REP,510055,38,171,1139,1348,
Muskogee,President,Gary Johnson,LIB,510055,2,8,77,87,
Muskogee,President,Hillary Clinton,DEM,510055,20,56,352,428,
Muskogee,U.S. Senate,James Lankford,REP,510055,35,175,1148,1358,
Muskogee,U.S. Senate,Robert Murphy,LIB,510055,2,2,29,33,
Muskogee,U.S. Senate,Mike Workman,DEM,510055,20,51,347,418,
Muskogee,U.S. Senate,Mark Beard,IND,510055,2,3,16,21,
Muskogee,U.S. Senate,Sean Braddy,IND,510055,1,4,22,27,
Muskogee,U.S. House,Markwayne Mullin,REP,510055,37,165,1145,1347,02
Muskogee,U.S. House,Joshua Harris-Till,DEM,510055,21,59,350,430,02
Muskogee,U.S. House,John Mccarthy,IND,510055,2,12,65,79,02
Muskogee,State Senate,Dewayne Pemberton,REP,510055,32,160,1090,1282,9
Muskogee,State Senate,Jack Reavis,DEM,510055,28,75,476,579,9
Muskogee,State House,Avery Carl Frix,REP,510055,39,136,937,1112,13
Muskogee,State House,Wayne Herriman,DEM,510055,19,100,628,747,13
Muskogee,President,Donald Trump,REP,510056,2,2,114,118,
Muskogee,President,Gary Johnson,LIB,510056,0,0,5,5,
Muskogee,President,Hillary Clinton,DEM,510056,0,1,32,33,
Muskogee,U.S. Senate,James Lankford,REP,510056,2,2,109,113,
Muskogee,U.S. Senate,Robert Murphy,LIB,510056,0,0,2,2,
Muskogee,U.S. Senate,Mike Workman,DEM,510056,0,1,37,38,
Muskogee,U.S. Senate,Mark Beard,IND,510056,0,0,1,1,
Muskogee,U.S. Senate,Sean Braddy,IND,510056,0,0,1,1,
Muskogee,U.S. House,Markwayne Mullin,REP,510056,2,2,115,119,02
Muskogee,U.S. House,Joshua Harris-Till,DEM,510056,0,1,32,33,02
Muskogee,U.S. House,John Mccarthy,IND,510056,0,0,4,4,02
Muskogee,State Senate,Dewayne Pemberton,REP,510056,2,1,95,98,9
Muskogee,State Senate,Jack Reavis,DEM,510056,0,1,54,55,9
Muskogee,State House,Avery Carl Frix,REP,510056,2,0,78,80,13
Muskogee,State House,Wayne Herriman,DEM,510056,0,3,72,75,13
Muskogee,President,Donald Trump,REP,510057,0,3,20,23,
Muskogee,President,Gary Johnson,LIB,510057,0,4,3,7,
Muskogee,President,Hillary Clinton,DEM,510057,1,0,3,4,
Muskogee,U.S. Senate,James Lankford,REP,510057,0,4,20,24,
Muskogee,U.S. Senate,Robert Murphy,LIB,510057,0,3,0,3,
Muskogee,U.S. Senate,Mike Workman,DEM,510057,1,0,5,6,
Muskogee,U.S. Senate,Mark Beard,IND,510057,0,0,1,1,
Muskogee,U.S. Senate,Sean Braddy,IND,510057,0,0,0,0,
Muskogee,U.S. House,Markwayne Mullin,REP,510057,0,5,20,25,02
Muskogee,U.S. House,Joshua Harris-Till,DEM,510057,1,0,4,5,02
Muskogee,U.S. House,John Mccarthy,IND,510057,0,2,2,4,02
Muskogee,State Senate,Dewayne Pemberton,REP,510057,0,6,19,25,9
Muskogee,State Senate,Jack Reavis,DEM,510057,1,1,7,9,9
Muskogee,State House,George Faught,REP,510057,0,7,19,26,14
Muskogee,State House,Lee Ann Langston,DEM,510057,1,0,7,8,14
Muskogee,President,Donald Trump,REP,510058,11,12,339,362,
Muskogee,President,Gary Johnson,LIB,510058,1,0,22,23,
Muskogee,President,Hillary Clinton,DEM,510058,5,4,95,104,
Muskogee,U.S. Senate,James Lankford,REP,510058,14,14,305,333,
Muskogee,U.S. Senate,Robert Murphy,LIB,510058,0,0,6,6,
Muskogee,U.S. Senate,Mike Workman,DEM,510058,3,2,117,122,
Muskogee,U.S. Senate,Mark Beard,IND,510058,0,0,10,10,
Muskogee,U.S. Senate,Sean Braddy,IND,510058,0,0,12,12,
Muskogee,U.S. House,Markwayne Mullin,REP,510058,14,13,306,333,02
Muskogee,U.S. House,Joshua Harris-Till,DEM,510058,3,2,119,124,02
Muskogee,U.S. House,John Mccarthy,IND,510058,0,1,26,27,02
Muskogee,State House,George Faught,REP,510058,14,12,317,343,14
Muskogee,State House,Lee Ann Langston,DEM,510058,3,4,133,140,14
Muskogee,President,Donald Trump,REP,510059,17,24,523,564,
Muskogee,President,Gary Johnson,LIB,510059,1,0,32,33,
Muskogee,President,Hillary Clinton,DEM,510059,20,16,136,172,
Muskogee,U.S. Senate,James Lankford,REP,510059,19,25,487,531,
Muskogee,U.S. Senate,Robert Murphy,LIB,510059,0,0,15,15,
Muskogee,U.S. Senate,Mike Workman,DEM,510059,12,14,156,182,
Muskogee,U.S. Senate,Mark Beard,IND,510059,0,1,11,12,
Muskogee,U.S. Senate,Sean Braddy,IND,510059,0,0,15,15,
Muskogee,U.S. House,Markwayne Mullin,REP,510059,18,22,512,552,02
Muskogee,U.S. House,Joshua Harris-Till,DEM,510059,12,18,136,166,02
Muskogee,U.S. House,John Mccarthy,IND,510059,2,0,38,40,02
Muskogee,State House,Avery Carl Frix,REP,510059,15,20,326,361,13
Muskogee,State House,Wayne Herriman,DEM,510059,18,20,364,402,13
Muskogee,President,Donald Trump,REP,510060,5,8,138,151,
Muskogee,President,Gary Johnson,LIB,510060,0,0,5,5,
Muskogee,President,Hillary Clinton,DEM,510060,1,1,52,54,
Muskogee,U.S. Senate,James Lankford,REP,510060,3,7,125,135,
Muskogee,U.S. Senate,Robert Murphy,LIB,510060,1,0,4,5,
Muskogee,U.S. Senate,Mike Workman,DEM,510060,2,1,53,56,
Muskogee,U.S. Senate,Mark Beard,IND,510060,0,0,4,4,
Muskogee,U.S. Senate,Sean Braddy,IND,510060,0,0,7,7,
Muskogee,U.S. House,Markwayne Mullin,REP,510060,3,6,131,140,02
Muskogee,U.S. House,Joshua Harris-Till,DEM,510060,2,2,55,59,02
Muskogee,U.S. House,John Mccarthy,IND,510060,1,0,8,9,02
Muskogee,State House,Don Herrold,REP,510060,2,3,60,65,15
Muskogee,State House,Ed Cannaday,DEM,510060,4,5,134,143,15
Muskogee,President,Donald Trump,REP,510061,9,13,241,263,
Muskogee,President,Gary Johnson,LIB,510061,0,0,9,9,
Muskogee,President,Hillary Clinton,DEM,510061,2,8,119,129,
Muskogee,U.S. Senate,James Lankford,REP,510061,7,13,227,247,
Muskogee,U.S. Senate,Robert Murphy,LIB,510061,0,0,5,5,
Muskogee,U.S. Senate,Mike Workman,DEM,510061,3,7,122,132,
Muskogee,U.S. Senate,Mark Beard,IND,510061,1,0,7,8,
Muskogee,U.S. Senate,Sean Braddy,IND,510061,0,1,6,7,
Muskogee,U.S. House,Markwayne Mullin,REP,510061,9,13,245,267,02
Muskogee,U.S. House,Joshua Harris-Till,DEM,510061,2,8,104,114,02
Muskogee,U.S. House,John Mccarthy,IND,510061,0,1,20,21,02
Muskogee,State Senate,Dewayne Pemberton,REP,510061,5,13,221,239,9
Muskogee,State Senate,Jack Reavis,DEM,510061,6,9,146,161,9
Muskogee,State House,Avery Carl Frix,REP,510061,7,12,169,188,13
Muskogee,State House,Wayne Herriman,DEM,510061,4,10,200,214,13
Muskogee,President,Donald Trump,REP,510064,20,18,546,584,
Muskogee,President,Gary Johnson,LIB,510064,1,1,31,33,
Muskogee,President,Hillary Clinton,DEM,510064,7,3,155,165,
Muskogee,U.S. Senate,James Lankford,REP,510064,19,20,479,518,
Muskogee,U.S. Senate,Robert Murphy,LIB,510064,1,0,18,19,
Muskogee,U.S. Senate,Mike Workman,DEM,510064,7,2,192,201,
Muskogee,U.S. Senate,Mark Beard,IND,510064,1,0,17,18,
Muskogee,U.S. Senate,Sean Braddy,IND,510064,0,0,18,18,
Muskogee,U.S. House,Markwayne Mullin,REP,510064,20,19,503,542,02
Muskogee,U.S. House,Joshua Harris-Till,DEM,510064,5,4,182,191,02
Muskogee,U.S. House,John Mccarthy,IND,510064,3,0,39,42,02
Muskogee,State House,Don Herrold,REP,510064,16,4,202,222,15
Muskogee,State House,Ed Cannaday,DEM,510064,11,19,524,554,15
Noble,President,Donald Trump,REP,520101,19,144,406,569,
Noble,President,Gary Johnson,LIB,520101,1,10,23,34,
Noble,President,Hillary Clinton,DEM,520101,6,28,70,104,
Noble,U.S. Senate,James Lankford,REP,520101,22,142,420,584,
Noble,U.S. Senate,Robert Murphy,LIB,520101,0,1,12,13,
Noble,U.S. Senate,Mike Workman,DEM,520101,4,32,49,85,
Noble,U.S. Senate,Mark Beard,IND,520101,0,1,7,8,
Noble,U.S. Senate,Sean Braddy,IND,520101,0,4,4,8,
Noble,U.S. House,Frank Lucas,REP,520101,22,147,430,599,03
Noble,U.S. House,Frankie Robbins,DEM,520101,4,31,52,87,03
Noble,President,Donald Trump,REP,520102,4,22,122,148,
Noble,President,Gary Johnson,LIB,520102,0,0,7,7,
Noble,President,Hillary Clinton,DEM,520102,0,4,22,26,
Noble,U.S. Senate,James Lankford,REP,520102,4,24,123,151,
Noble,U.S. Senate,Robert Murphy,LIB,520102,0,0,3,3,
Noble,U.S. Senate,Mike Workman,DEM,520102,0,3,20,23,
Noble,U.S. Senate,Mark Beard,IND,520102,0,0,0,0,
Noble,U.S. Senate,Sean Braddy,IND,520102,0,0,1,1,
Noble,U.S. House,Frank Lucas,REP,520102,4,25,123,152,03
Noble,U.S. House,Frankie Robbins,DEM,520102,0,2,20,22,03
Noble,President,Donald Trump,REP,520103,5,7,146,158,
Noble,President,Gary Johnson,LIB,520103,0,0,10,10,
Noble,President,Hillary Clinton,DEM,520103,2,1,37,40,
Noble,U.S. Senate,James Lankford,REP,520103,6,6,148,160,
Noble,U.S. Senate,Robert Murphy,LIB,520103,0,0,4,4,
Noble,U.S. Senate,Mike Workman,DEM,520103,1,2,32,35,
Noble,U.S. Senate,Mark Beard,IND,520103,0,0,5,5,
Noble,U.S. Senate,Sean Braddy,IND,520103,1,0,1,2,
Noble,U.S. House,Frank Lucas,REP,520103,6,7,145,158,03
Noble,U.S. House,Frankie Robbins,DEM,520103,2,1,45,48,03
Noble,President,Donald Trump,REP,520104,6,7,177,190,
Noble,President,Gary Johnson,LIB,520104,1,0,20,21,
Noble,President,Hillary Clinton,DEM,520104,3,2,51,56,
Noble,U.S. Senate,James Lankford,REP,520104,10,8,173,191,
Noble,U.S. Senate,Robert Murphy,LIB,520104,0,0,8,8,
Noble,U.S. Senate,Mike Workman,DEM,520104,0,1,51,52,
Noble,U.S. Senate,Mark Beard,IND,520104,0,0,6,6,
Noble,U.S. Senate,Sean Braddy,IND,520104,1,0,7,8,
Noble,U.S. House,Frank Lucas,REP,520104,11,8,175,194,03
Noble,U.S. House,Frankie Robbins,DEM,520104,0,1,65,66,03
Noble,President,Donald Trump,REP,520105,2,10,101,113,
Noble,President,Gary Johnson,LIB,520105,0,1,8,9,
Noble,President,Hillary Clinton,DEM,520105,4,3,72,79,
Noble,U.S. Senate,James Lankford,REP,520105,2,11,106,119,
Noble,U.S. Senate,Robert Murphy,LIB,520105,0,0,2,2,
Noble,U.S. Senate,Mike Workman,DEM,520105,4,3,59,66,
Noble,U.S. Senate,Mark Beard,IND,520105,0,0,7,7,
Noble,U.S. Senate,Sean Braddy,IND,520105,0,0,6,6,
Noble,U.S. House,Frank Lucas,REP,520105,2,11,101,114,03
Noble,U.S. House,Frankie Robbins,DEM,520105,4,3,76,83,03
Noble,President,Donald Trump,REP,520106,1,0,83,84,
Noble,President,Gary Johnson,LIB,520106,0,1,2,3,
Noble,President,Hillary Clinton,DEM,520106,0,3,11,14,
Noble,U.S. Senate,James Lankford,REP,520106,1,1,85,87,
Noble,U.S. Senate,Robert Murphy,LIB,520106,0,0,0,0,
Noble,U.S. Senate,Mike Workman,DEM,520106,0,3,9,12,
Noble,U.S. Senate,Mark Beard,IND,520106,0,0,0,0,
Noble,U.S. Senate,Sean Braddy,IND,520106,0,0,2,2,
Noble,U.S. House,Frank Lucas,REP,520106,1,1,77,79,03
Noble,U.S. House,Frankie Robbins,DEM,520106,0,3,18,21,03
Noble,President,Donald Trump,REP,520201,15,127,326,468,
Noble,President,Gary Johnson,LIB,520201,0,6,31,37,
Noble,President,Hillary Clinton,DEM,520201,4,30,84,118,
Noble,U.S. Senate,James Lankford,REP,520201,15,130,345,490,
Noble,U.S. Senate,Robert Murphy,LIB,520201,0,3,15,18,
Noble,U.S. Senate,Mike Workman,DEM,520201,3,28,70,101,
Noble,U.S. Senate,Mark Beard,IND,520201,1,3,4,8,
Noble,U.S. Senate,Sean Braddy,IND,520201,0,2,6,8,
Noble,U.S. House,Frank Lucas,REP,520201,16,131,361,508,03
Noble,U.S. House,Frankie Robbins,DEM,520201,3,35,80,118,03
Noble,President,Donald Trump,REP,520202,13,68,184,265,
Noble,President,Gary Johnson,LIB,520202,2,2,20,24,
Noble,President,Hillary Clinton,DEM,520202,8,23,53,84,
Noble,U.S. Senate,James Lankford,REP,520202,18,66,203,287,
Noble,U.S. Senate,Robert Murphy,LIB,520202,0,0,5,5,
Noble,U.S. Senate,Mike Workman,DEM,520202,6,24,42,72,
Noble,U.S. Senate,Mark Beard,IND,520202,0,2,2,4,
Noble,U.S. Senate,Sean Braddy,IND,520202,0,0,4,4,
Noble,U.S. House,Frank Lucas,REP,520202,17,69,207,293,03
Noble,U.S. House,Frankie Robbins,DEM,520202,7,24,46,77,03
Noble,President,Donald Trump,REP,520203,16,44,193,253,
Noble,President,Gary Johnson,LIB,520203,1,5,18,24,
Noble,President,Hillary Clinton,DEM,520203,8,12,57,77,
Noble,U.S. Senate,James Lankford,REP,520203,16,48,184,248,
Noble,U.S. Senate,Robert Murphy,LIB,520203,1,1,18,20,
Noble,U.S. Senate,Mike Workman,DEM,520203,7,11,46,64,
Noble,U.S. Senate,Mark Beard,IND,520203,2,2,7,11,
Noble,U.S. Senate,Sean Braddy,IND,520203,0,0,9,9,
Noble,U.S. House,Frank Lucas,REP,520203,17,51,208,276,03
Noble,U.S. House,Frankie Robbins,DEM,520203,9,11,55,75,03
Noble,President,Donald Trump,REP,520301,14,92,258,364,
Noble,President,Gary Johnson,LIB,520301,0,4,4,8,
Noble,President,Hillary Clinton,DEM,520301,3,18,42,63,
Noble,U.S. Senate,James Lankford,REP,520301,17,95,257,369,
Noble,U.S. Senate,Robert Murphy,LIB,520301,0,0,5,5,
Noble,U.S. Senate,Mike Workman,DEM,520301,1,16,37,54,
Noble,U.S. Senate,Mark Beard,IND,520301,0,2,2,4,
Noble,U.S. Senate,Sean Braddy,IND,520301,0,1,3,4,
Noble,U.S. House,Frank Lucas,REP,520301,17,95,261,373,03
Noble,U.S. House,Frankie Robbins,DEM,520301,1,17,38,56,03
Noble,President,Donald Trump,REP,520305,27,71,506,604,
Noble,President,Gary Johnson,LIB,520305,1,1,57,59,
Noble,President,Hillary Clinton,DEM,520305,3,7,125,135,
Noble,U.S. Senate,James Lankford,REP,520305,28,70,533,631,
Noble,U.S. Senate,Robert Murphy,LIB,520305,0,2,26,28,
Noble,U.S. Senate,Mike Workman,DEM,520305,2,5,91,98,
Noble,U.S. Senate,Mark Beard,IND,520305,0,1,17,18,
Noble,U.S. Senate,Sean Braddy,IND,520305,0,1,15,16,
Noble,U.S. House,Frank Lucas,REP,520305,29,75,542,646,03
Noble,U.S. House,Frankie Robbins,DEM,520305,2,4,128,134,03
Noble,President,Donald Trump,REP,520307,15,139,345,499,
Noble,President,Gary Johnson,LIB,520307,1,10,15,26,
Noble,President,Hillary Clinton,DEM,520307,7,33,65,105,
Noble,U.S. Senate,James Lankford,REP,520307,17,135,350,502,
Noble,U.S. Senate,Robert Murphy,LIB,520307,1,3,7,11,
Noble,U.S. Senate,Mike Workman,DEM,520307,5,36,56,97,
Noble,U.S. Senate,Mark Beard,IND,520307,0,6,4,10,
Noble,U.S. Senate,Sean Braddy,IND,520307,0,1,4,5,
Noble,U.S. House,Frank Lucas,REP,520307,16,141,357,514,03
Noble,U.S. House,Frankie Robbins,DEM,520307,6,36,58,100,03
Nowata,President,Donald Trump,REP,530101,13,85,332,430,
Nowata,President,Gary Johnson,LIB,530101,2,2,9,13,
Nowata,President,Hillary Clinton,DEM,530101,5,23,56,84,
Nowata,U.S. Senate,James Lankford,REP,530101,14,85,292,391,
Nowata,U.S. Senate,Robert Murphy,LIB,530101,0,2,10,12,
Nowata,U.S. Senate,Mike Workman,DEM,530101,5,24,83,112,
Nowata,U.S. Senate,Mark Beard,IND,530101,1,2,9,12,
Nowata,U.S. Senate,Sean Braddy,IND,530101,0,0,4,4,
Nowata,U.S. House,Markwayne Mullin,REP,530101,15,87,301,403,02
Nowata,U.S. House,Joshua Harris-Till,DEM,530101,4,21,73,98,02
Nowata,U.S. House,John Mccarthy,IND,530101,1,4,20,25,02
Nowata,State Senate,Julie Daniels,REP,530101,11,50,173,234,29
Nowata,State Senate,Robert Jobe,DEM,530101,8,62,223,293,29
Nowata,State House,Travis Dunlap,REP,530101,13,60,216,289,10
Nowata,State House,Eric Epperson,DEM,530101,7,51,177,235,10
Nowata,President,Donald Trump,REP,530102,20,82,397,499,
Nowata,President,Gary Johnson,LIB,530102,3,8,23,34,
Nowata,President,Hillary Clinton,DEM,530102,6,12,99,117,
Nowata,U.S. Senate,James Lankford,REP,530102,24,80,382,486,
Nowata,U.S. Senate,Robert Murphy,LIB,530102,1,4,7,12,
Nowata,U.S. Senate,Mike Workman,DEM,530102,2,16,113,131,
Nowata,U.S. Senate,Mark Beard,IND,530102,1,0,4,5,
Nowata,U.S. Senate,Sean Braddy,IND,530102,1,1,8,10,
Nowata,U.S. House,Markwayne Mullin,REP,530102,24,88,399,511,02
Nowata,U.S. House,Joshua Harris-Till,DEM,530102,3,12,92,107,02
Nowata,U.S. House,John Mccarthy,IND,530102,2,1,25,28,02
Nowata,State Senate,Julie Daniels,REP,530102,14,47,232,293,29
Nowata,State Senate,Robert Jobe,DEM,530102,14,54,288,356,29
Nowata,State House,Travis Dunlap,REP,530102,20,60,296,376,10
Nowata,State House,Eric Epperson,DEM,530102,8,41,223,272,10
Nowata,President,Donald Trump,REP,530103,7,30,164,201,
Nowata,President,Gary Johnson,LIB,530103,1,1,7,9,
Nowata,President,Hillary Clinton,DEM,530103,1,2,40,43,
Nowata,U.S. Senate,James Lankford,REP,530103,6,25,145,176,
Nowata,U.S. Senate,Robert Murphy,LIB,530103,1,0,2,3,
Nowata,U.S. Senate,Mike Workman,DEM,530103,1,6,61,68,
Nowata,U.S. Senate,Mark Beard,IND,530103,0,1,1,2,
Nowata,U.S. Senate,Sean Braddy,IND,530103,0,1,2,3,
Nowata,U.S. House,Markwayne Mullin,REP,530103,6,26,162,194,02
Nowata,U.S. House,Joshua Harris-Till,DEM,530103,1,4,47,52,02
Nowata,U.S. House,John Mccarthy,IND,530103,1,2,4,7,02
Nowata,State Senate,Julie Daniels,REP,530103,6,12,84,102,29
Nowata,State Senate,Robert Jobe,DEM,530103,2,21,127,150,29
Nowata,State House,Travis Dunlap,REP,530103,6,16,109,131,10
Nowata,State House,Eric Epperson,DEM,530103,2,17,101,120,10
Nowata,President,Donald Trump,REP,530201,11,13,237,261,
Nowata,President,Gary Johnson,LIB,530201,0,0,17,17,
Nowata,President,Hillary Clinton,DEM,530201,3,2,49,54,
Nowata,U.S. Senate,James Lankford,REP,530201,12,12,226,250,
Nowata,U.S. Senate,Robert Murphy,LIB,530201,0,0,9,9,
Nowata,U.S. Senate,Mike Workman,DEM,530201,3,3,59,65,
Nowata,U.S. Senate,Mark Beard,IND,530201,0,0,4,4,
Nowata,U.S. Senate,Sean Braddy,IND,530201,1,0,3,4,
Nowata,U.S. House,Markwayne Mullin,REP,530201,13,11,240,264,02
Nowata,U.S. House,Joshua Harris-Till,DEM,530201,3,3,49,55,02
Nowata,U.S. House,John Mccarthy,IND,530201,0,1,13,14,02
Nowata,State Senate,Julie Daniels,REP,530201,14,5,113,132,29
Nowata,State Senate,Robert Jobe,DEM,530201,2,10,190,202,29
Nowata,State House,Travis Dunlap,REP,530201,15,10,183,208,10
Nowata,State House,Eric Epperson,DEM,530201,1,5,113,119,10
Nowata,President,Donald Trump,REP,530202,12,52,221,285,
Nowata,President,Gary Johnson,LIB,530202,0,2,7,9,
Nowata,President,Hillary Clinton,DEM,530202,6,4,20,30,
Nowata,U.S. Senate,James Lankford,REP,530202,13,52,198,263,
Nowata,U.S. Senate,Robert Murphy,LIB,530202,0,2,5,7,
Nowata,U.S. Senate,Mike Workman,DEM,530202,5,4,34,43,
Nowata,U.S. Senate,Mark Beard,IND,530202,0,0,6,6,
Nowata,U.S. Senate,Sean Braddy,IND,530202,0,0,2,2,
Nowata,U.S. House,Markwayne Mullin,REP,530202,12,55,206,273,02
Nowata,U.S. House,Joshua Harris-Till,DEM,530202,6,3,27,36,02
Nowata,U.S. House,John Mccarthy,IND,530202,0,1,11,12,02
Nowata,State Senate,Julie Daniels,REP,530202,8,20,112,140,29
Nowata,State Senate,Robert Jobe,DEM,530202,11,38,134,183,29
Nowata,State House,Travis Dunlap,REP,530202,10,38,128,176,10
Nowata,State House,Eric Epperson,DEM,530202,9,19,114,142,10
Nowata,President,Donald Trump,REP,530203,7,81,345,433,
Nowata,President,Gary Johnson,LIB,530203,0,5,19,24,
Nowata,President,Hillary Clinton,DEM,530203,5,19,82,106,
Nowata,U.S. Senate,James Lankford,REP,530203,7,79,333,419,
Nowata,U.S. Senate,Robert Murphy,LIB,530203,0,2,12,14,
Nowata,U.S. Senate,Mike Workman,DEM,530203,3,21,81,105,
Nowata,U.S. Senate,Mark Beard,IND,530203,0,3,9,12,
Nowata,U.S. Senate,Sean Braddy,IND,530203,1,0,9,10,
Nowata,U.S. House,Markwayne Mullin,REP,530203,7,84,346,437,02
Nowata,U.S. House,Joshua Harris-Till,DEM,530203,3,15,74,92,02
Nowata,U.S. House,John Mccarthy,IND,530203,0,5,24,29,02
Nowata,State Senate,Julie Daniels,REP,530203,6,46,210,262,29
Nowata,State Senate,Robert Jobe,DEM,530203,4,59,233,296,29
Nowata,State House,Travis Dunlap,REP,530203,4,60,265,329,10
Nowata,State House,Eric Epperson,DEM,530203,8,45,176,229,10
Nowata,President,Donald Trump,REP,530204,9,12,184,205,
Nowata,President,Gary Johnson,LIB,530204,0,0,7,7,
Nowata,President,Hillary Clinton,DEM,530204,1,1,36,38,
Nowata,U.S. Senate,James Lankford,REP,530204,7,10,170,187,
Nowata,U.S. Senate,Robert Murphy,LIB,530204,0,1,3,4,
Nowata,U.S. Senate,Mike Workman,DEM,530204,4,2,42,48,
Nowata,U.S. Senate,Mark Beard,IND,530204,0,0,2,2,
Nowata,U.S. Senate,Sean Braddy,IND,530204,0,0,3,3,
Nowata,U.S. House,Markwayne Mullin,REP,530204,7,12,178,197,02
Nowata,U.S. House,Joshua Harris-Till,DEM,530204,3,1,36,40,02
Nowata,U.S. House,John Mccarthy,IND,530204,1,0,10,11,02
Nowata,State Senate,Julie Daniels,REP,530204,5,7,77,89,29
Nowata,State Senate,Robert Jobe,DEM,530204,6,6,149,161,29
Nowata,State House,Travis Dunlap,REP,530204,7,11,115,133,10
Nowata,State House,Eric Epperson,DEM,530204,4,2,109,115,10
Nowata,President,Donald Trump,REP,530301,14,27,432,473,
Nowata,President,Gary Johnson,LIB,530301,1,1,26,28,
Nowata,President,Hillary Clinton,DEM,530301,7,0,111,118,
Nowata,U.S. Senate,James Lankford,REP,530301,19,26,384,429,
Nowata,U.S. Senate,Robert Murphy,LIB,530301,0,0,13,13,
Nowata,U.S. Senate,Mike Workman,DEM,530301,4,0,125,129,
Nowata,U.S. Senate,Mark Beard,IND,530301,1,2,27,30,
Nowata,U.S. Senate,Sean Braddy,IND,530301,0,0,16,16,
Nowata,U.S. House,Markwayne Mullin,REP,530301,19,27,411,457,02
Nowata,U.S. House,Joshua Harris-Till,DEM,530301,4,0,114,118,02
Nowata,U.S. House,John Mccarthy,IND,530301,1,1,39,41,02
Nowata,State Senate,Julie Daniels,REP,530301,11,15,243,269,29
Nowata,State Senate,Robert Jobe,DEM,530301,13,13,323,349,29
Nowata,State House,Travis Dunlap,REP,530301,13,22,319,354,10
Nowata,State House,Eric Epperson,DEM,530301,11,6,241,258,10
Nowata,President,Donald Trump,REP,530302,7,48,180,235,
Nowata,President,Gary Johnson,LIB,530302,0,1,13,14,
Nowata,President,Hillary Clinton,DEM,530302,1,20,68,89,
Nowata,U.S. Senate,James Lankford,REP,530302,7,50,179,236,
Nowata,U.S. Senate,Robert Murphy,LIB,530302,0,0,8,8,
Nowata,U.S. Senate,Mike Workman,DEM,530302,1,15,57,73,
Nowata,U.S. Senate,Mark Beard,IND,530302,0,3,10,13,
Nowata,U.S. Senate,Sean Braddy,IND,530302,0,1,4,5,
Nowata,U.S. House,Markwayne Mullin,REP,530302,7,49,182,238,02
Nowata,U.S. House,Joshua Harris-Till,DEM,530302,1,17,62,80,02
Nowata,U.S. House,John Mccarthy,IND,530302,0,3,15,18,02
Nowata,State Senate,Julie Daniels,REP,530302,6,34,109,149,29
Nowata,State Senate,Robert Jobe,DEM,530302,2,35,149,186,29
Nowata,State House,Travis Dunlap,REP,530302,5,39,131,175,10
Nowata,State House,Eric Epperson,DEM,530302,3,30,129,162,10
Nowata,President,Donald Trump,REP,530303,3,10,182,195,
Nowata,President,Gary Johnson,LIB,530303,1,0,16,17,
Nowata,President,Hillary Clinton,DEM,530303,0,2,37,39,
Nowata,U.S. Senate,James Lankford,REP,530303,3,7,170,180,
Nowata,U.S. Senate,Robert Murphy,LIB,530303,0,0,8,8,
Nowata,U.S. Senate,Mike Workman,DEM,530303,1,4,42,47,
Nowata,U.S. Senate,Mark Beard,IND,530303,0,1,3,4,
Nowata,U.S. Senate,Sean Braddy,IND,530303,1,0,9,10,
Nowata,U.S. House,Markwayne Mullin,REP,530303,4,8,176,188,02
Nowata,U.S. House,Joshua Harris-Till,DEM,530303,1,3,37,41,02
Nowata,U.S. House,John Mccarthy,IND,530303,0,1,19,20,02
Nowata,State Senate,Julie Daniels,REP,530303,2,5,90,97,29
Nowata,State Senate,Robert Jobe,DEM,530303,3,7,144,154,29
Nowata,State House,Travis Dunlap,REP,530303,4,6,107,117,10
Nowata,State House,Eric Epperson,DEM,530303,1,6,127,134,10
Nowata,President,Donald Trump,REP,530304,2,7,95,104,
Nowata,President,Gary Johnson,LIB,530304,1,0,1,2,
Nowata,President,Hillary Clinton,DEM,530304,4,4,16,24,
Nowata,U.S. Senate,James Lankford,REP,530304,4,5,89,98,
Nowata,U.S. Senate,Robert Murphy,LIB,530304,0,0,0,0,
Nowata,U.S. Senate,Mike Workman,DEM,530304,3,4,17,24,
Nowata,U.S. Senate,Mark Beard,IND,530304,0,0,0,0,
Nowata,U.S. Senate,Sean Braddy,IND,530304,0,2,3,5,
Nowata,U.S. House,Markwayne Mullin,REP,530304,4,8,92,104,02
Nowata,U.S. House,Joshua Harris-Till,DEM,530304,3,3,16,22,02
Nowata,U.S. House,John Mccarthy,IND,530304,0,0,3,3,02
Nowata,State Senate,Julie Daniels,REP,530304,1,1,39,41,29
Nowata,State Senate,Robert Jobe,DEM,530304,6,10,71,87,29
Nowata,State House,Travis Dunlap,REP,530304,2,4,65,71,10
Nowata,State House,Eric Epperson,DEM,530304,5,6,45,56,10
Okfuskee,President,Donald Trump,REP,540101,14,27,553,594,
Okfuskee,President,Gary Johnson,LIB,540101,1,2,24,27,
Okfuskee,President,Hillary Clinton,DEM,540101,4,6,72,82,
Okfuskee,U.S. Senate,James Lankford,REP,540101,16,28,525,569,
Okfuskee,U.S. Senate,Robert Murphy,LIB,540101,1,0,8,9,
Okfuskee,U.S. Senate,Mike Workman,DEM,540101,2,6,84,92,
Okfuskee,U.S. Senate,Mark Beard,IND,540101,0,1,18,19,
Okfuskee,U.S. Senate,Sean Braddy,IND,540101,0,0,7,7,
Okfuskee,U.S. House,Markwayne Mullin,REP,540101,14,26,480,520,02
Okfuskee,U.S. House,Joshua Harris-Till,DEM,540101,4,8,105,117,02
Okfuskee,U.S. House,John Mccarthy,IND,540101,1,1,49,51,02
Okfuskee,President,Donald Trump,REP,540102,3,6,29,38,
Okfuskee,President,Gary Johnson,LIB,540102,0,0,7,7,
Okfuskee,President,Hillary Clinton,DEM,540102,12,8,140,160,
Okfuskee,U.S. Senate,James Lankford,REP,540102,3,6,39,48,
Okfuskee,U.S. Senate,Robert Murphy,LIB,540102,0,0,5,5,
Okfuskee,U.S. Senate,Mike Workman,DEM,540102,12,8,115,135,
Okfuskee,U.S. Senate,Mark Beard,IND,540102,0,0,9,9,
Okfuskee,U.S. Senate,Sean Braddy,IND,540102,0,0,5,5,
Okfuskee,U.S. House,Markwayne Mullin,REP,540102,0,6,32,38,02
Okfuskee,U.S. House,Joshua Harris-Till,DEM,540102,12,8,127,147,02
Okfuskee,U.S. House,John Mccarthy,IND,540102,3,0,14,17,02
Okfuskee,President,Donald Trump,REP,540103,1,7,100,108,
Okfuskee,President,Gary Johnson,LIB,540103,0,0,3,3,
Okfuskee,President,Hillary Clinton,DEM,540103,0,0,30,30,
Okfuskee,U.S. Senate,James Lankford,REP,540103,1,7,95,103,
Okfuskee,U.S. Senate,Robert Murphy,LIB,540103,0,0,0,0,
Okfuskee,U.S. Senate,Mike Workman,DEM,540103,0,0,29,29,
Okfuskee,U.S. Senate,Mark Beard,IND,540103,0,0,3,3,
Okfuskee,U.S. Senate,Sean Braddy,IND,540103,0,0,5,5,
Okfuskee,U.S. House,Markwayne Mullin,REP,540103,1,7,88,96,02
Okfuskee,U.S. House,Joshua Harris-Till,DEM,540103,0,0,30,30,02
Okfuskee,U.S. House,John Mccarthy,IND,540103,0,0,15,15,02
Okfuskee,President,Donald Trump,REP,540105,2,30,97,129,
Okfuskee,President,Gary Johnson,LIB,540105,0,2,6,8,
Okfuskee,President,Hillary Clinton,DEM,540105,6,16,27,49,
Okfuskee,U.S. Senate,James Lankford,REP,540105,2,32,92,126,
Okfuskee,U.S. Senate,Robert Murphy,LIB,540105,0,2,4,6,
Okfuskee,U.S. Senate,Mike Workman,DEM,540105,6,12,29,47,
Okfuskee,U.S. Senate,Mark Beard,IND,540105,0,1,1,2,
Okfuskee,U.S. Senate,Sean Braddy,IND,540105,0,0,4,4,
Okfuskee,U.S. House,Markwayne Mullin,REP,540105,2,33,92,127,02
Okfuskee,U.S. House,Joshua Harris-Till,DEM,540105,6,14,32,52,02
Okfuskee,U.S. House,John Mccarthy,IND,540105,0,0,5,5,02
Okfuskee,President,Donald Trump,REP,540206,15,27,240,282,
Okfuskee,President,Gary Johnson,LIB,540206,0,1,5,6,
Okfuskee,President,Hillary Clinton,DEM,540206,3,6,45,54,
Okfuskee,U.S. Senate,James Lankford,REP,540206,15,25,237,277,
Okfuskee,U.S. Senate,Robert Murphy,LIB,540206,0,0,3,3,
Okfuskee,U.S. Senate,Mike Workman,DEM,540206,3,7,45,55,
Okfuskee,U.S. Senate,Mark Beard,IND,540206,0,0,1,1,
Okfuskee,U.S. Senate,Sean Braddy,IND,540206,0,1,3,4,
Okfuskee,U.S. House,Markwayne Mullin,REP,540206,14,25,239,278,02
Okfuskee,U.S. House,Joshua Harris-Till,DEM,540206,3,7,42,52,02
Okfuskee,U.S. House,John Mccarthy,IND,540206,1,1,8,10,02
Okfuskee,President,Donald Trump,REP,540207,2,12,77,91,
Okfuskee,President,Gary Johnson,LIB,540207,1,0,8,9,
Okfuskee,President,Hillary Clinton,DEM,540207,1,5,26,32,
Okfuskee,U.S. Senate,James Lankford,REP,540207,4,13,76,93,
Okfuskee,U.S. Senate,Robert Murphy,LIB,540207,0,0,2,2,
Okfuskee,U.S. Senate,Mike Workman,DEM,540207,0,4,22,26,
Okfuskee,U.S. Senate,Mark Beard,IND,540207,0,0,5,5,
Okfuskee,U.S. Senate,Sean Braddy,IND,540207,0,0,5,5,
Okfuskee,U.S. House,Markwayne Mullin,REP,540207,4,11,75,90,02
Okfuskee,U.S. House,Joshua Harris-Till,DEM,540207,0,6,27,33,02
Okfuskee,U.S. House,John Mccarthy,IND,540207,0,0,7,7,02
Okfuskee,President,Donald Trump,REP,540208,10,67,185,262,
Okfuskee,President,Gary Johnson,LIB,540208,0,4,21,25,
Okfuskee,President,Hillary Clinton,DEM,540208,4,11,42,57,
Okfuskee,U.S. Senate,James Lankford,REP,540208,7,66,185,258,
Okfuskee,U.S. Senate,Robert Murphy,LIB,540208,0,1,9,10,
Okfuskee,U.S. Senate,Mike Workman,DEM,540208,6,13,49,68,
Okfuskee,U.S. Senate,Mark Beard,IND,540208,0,1,2,3,
Okfuskee,U.S. Senate,Sean Braddy,IND,540208,1,1,4,6,
Okfuskee,U.S. House,Markwayne Mullin,REP,540208,6,66,178,250,02
Okfuskee,U.S. House,Joshua Harris-Till,DEM,540208,6,10,44,60,02
Okfuskee,U.S. House,John Mccarthy,IND,540208,2,6,27,35,02
Okfuskee,President,Donald Trump,REP,540209,14,74,296,384,
Okfuskee,President,Gary Johnson,LIB,540209,0,2,33,35,
Okfuskee,President,Hillary Clinton,DEM,540209,9,16,103,128,
Okfuskee,U.S. Senate,James Lankford,REP,540209,16,74,318,408,
Okfuskee,U.S. Senate,Robert Murphy,LIB,540209,1,2,9,12,
Okfuskee,U.S. Senate,Mike Workman,DEM,540209,7,12,82,101,
Okfuskee,U.S. Senate,Mark Beard,IND,540209,0,3,12,15,
Okfuskee,U.S. Senate,Sean Braddy,IND,540209,0,1,6,7,
Okfuskee,U.S. House,Markwayne Mullin,REP,540209,19,74,310,403,02
Okfuskee,U.S. House,Joshua Harris-Till,DEM,540209,5,15,90,110,02
Okfuskee,U.S. House,John Mccarthy,IND,540209,0,3,21,24,02
Okfuskee,President,Donald Trump,REP,540210,9,26,118,153,
Okfuskee,President,Gary Johnson,LIB,540210,1,0,6,7,
Okfuskee,President,Hillary Clinton,DEM,540210,5,5,23,33,
Okfuskee,U.S. Senate,James Lankford,REP,540210,14,23,118,155,
Okfuskee,U.S. Senate,Robert Murphy,LIB,540210,0,0,1,1,
Okfuskee,U.S. Senate,Mike Workman,DEM,540210,2,7,23,32,
Okfuskee,U.S. Senate,Mark Beard,IND,540210,0,1,3,4,
Okfuskee,U.S. Senate,Sean Braddy,IND,540210,0,0,1,1,
Okfuskee,U.S. House,Markwayne Mullin,REP,540210,11,23,112,146,02
Okfuskee,U.S. House,Joshua Harris-Till,DEM,540210,3,9,26,38,02
Okfuskee,U.S. House,John Mccarthy,IND,540210,0,0,8,8,02
Okfuskee,State Senate,Larry Boggs,REP,540210,12,23,104,139,7
Okfuskee,State Senate,Joel Kerns,DEM,540210,4,7,41,52,7
Okfuskee,President,Donald Trump,REP,540311,13,19,173,205,
Okfuskee,President,Gary Johnson,LIB,540311,0,4,8,12,
Okfuskee,President,Hillary Clinton,DEM,540311,6,8,65,79,
Okfuskee,U.S. Senate,James Lankford,REP,540311,14,20,180,214,
Okfuskee,U.S. Senate,Robert Murphy,LIB,540311,0,1,3,4,
Okfuskee,U.S. Senate,Mike Workman,DEM,540311,5,9,59,73,
Okfuskee,U.S. Senate,Mark Beard,IND,540311,0,1,1,2,
Okfuskee,U.S. Senate,Sean Braddy,IND,540311,0,0,1,1,
Okfuskee,U.S. House,Markwayne Mullin,REP,540311,13,19,169,201,02
Okfuskee,U.S. House,Joshua Harris-Till,DEM,540311,6,10,58,74,02
Okfuskee,U.S. House,John Mccarthy,IND,540311,0,2,17,19,02
Okfuskee,President,Donald Trump,REP,540312,12,27,260,299,
Okfuskee,President,Gary Johnson,LIB,540312,2,1,22,25,
Okfuskee,President,Hillary Clinton,DEM,540312,14,9,106,129,
Okfuskee,U.S. Senate,James Lankford,REP,540312,17,28,251,296,
Okfuskee,U.S. Senate,Robert Murphy,LIB,540312,1,2,14,17,
Okfuskee,U.S. Senate,Mike Workman,DEM,540312,12,7,113,132,
Okfuskee,U.S. Senate,Mark Beard,IND,540312,0,1,4,5,
Okfuskee,U.S. Senate,Sean Braddy,IND,540312,0,0,9,9,
Okfuskee,U.S. House,Markwayne Mullin,REP,540312,19,27,233,279,02
Okfuskee,U.S. House,Joshua Harris-Till,DEM,540312,11,9,124,144,02
Okfuskee,U.S. House,John Mccarthy,IND,540312,0,2,30,32,02
Okfuskee,State Senate,Larry Boggs,REP,540312,18,26,230,274,7
Okfuskee,State Senate,Joel Kerns,DEM,540312,12,11,159,182,7
Okfuskee,President,Donald Trump,REP,540313,3,3,88,94,
Okfuskee,President,Gary Johnson,LIB,540313,0,0,6,6,
Okfuskee,President,Hillary Clinton,DEM,540313,0,3,27,30,
Okfuskee,U.S. Senate,James Lankford,REP,540313,3,2,78,83,
Okfuskee,U.S. Senate,Robert Murphy,LIB,540313,0,0,0,0,
Okfuskee,U.S. Senate,Mike Workman,DEM,540313,0,4,36,40,
Okfuskee,U.S. Senate,Mark Beard,IND,540313,0,0,1,1,
Okfuskee,U.S. Senate,Sean Braddy,IND,540313,0,0,3,3,
Okfuskee,U.S. House,Markwayne Mullin,REP,540313,3,2,87,92,02
Okfuskee,U.S. House,Joshua Harris-Till,DEM,540313,0,4,28,32,02
Okfuskee,U.S. House,John Mccarthy,IND,540313,0,0,3,3,02
Okfuskee,President,Donald Trump,REP,540314,11,23,127,161,
Okfuskee,President,Gary Johnson,LIB,540314,4,4,22,30,
Okfuskee,President,Hillary Clinton,DEM,540314,8,8,64,80,
Okfuskee,U.S. Senate,James Lankford,REP,540314,13,23,129,165,
Okfuskee,U.S. Senate,Robert Murphy,LIB,540314,0,1,7,8,
Okfuskee,U.S. Senate,Mike Workman,DEM,540314,9,8,59,76,
Okfuskee,U.S. Senate,Mark Beard,IND,540314,0,0,7,7,
Okfuskee,U.S. Senate,Sean Braddy,IND,540314,0,3,7,10,
Okfuskee,U.S. House,Markwayne Mullin,REP,540314,11,23,127,161,02
Okfuskee,U.S. House,Joshua Harris-Till,DEM,540314,6,9,60,75,02
Okfuskee,U.S. House,John Mccarthy,IND,540314,3,3,22,28,02
Oklahoma,President,Donald Trump,REP,550001,0,0,345,345,
Oklahoma,President,Gary Johnson,LIB,550001,0,0,61,61,
Oklahoma,President,Hillary Clinton,DEM,550001,0,0,345,345,
Oklahoma,U.S. Senate,James Lankford,REP,550001,0,0,402,402,
Oklahoma,U.S. Senate,Robert Murphy,LIB,550001,0,0,32,32,
Oklahoma,U.S. Senate,Mike Workman,DEM,550001,0,0,270,270,
Oklahoma,U.S. Senate,Mark Beard,IND,550001,0,0,14,14,
Oklahoma,U.S. Senate,Sean Braddy,IND,550001,0,0,30,30,
Oklahoma,U.S. House,Steve Russell,REP,550001,0,0,387,387,05
Oklahoma,U.S. House,Zachary Knight,LIB,550001,0,0,46,46,05
Oklahoma,U.S. House,Al Mcaffrey,DEM,550001,0,0,311,311,05
Oklahoma,State House,Tammy West,REP,550001,0,0,395,395,84
Oklahoma,State House,Will Hollander,DEM,550001,0,0,347,347,84
Oklahoma,President,Donald Trump,REP,550002,0,0,454,454,
Oklahoma,President,Gary Johnson,LIB,550002,0,0,63,63,
Oklahoma,President,Hillary Clinton,DEM,550002,0,0,212,212,
Oklahoma,U.S. Senate,James Lankford,REP,550002,0,0,491,491,
Oklahoma,U.S. Senate,Robert Murphy,LIB,550002,0,0,25,25,
Oklahoma,U.S. Senate,Mike Workman,DEM,550002,0,0,171,171,
Oklahoma,U.S. Senate,Mark Beard,IND,550002,0,0,16,16,
Oklahoma,U.S. Senate,Sean Braddy,IND,550002,0,0,26,26,
Oklahoma,U.S. House,Steve Russell,REP,550002,0,0,482,482,05
Oklahoma,U.S. House,Zachary Knight,LIB,550002,0,0,57,57,05
Oklahoma,U.S. House,Al Mcaffrey,DEM,550002,0,0,188,188,05
Oklahoma,State House,Tammy West,REP,550002,0,0,489,489,84
Oklahoma,State House,Will Hollander,DEM,550002,0,0,231,231,84
Oklahoma,President,Donald Trump,REP,550003,0,0,572,572,
Oklahoma,President,Gary Johnson,LIB,550003,0,0,64,64,
Oklahoma,President,Hillary Clinton,DEM,550003,0,0,246,246,
Oklahoma,U.S. Senate,James Lankford,REP,550003,0,0,629,629,
Oklahoma,U.S. Senate,Robert Murphy,LIB,550003,0,0,27,27,
Oklahoma,U.S. Senate,Mike Workman,DEM,550003,0,0,184,184,
Oklahoma,U.S. Senate,Mark Beard,IND,550003,0,0,24,24,
Oklahoma,U.S. Senate,Sean Braddy,IND,550003,0,0,24,24,
Oklahoma,U.S. House,Steve Russell,REP,550003,0,0,594,594,05
Oklahoma,U.S. House,Zachary Knight,LIB,550003,0,0,59,59,05
Oklahoma,U.S. House,Al Mcaffrey,DEM,550003,0,0,226,226,05
Oklahoma,State House,Tammy West,REP,550003,0,0,634,634,84
Oklahoma,State House,Will Hollander,DEM,550003,0,0,242,242,84
Oklahoma,President,Donald Trump,REP,550004,0,0,682,682,
Oklahoma,President,Gary Johnson,LIB,550004,0,0,84,84,
Oklahoma,President,Hillary Clinton,DEM,550004,0,0,263,263,
Oklahoma,U.S. Senate,James Lankford,REP,550004,0,0,753,753,
Oklahoma,U.S. Senate,Robert Murphy,LIB,550004,0,0,41,41,
Oklahoma,U.S. Senate,Mike Workman,DEM,550004,0,0,199,199,
Oklahoma,U.S. Senate,Mark Beard,IND,550004,0,0,9,9,
Oklahoma,U.S. Senate,Sean Braddy,IND,550004,0,0,32,32,
Oklahoma,U.S. House,Steve Russell,REP,550004,0,0,738,738,05
Oklahoma,U.S. House,Zachary Knight,LIB,550004,0,0,62,62,05
Oklahoma,U.S. House,Al Mcaffrey,DEM,550004,0,0,224,224,05
Oklahoma,State House,Tammy West,REP,550004,0,0,704,704,84
Oklahoma,State House,Will Hollander,DEM,550004,0,0,318,318,84
Oklahoma,President,Donald Trump,REP,550005,0,0,509,509,
Oklahoma,President,Gary Johnson,LIB,550005,0,0,79,79,
Oklahoma,President,Hillary Clinton,DEM,550005,0,0,271,271,
Oklahoma,U.S. Senate,James Lankford,REP,550005,0,0,576,576,
Oklahoma,U.S. Senate,Robert Murphy,LIB,550005,0,0,33,33,
Oklahoma,U.S. Senate,Mike Workman,DEM,550005,0,0,213,213,
Oklahoma,U.S. Senate,Mark Beard,IND,550005,0,0,18,18,
Oklahoma,U.S. Senate,Sean Braddy,IND,550005,0,0,30,30,
Oklahoma,U.S. House,Steve Russell,REP,550005,0,0,541,541,05
Oklahoma,U.S. House,Zachary Knight,LIB,550005,0,0,66,66,05
Oklahoma,U.S. House,Al Mcaffrey,DEM,550005,0,0,255,255,05
Oklahoma,State House,Tammy West,REP,550005,0,0,539,539,84
Oklahoma,State House,Will Hollander,DEM,550005,0,0,316,316,84
Oklahoma,President,Donald Trump,REP,550006,0,0,445,445,
Oklahoma,President,Gary Johnson,LIB,550006,0,0,51,51,
Oklahoma,President,Hillary Clinton,DEM,550006,0,0,212,212,
Oklahoma,U.S. Senate,James Lankford,REP,550006,0,0,467,467,
Oklahoma,U.S. Senate,Robert Murphy,LIB,550006,0,0,20,20,
Oklahoma,U.S. Senate,Mike Workman,DEM,550006,0,0,177,177,
Oklahoma,U.S. Senate,Mark Beard,IND,550006,0,0,15,15,
Oklahoma,U.S. Senate,Sean Braddy,IND,550006,0,0,28,28,
Oklahoma,U.S. House,Steve Russell,REP,550006,0,0,454,454,05
Oklahoma,U.S. House,Zachary Knight,LIB,550006,0,0,36,36,05
Oklahoma,U.S. House,Al Mcaffrey,DEM,550006,0,0,210,210,05
Oklahoma,State House,Tammy West,REP,550006,0,0,435,435,84
Oklahoma,State House,Will Hollander,DEM,550006,0,0,265,265,84
Oklahoma,President,Donald Trump,REP,550007,0,0,744,744,
Oklahoma,President,Gary Johnson,LIB,550007,0,0,65,65,
Oklahoma,President,Hillary Clinton,DEM,550007,0,0,242,242,
Oklahoma,U.S. Senate,James Lankford,REP,550007,0,0,792,792,
Oklahoma,U.S. Senate,Robert Murphy,LIB,550007,0,0,38,38,
Oklahoma,U.S. Senate,Mike Workman,DEM,550007,0,0,178,178,
Oklahoma,U.S. Senate,Mark Beard,IND,550007,0,0,16,16,
Oklahoma,U.S. Senate,Sean Braddy,IND,550007,0,0,27,27,
Oklahoma,U.S. House,Steve Russell,REP,550007,0,0,785,785,05
Oklahoma,U.S. House,Zachary Knight,LIB,550007,0,0,60,60,05
Oklahoma,U.S. House,Al Mcaffrey,DEM,550007,0,0,197,197,05
Oklahoma,State Senate,Greg Treat,REP,550007,0,0,689,689,47
Oklahoma,State Senate,Judy Mullen Hopper,DEM,550007,0,0,290,290,47
Oklahoma,State Senate,Steven Weber,IND,550007,0,0,65,65,47
Oklahoma,State House,Tammy West,REP,550007,0,0,759,759,84
Oklahoma,State House,Will Hollander,DEM,550007,0,0,283,283,84
Oklahoma,President,Donald Trump,REP,550008,0,0,303,303,
Oklahoma,President,Gary Johnson,LIB,550008,0,0,27,27,
Oklahoma,President,Hillary Clinton,DEM,550008,0,0,82,82,
Oklahoma,U.S. Senate,James Lankford,REP,550008,0,0,339,339,
Oklahoma,U.S. Senate,Robert Murphy,LIB,550008,0,0,6,6,
Oklahoma,U.S. Senate,Mike Workman,DEM,550008,0,0,56,56,
Oklahoma,U.S. Senate,Mark Beard,IND,550008,0,0,9,9,
Oklahoma,U.S. Senate,Sean Braddy,IND,550008,0,0,12,12,
Oklahoma,U.S. House,Steve Russell,REP,550008,0,0,321,321,05
Oklahoma,U.S. House,Zachary Knight,LIB,550008,0,0,20,20,05
Oklahoma,U.S. House,Al Mcaffrey,DEM,550008,0,0,73,73,05
Oklahoma,State House,Tammy West,REP,550008,0,0,322,322,84
Oklahoma,State House,Will Hollander,DEM,550008,0,0,94,94,84
Oklahoma,President,Donald Trump,REP,550009,0,0,430,430,
Oklahoma,President,Gary Johnson,LIB,550009,0,0,67,67,
Oklahoma,President,Hillary Clinton,DEM,550009,0,0,146,146,
Oklahoma,U.S. Senate,James Lankford,REP,550009,0,0,485,485,
Oklahoma,U.S. Senate,Robert Murphy,LIB,550009,0,0,23,23,
Oklahoma,U.S. Senate,Mike Workman,DEM,550009,0,0,107,107,
Oklahoma,U.S. Senate,Mark Beard,IND,550009,0,0,10,10,
Oklahoma,U.S. Senate,Sean Braddy,IND,550009,0,0,17,17,
Oklahoma,U.S. House,Steve Russell,REP,550009,0,0,465,465,05
Oklahoma,U.S. House,Zachary Knight,LIB,550009,0,0,44,44,05
Oklahoma,U.S. House,Al Mcaffrey,DEM,550009,0,0,129,129,05
Oklahoma,State House,Elise Hall,REP,550009,0,0,315,315,10
Oklahoma,State House,Christina Wright,LIB,550009,0,0,34,34,10
Oklahoma,State House,Donald Wentroth Jr.,DEM,550009,0,0,294,294,10
Oklahoma,President,Donald Trump,REP,550010,0,0,322,322,
Oklahoma,President,Gary Johnson,LIB,550010,0,0,61,61,
Oklahoma,President,Hillary Clinton,DEM,550010,0,0,138,138,
Oklahoma,U.S. Senate,James Lankford,REP,550010,0,0,370,370,
Oklahoma,U.S. Senate,Robert Murphy,LIB,550010,0,0,20,20,
Oklahoma,U.S. Senate,Mike Workman,DEM,550010,0,0,104,104,
Oklahoma,U.S. Senate,Mark Beard,IND,550010,0,0,8,8,
Oklahoma,U.S. Senate,Sean Braddy,IND,550010,0,0,20,20,
Oklahoma,U.S. House,Steve Russell,REP,550010,0,0,337,337,05
Oklahoma,U.S. House,Zachary Knight,LIB,550010,0,0,36,36,05
Oklahoma,U.S. House,Al Mcaffrey,DEM,550010,0,0,135,135,05
Oklahoma,State House,Tammy West,REP,550010,0,0,334,334,84
Oklahoma,State House,Will Hollander,DEM,550010,0,0,179,179,84
Oklahoma,President,Donald Trump,REP,550011,0,0,394,394,
Oklahoma,President,Gary Johnson,LIB,550011,0,0,61,61,
Oklahoma,President,Hillary Clinton,DEM,550011,0,0,258,258,
Oklahoma,U.S. Senate,James Lankford,REP,550011,0,0,429,429,
Oklahoma,U.S. Senate,Robert Murphy,LIB,550011,0,0,30,30,
Oklahoma,U.S. Senate,Mike Workman,DEM,550011,0,0,206,206,
Oklahoma,U.S. Senate,Mark Beard,IND,550011,0,0,12,12,
Oklahoma,U.S. Senate,Sean Braddy,IND,550011,0,0,34,34,
Oklahoma,U.S. House,Steve Russell,REP,550011,0,0,403,403,05
Oklahoma,U.S. House,Zachary Knight,LIB,550011,0,0,53,53,05
Oklahoma,U.S. House,Al Mcaffrey,DEM,550011,0,0,245,245,05
Oklahoma,State House,Tammy West,REP,550011,0,0,419,419,84
Oklahoma,State House,Will Hollander,DEM,550011,0,0,284,284,84
Oklahoma,President,Donald Trump,REP,550012,0,0,607,607,
Oklahoma,President,Gary Johnson,LIB,550012,0,0,96,96,
Oklahoma,President,Hillary Clinton,DEM,550012,0,0,499,499,
Oklahoma,U.S. Senate,James Lankford,REP,550012,0,0,694,694,
Oklahoma,U.S. Senate,Robert Murphy,LIB,550012,0,0,40,40,
Oklahoma,U.S. Senate,Mike Workman,DEM,550012,0,0,411,411,
Oklahoma,U.S. Senate,Mark Beard,IND,550012,0,0,24,24,
Oklahoma,U.S. Senate,Sean Braddy,IND,550012,0,0,44,44,
Oklahoma,U.S. House,Steve Russell,REP,550012,0,0,666,666,05
Oklahoma,U.S. House,Zachary Knight,LIB,550012,0,0,74,74,05
Oklahoma,U.S. House,Al Mcaffrey,DEM,550012,0,0,458,458,05
Oklahoma,State House,Bruce Lee Smith,REP,550012,0,0,614,614,87
Oklahoma,State House,Elle Collins,LIB,550012,0,0,66,66,87
Oklahoma,State House,Collin Walke,DEM,550012,0,0,524,524,87
Oklahoma,President,Donald Trump,REP,550013,0,0,478,478,
Oklahoma,President,Gary Johnson,LIB,550013,0,0,80,80,
Oklahoma,President,Hillary Clinton,DEM,550013,0,0,250,250,
Oklahoma,U.S. Senate,James Lankford,REP,550013,0,0,515,515,
Oklahoma,U.S. Senate,Robert Murphy,LIB,550013,0,0,43,43,
Oklahoma,U.S. Senate,Mike Workman,DEM,550013,0,0,185,185,
Oklahoma,U.S. Senate,Mark Beard,IND,550013,0,0,22,22,
Oklahoma,U.S. Senate,Sean Braddy,IND,550013,0,0,33,33,
Oklahoma,U.S. House,Steve Russell,REP,550013,0,0,492,492,05
Oklahoma,U.S. House,Zachary Knight,LIB,550013,0,0,77,77,05
Oklahoma,U.S. House,Al Mcaffrey,DEM,550013,0,0,220,220,05
Oklahoma,State House,Elise Hall,REP,550013,0,0,426,426,10
Oklahoma,State House,Christina Wright,LIB,550013,0,0,69,69,10
Oklahoma,State House,Donald Wentroth Jr.,DEM,550013,0,0,303,303,10
Oklahoma,President,Donald Trump,REP,550014,0,0,427,427,
Oklahoma,President,Gary Johnson,LIB,550014,0,0,55,55,
Oklahoma,President,Hillary Clinton,DEM,550014,0,0,285,285,
Oklahoma,U.S. Senate,James Lankford,REP,550014,0,0,466,466,
Oklahoma,U.S. Senate,Robert Murphy,LIB,550014,0,0,31,31,
Oklahoma,U.S. Senate,Mike Workman,DEM,550014,0,0,230,230,
Oklahoma,U.S. Senate,Mark Beard,IND,550014,0,0,18,18,
Oklahoma,U.S. Senate,Sean Braddy,IND,550014,0,0,24,24,
Oklahoma,U.S. House,Steve Russell,REP,550014,0,0,437,437,05
Oklahoma,U.S. House,Zachary Knight,LIB,550014,0,0,62,62,05
Oklahoma,U.S. House,Al Mcaffrey,DEM,550014,0,0,263,263,05
Oklahoma,State House,Bruce Lee Smith,REP,550014,0,0,396,396,87
Oklahoma,State House,Elle Collins,LIB,550014,0,0,53,53,87
Oklahoma,State House,Collin Walke,DEM,550014,0,0,310,310,87
Oklahoma,President,Donald Trump,REP,550015,0,0,518,518,
Oklahoma,President,Gary Johnson,LIB,550015,0,0,83,83,
Oklahoma,President,Hillary Clinton,DEM,550015,0,0,356,356,
Oklahoma,U.S. Senate,James Lankford,REP,550015,0,0,573,573,
Oklahoma,U.S. Senate,Robert Murphy,LIB,550015,0,0,39,39,
Oklahoma,U.S. Senate,Mike Workman,DEM,550015,0,0,285,285,
Oklahoma,U.S. Senate,Mark Beard,IND,550015,0,0,20,20,
Oklahoma,U.S. Senate,Sean Braddy,IND,550015,0,0,44,44,
Oklahoma,U.S. House,Steve Russell,REP,550015,0,0,544,544,05
Oklahoma,U.S. House,Zachary Knight,LIB,550015,0,0,69,69,05
Oklahoma,U.S. House,Al Mcaffrey,DEM,550015,0,0,341,341,05
Oklahoma,State House,Bruce Lee Smith,REP,550015,0,0,523,523,87
Oklahoma,State House,Elle Collins,LIB,550015,0,0,61,61,87
Oklahoma,State House,Collin Walke,DEM,550015,0,0,367,367,87
Oklahoma,President,Donald Trump,REP,550016,0,0,110,110,
Oklahoma,President,Gary Johnson,LIB,550016,0,0,16,16,
Oklahoma,President,Hillary Clinton,DEM,550016,0,0,80,80,
Oklahoma,U.S. Senate,James Lankford,REP,550016,0,0,128,128,
Oklahoma,U.S. Senate,Robert Murphy,LIB,550016,0,0,13,13,
Oklahoma,U.S. Senate,Mike Workman,DEM,550016,0,0,55,55,
Oklahoma,U.S. Senate,Mark Beard,IND,550016,0,0,0,0,
Oklahoma,U.S. Senate,Sean Braddy,IND,550016,0,0,8,8,
Oklahoma,U.S. House,Steve Russell,REP,550016,0,0,126,126,05
Oklahoma,U.S. House,Zachary Knight,LIB,550016,0,0,15,15,05
Oklahoma,U.S. House,Al Mcaffrey,DEM,550016,0,0,61,61,05
Oklahoma,State House,Matt Jackson,REP,550016,0,0,103,103,85
Oklahoma,State House,Cyndi Munson,DEM,550016,0,0,98,98,85
Oklahoma,President,Donald Trump,REP,550017,0,0,0,0,
Oklahoma,President,Gary Johnson,LIB,550017,0,0,0,0,
Oklahoma,President,Hillary Clinton,DEM,550017,0,0,0,0,
Oklahoma,U.S. Senate,James Lankford,REP,550017,0,0,0,0,
Oklahoma,U.S. Senate,Robert Murphy,LIB,550017,0,0,0,0,
Oklahoma,U.S. Senate,Mike Workman,DEM,550017,0,0,0,0,
Oklahoma,U.S. Senate,Mark Beard,IND,550017,0,0,0,0,
Oklahoma,U.S. Senate,Sean Braddy,IND,550017,0,0,0,0,
Oklahoma,U.S. House,Steve Russell,REP,550017,0,0,0,0,05
Oklahoma,U.S. House,Zachary Knight,LIB,550017,0,0,0,0,05
Oklahoma,U.S. House,Al Mcaffrey,DEM,550017,0,0,0,0,05
Oklahoma,State House,Matt Jackson,REP,550017,0,0,0,0,85
Oklahoma,State House,Cyndi Munson,DEM,550017,0,0,0,0,85
Oklahoma,President,Donald Trump,REP,550018,0,0,262,262,
Oklahoma,President,Gary Johnson,LIB,550018,0,0,28,28,
Oklahoma,President,Hillary Clinton,DEM,550018,0,0,75,75,
Oklahoma,U.S. Senate,James Lankford,REP,550018,0,0,294,294,
Oklahoma,U.S. Senate,Robert Murphy,LIB,550018,0,0,5,5,
Oklahoma,U.S. Senate,Mike Workman,DEM,550018,0,0,51,51,
Oklahoma,U.S. Senate,Mark Beard,IND,550018,0,0,5,5,
Oklahoma,U.S. Senate,Sean Braddy,IND,550018,0,0,9,9,
Oklahoma,U.S. House,Steve Russell,REP,550018,0,0,271,271,05
Oklahoma,U.S. House,Zachary Knight,LIB,550018,0,0,21,21,05
Oklahoma,U.S. House,Al Mcaffrey,DEM,550018,0,0,67,67,05
Oklahoma,President,Donald Trump,REP,550019,0,0,666,666,
Oklahoma,President,Gary Johnson,LIB,550019,0,0,45,45,
Oklahoma,President,Hillary Clinton,DEM,550019,0,0,180,180,
Oklahoma,U.S. Senate,James Lankford,REP,550019,0,0,689,689,
Oklahoma,U.S. Senate,Robert Murphy,LIB,550019,0,0,33,33,
Oklahoma,U.S. Senate,Mike Workman,DEM,550019,0,0,135,135,
Oklahoma,U.S. Senate,Mark Beard,IND,550019,0,0,12,12,
Oklahoma,U.S. Senate,Sean Braddy,IND,550019,0,0,21,21,
Oklahoma,U.S. House,Steve Russell,REP,550019,0,0,657,657,05
Oklahoma,U.S. House,Zachary Knight,LIB,550019,0,0,60,60,05
Oklahoma,U.S. House,Al Mcaffrey,DEM,550019,0,0,167,167,05
Oklahoma,President,Donald Trump,REP,550020,0,0,1050,1050,
Oklahoma,President,Gary Johnson,LIB,550020,0,0,77,77,
Oklahoma,President,Hillary Clinton,DEM,550020,0,0,230,230,
Oklahoma,U.S. Senate,James Lankford,REP,550020,0,0,1071,1071,
Oklahoma,U.S. Senate,Robert Murphy,LIB,550020,0,0,40,40,
Oklahoma,U.S. Senate,Mike Workman,DEM,550020,0,0,184,184,
Oklahoma,U.S. Senate,Mark Beard,IND,550020,0,0,23,23,
Oklahoma,U.S. Senate,Sean Braddy,IND,550020,0,0,36,36,
Oklahoma,U.S. House,Steve Russell,REP,550020,0,0,1027,1027,05
Oklahoma,U.S. House,Zachary Knight,LIB,550020,0,0,77,77,05
Oklahoma,U.S. House,Al Mcaffrey,DEM,550020,0,0,234,234,05
Oklahoma,President,Donald Trump,REP,550021,0,0,1066,1066,
Oklahoma,President,Gary Johnson,LIB,550021,0,0,101,101,
Oklahoma,President,Hillary Clinton,DEM,550021,0,0,303,303,
Oklahoma,U.S. Senate,James Lankford,REP,550021,0,0,1122,1122,
Oklahoma,U.S. Senate,Robert Murphy,LIB,550021,0,0,49,49,
Oklahoma,U.S. Senate,Mike Workman,DEM,550021,0,0,227,227,
Oklahoma,U.S. Senate,Mark Beard,IND,550021,0,0,38,38,
Oklahoma,U.S. Senate,Sean Braddy,IND,550021,0,0,34,34,
Oklahoma,U.S. House,Steve Russell,REP,550021,0,0,1087,1087,05
Oklahoma,U.S. House,Zachary Knight,LIB,550021,0,0,97,97,05
Oklahoma,U.S. House,Al Mcaffrey,DEM,550021,0,0,272,272,05
Oklahoma,State House,Tess Teague,REP,550021,0,0,1046,1046,10
Oklahoma,State House,Cheryl Hessman,DEM,550021,0,0,409,409,10
Oklahoma,President,Donald Trump,REP,550022,0,0,584,584,
Oklahoma,President,Gary Johnson,LIB,550022,0,0,48,48,
Oklahoma,President,Hillary Clinton,DEM,550022,0,0,162,162,
Oklahoma,U.S. Senate,James Lankford,REP,550022,0,0,612,612,
Oklahoma,U.S. Senate,Robert Murphy,LIB,550022,0,0,29,29,
Oklahoma,U.S. Senate,Mike Workman,DEM,550022,0,0,121,121,
Oklahoma,U.S. Senate,Mark Beard,IND,550022,0,0,10,10,
Oklahoma,U.S. Senate,Sean Braddy,IND,550022,0,0,20,20,
Oklahoma,U.S. House,Tom Cole,REP,550022,0,0,604,604,04
Oklahoma,U.S. House,Sevier White,LIB,550022,0,0,44,44,04
Oklahoma,U.S. House,Christina Owen,DEM,550022,0,0,143,143,04
Oklahoma,State House,Tess Teague,REP,550022,0,0,562,562,10
Oklahoma,State House,Cheryl Hessman,DEM,550022,0,0,216,216,10
Oklahoma,President,Donald Trump,REP,550023,0,0,830,830,
Oklahoma,President,Gary Johnson,LIB,550023,0,0,93,93,
Oklahoma,President,Hillary Clinton,DEM,550023,0,0,228,228,
Oklahoma,U.S. Senate,James Lankford,REP,550023,0,0,889,889,
Oklahoma,U.S. Senate,Robert Murphy,LIB,550023,0,0,43,43,
Oklahoma,U.S. Senate,Mike Workman,DEM,550023,0,0,165,165,
Oklahoma,U.S. Senate,Mark Beard,IND,550023,0,0,20,20,
Oklahoma,U.S. Senate,Sean Braddy,IND,550023,0,0,37,37,
Oklahoma,U.S. House,Tom Cole,REP,550023,0,0,866,866,04
Oklahoma,U.S. House,Sevier White,LIB,550023,0,0,60,60,04
Oklahoma,U.S. House,Christina Owen,DEM,550023,0,0,217,217,04
Oklahoma,State House,Tess Teague,REP,550023,0,0,776,776,10
Oklahoma,State House,Cheryl Hessman,DEM,550023,0,0,362,362,10
Oklahoma,President,Donald Trump,REP,550024,0,0,62,62,
Oklahoma,President,Gary Johnson,LIB,550024,0,0,3,3,
Oklahoma,President,Hillary Clinton,DEM,550024,0,0,15,15,
Oklahoma,U.S. Senate,James Lankford,REP,550024,0,0,65,65,
Oklahoma,U.S. Senate,Robert Murphy,LIB,550024,0,0,0,0,
Oklahoma,U.S. Senate,Mike Workman,DEM,550024,0,0,11,11,
Oklahoma,U.S. Senate,Mark Beard,IND,550024,0,0,0,0,
Oklahoma,U.S. Senate,Sean Braddy,IND,550024,0,0,3,3,
Oklahoma,U.S. House,Steve Russell,REP,550024,0,0,59,59,05
Oklahoma,U.S. House,Zachary Knight,LIB,550024,0,0,2,2,05
Oklahoma,U.S. House,Al Mcaffrey,DEM,550024,0,0,18,18,05
Oklahoma,President,Donald Trump,REP,550025,0,0,223,223,
Oklahoma,President,Gary Johnson,LIB,550025,0,0,16,16,
Oklahoma,President,Hillary Clinton,DEM,550025,0,0,147,147,
Oklahoma,U.S. Senate,James Lankford,REP,550025,0,0,226,226,
Oklahoma,U.S. Senate,Robert Murphy,LIB,550025,0,0,11,11,
Oklahoma,U.S. Senate,Mike Workman,DEM,550025,0,0,129,129,
Oklahoma,U.S. Senate,Mark Beard,IND,550025,0,0,9,9,
Oklahoma,U.S. Senate,Sean Braddy,IND,550025,0,0,10,10,
Oklahoma,U.S. House,Steve Russell,REP,550025,0,0,215,215,05
Oklahoma,U.S. House,Zachary Knight,LIB,550025,0,0,28,28,05
Oklahoma,U.S. House,Al Mcaffrey,DEM,550025,0,0,138,138,05
Oklahoma,State House,Tonni Canaday,REP,550025,0,0,215,215,97
Oklahoma,State House,Jason Lowe,DEM,550025,0,0,164,164,97
Oklahoma,President,Donald Trump,REP,550026,0,0,526,526,
Oklahoma,President,Gary Johnson,LIB,550026,0,0,57,57,
Oklahoma,President,Hillary Clinton,DEM,550026,0,0,118,118,
Oklahoma,U.S. Senate,James Lankford,REP,550026,0,0,524,524,
Oklahoma,U.S. Senate,Robert Murphy,LIB,550026,0,0,34,34,
Oklahoma,U.S. Senate,Mike Workman,DEM,550026,0,0,105,105,
Oklahoma,U.S. Senate,Mark Beard,IND,550026,0,0,12,12,
Oklahoma,U.S. Senate,Sean Braddy,IND,550026,0,0,21,21,
Oklahoma,U.S. House,Tom Cole,REP,550026,0,0,531,531,04
Oklahoma,U.S. House,Sevier White,LIB,550026,0,0,44,44,04
Oklahoma,U.S. House,Christina Owen,DEM,550026,0,0,121,121,04
Oklahoma,State House,Tess Teague,REP,550026,0,0,503,503,10
Oklahoma,State House,Cheryl Hessman,DEM,550026,0,0,180,180,10
Oklahoma,President,Donald Trump,REP,550027,0,0,123,123,
Oklahoma,President,Gary Johnson,LIB,550027,0,0,8,8,
Oklahoma,President,Hillary Clinton,DEM,550027,0,0,40,40,
Oklahoma,U.S. Senate,James Lankford,REP,550027,0,0,130,130,
Oklahoma,U.S. Senate,Robert Murphy,LIB,550027,0,0,3,3,
Oklahoma,U.S. Senate,Mike Workman,DEM,550027,0,0,28,28,
Oklahoma,U.S. Senate,Mark Beard,IND,550027,0,0,1,1,
Oklahoma,U.S. Senate,Sean Braddy,IND,550027,0,0,9,9,
Oklahoma,U.S. House,Tom Cole,REP,550027,0,0,121,121,04
Oklahoma,U.S. House,Sevier White,LIB,550027,0,0,10,10,04
Oklahoma,U.S. House,Christina Owen,DEM,550027,0,0,38,38,04
Oklahoma,State House,Tess Teague,REP,550027,0,0,120,120,10
Oklahoma,State House,Cheryl Hessman,DEM,550027,0,0,48,48,10
Oklahoma,President,Donald Trump,REP,550028,0,0,376,376,
Oklahoma,President,Gary Johnson,LIB,550028,0,0,58,58,
Oklahoma,President,Hillary Clinton,DEM,550028,0,0,503,503,
Oklahoma,U.S. Senate,James Lankford,REP,550028,0,0,422,422,
Oklahoma,U.S. Senate,Robert Murphy,LIB,550028,0,0,37,37,
Oklahoma,U.S. Senate,Mike Workman,DEM,550028,0,0,410,410,
Oklahoma,U.S. Senate,Mark Beard,IND,550028,0,0,23,23,
Oklahoma,U.S. Senate,Sean Braddy,IND,550028,0,0,44,44,
Oklahoma,U.S. House,Steve Russell,REP,550028,0,0,392,392,05
Oklahoma,U.S. House,Zachary Knight,LIB,550028,0,0,63,63,05
Oklahoma,U.S. House,Al Mcaffrey,DEM,550028,0,0,477,477,05
Oklahoma,State House,Jason Sansone,REP,550028,0,0,287,287,94
Oklahoma,State House,Scott Inman,DEM,550028,0,0,644,644,94
Oklahoma,President,Donald Trump,REP,550029,0,0,729,729,
Oklahoma,President,Gary Johnson,LIB,550029,0,0,106,106,
Oklahoma,President,Hillary Clinton,DEM,550029,0,0,400,400,
Oklahoma,U.S. Senate,James Lankford,REP,550029,0,0,739,739,
Oklahoma,U.S. Senate,Robert Murphy,LIB,550029,0,0,49,49,
Oklahoma,U.S. Senate,Mike Workman,DEM,550029,0,0,343,343,
Oklahoma,U.S. Senate,Mark Beard,IND,550029,0,0,42,42,
Oklahoma,U.S. Senate,Sean Braddy,IND,550029,0,0,55,55,
Oklahoma,U.S. House,Steve Russell,REP,550029,0,0,733,733,05
Oklahoma,U.S. House,Zachary Knight,LIB,550029,0,0,94,94,05
Oklahoma,U.S. House,Al Mcaffrey,DEM,550029,0,0,387,387,05
Oklahoma,State House,Jason Sansone,REP,550029,0,0,556,556,94
Oklahoma,State House,Scott Inman,DEM,550029,0,0,670,670,94
Oklahoma,President,Donald Trump,REP,550030,0,0,512,512,
Oklahoma,President,Gary Johnson,LIB,550030,0,0,72,72,
Oklahoma,President,Hillary Clinton,DEM,550030,0,0,366,366,
Oklahoma,U.S. Senate,James Lankford,REP,550030,0,0,545,545,
Oklahoma,U.S. Senate,Robert Murphy,LIB,550030,0,0,27,27,
Oklahoma,U.S. Senate,Mike Workman,DEM,550030,0,0,309,309,
Oklahoma,U.S. Senate,Mark Beard,IND,550030,0,0,31,31,
Oklahoma,U.S. Senate,Sean Braddy,IND,550030,0,0,34,34,
Oklahoma,U.S. House,Steve Russell,REP,550030,0,0,510,510,05
Oklahoma,U.S. House,Zachary Knight,LIB,550030,0,0,72,72,05
Oklahoma,U.S. House,Al Mcaffrey,DEM,550030,0,0,358,358,05
Oklahoma,State House,Jason Sansone,REP,550030,0,0,384,384,94
Oklahoma,State House,Scott Inman,DEM,550030,0,0,553,553,94
Oklahoma,President,Donald Trump,REP,550031,0,0,608,608,
Oklahoma,President,Gary Johnson,LIB,550031,0,0,80,80,
Oklahoma,President,Hillary Clinton,DEM,550031,0,0,408,408,
Oklahoma,U.S. Senate,James Lankford,REP,550031,0,0,670,670,
Oklahoma,U.S. Senate,Robert Murphy,LIB,550031,0,0,36,36,
Oklahoma,U.S. Senate,Mike Workman,DEM,550031,0,0,335,335,
Oklahoma,U.S. Senate,Mark Beard,IND,550031,0,0,23,23,
Oklahoma,U.S. Senate,Sean Braddy,IND,550031,0,0,29,29,
Oklahoma,U.S. House,Steve Russell,REP,550031,0,0,644,644,05
Oklahoma,U.S. House,Zachary Knight,LIB,550031,0,0,59,59,05
Oklahoma,U.S. House,Al Mcaffrey,DEM,550031,0,0,385,385,05
Oklahoma,State House,Jason Sansone,REP,550031,0,0,451,451,94
Oklahoma,State House,Scott Inman,DEM,550031,0,0,641,641,94
Oklahoma,President,Donald Trump,REP,550032,0,0,478,478,
Oklahoma,President,Gary Johnson,LIB,550032,0,0,58,58,
Oklahoma,President,Hillary Clinton,DEM,550032,0,0,215,215,
Oklahoma,U.S. Senate,James Lankford,REP,550032,0,0,498,498,
Oklahoma,U.S. Senate,Robert Murphy,LIB,550032,0,0,29,29,
Oklahoma,U.S. Senate,Mike Workman,DEM,550032,0,0,164,164,
Oklahoma,U.S. Senate,Mark Beard,IND,550032,0,0,20,20,
Oklahoma,U.S. Senate,Sean Braddy,IND,550032,0,0,32,32,
Oklahoma,U.S. House,Steve Russell,REP,550032,0,0,484,484,05
Oklahoma,U.S. House,Zachary Knight,LIB,550032,0,0,58,58,05
Oklahoma,U.S. House,Al Mcaffrey,DEM,550032,0,0,193,193,05
Oklahoma,State House,Jason Sansone,REP,550032,0,0,339,339,94
Oklahoma,State House,Scott Inman,DEM,550032,0,0,401,401,94
Oklahoma,President,Donald Trump,REP,550033,0,0,876,876,
Oklahoma,President,Gary Johnson,LIB,550033,0,0,141,141,
Oklahoma,President,Hillary Clinton,DEM,550033,0,0,516,516,
Oklahoma,U.S. Senate,James Lankford,REP,550033,0,0,939,939,
Oklahoma,U.S. Senate,Robert Murphy,LIB,550033,0,0,73,73,
Oklahoma,U.S. Senate,Mike Workman,DEM,550033,0,0,422,422,
Oklahoma,U.S. Senate,Mark Beard,IND,550033,0,0,33,33,
Oklahoma,U.S. Senate,Sean Braddy,IND,550033,0,0,63,63,
Oklahoma,U.S. House,Steve Russell,REP,550033,0,0,931,931,05
Oklahoma,U.S. House,Zachary Knight,LIB,550033,0,0,123,123,05
Oklahoma,U.S. House,Al Mcaffrey,DEM,550033,0,0,466,466,05
Oklahoma,State House,Jason Sansone,REP,550033,0,0,600,600,94
Oklahoma,State House,Scott Inman,DEM,550033,0,0,925,925,94
Oklahoma,President,Donald Trump,REP,550034,0,0,727,727,
Oklahoma,President,Gary Johnson,LIB,550034,0,0,58,58,
Oklahoma,President,Hillary Clinton,DEM,550034,0,0,165,165,
Oklahoma,U.S. Senate,James Lankford,REP,550034,0,0,791,791,
Oklahoma,U.S. Senate,Robert Murphy,LIB,550034,0,0,33,33,
Oklahoma,U.S. Senate,Mike Workman,DEM,550034,0,0,108,108,
Oklahoma,U.S. Senate,Mark Beard,IND,550034,0,0,9,9,
Oklahoma,U.S. Senate,Sean Braddy,IND,550034,0,0,15,15,
Oklahoma,U.S. House,Steve Russell,REP,550034,0,0,746,746,05
Oklahoma,U.S. House,Zachary Knight,LIB,550034,0,0,49,49,05
Oklahoma,U.S. House,Al Mcaffrey,DEM,550034,0,0,152,152,05
Oklahoma,State House,Jason Murphey,REP,550034,0,0,765,765,31
Oklahoma,State House,John Tiller,DEM,550034,0,0,165,165,31
Oklahoma,President,Donald Trump,REP,550035,0,0,1226,1226,
Oklahoma,President,Gary Johnson,LIB,550035,0,0,156,156,
Oklahoma,President,Hillary Clinton,DEM,550035,0,0,547,547,
Oklahoma,U.S. Senate,James Lankford,REP,550035,0,0,1382,1382,
Oklahoma,U.S. Senate,Robert Murphy,LIB,550035,0,0,77,77,
Oklahoma,U.S. Senate,Mike Workman,DEM,550035,0,0,406,406,
Oklahoma,U.S. Senate,Mark Beard,IND,550035,0,0,27,27,
Oklahoma,U.S. Senate,Sean Braddy,IND,550035,0,0,42,42,
Oklahoma,U.S. House,Steve Russell,REP,550035,0,0,1309,1309,05
Oklahoma,U.S. House,Zachary Knight,LIB,550035,0,0,132,132,05
Oklahoma,U.S. House,Al Mcaffrey,DEM,550035,0,0,476,476,05
Oklahoma,State House,Kevin Calvey,REP,550035,0,0,1208,1208,82
Oklahoma,State House,Misty Warfield,DEM,550035,0,0,521,521,82
Oklahoma,State House,Christopher Crawford,IND,550035,0,0,132,132,82
Oklahoma,State House,David Dickerson,IND,550035,0,0,32,32,82
Oklahoma,President,Donald Trump,REP,550036,0,0,770,770,
Oklahoma,President,Gary Johnson,LIB,550036,0,0,60,60,
Oklahoma,President,Hillary Clinton,DEM,550036,0,0,245,245,
Oklahoma,U.S. Senate,James Lankford,REP,550036,0,0,843,843,
Oklahoma,U.S. Senate,Robert Murphy,LIB,550036,0,0,32,32,
Oklahoma,U.S. Senate,Mike Workman,DEM,550036,0,0,170,170,
Oklahoma,U.S. Senate,Mark Beard,IND,550036,0,0,19,19,
Oklahoma,U.S. Senate,Sean Braddy,IND,550036,0,0,15,15,
Oklahoma,U.S. House,Steve Russell,REP,550036,0,0,821,821,05
Oklahoma,U.S. House,Zachary Knight,LIB,550036,0,0,46,46,05
Oklahoma,U.S. House,Al Mcaffrey,DEM,550036,0,0,201,201,05
Oklahoma,State House,Ryan Martinez,REP,550036,0,0,844,844,39
Oklahoma,State House,Clark Duffe,LIB,550036,0,0,175,175,39
Oklahoma,President,Donald Trump,REP,550037,0,0,660,660,
Oklahoma,President,Gary Johnson,LIB,550037,0,0,89,89,
Oklahoma,President,Hillary Clinton,DEM,550037,0,0,288,288,
Oklahoma,U.S. Senate,James Lankford,REP,550037,0,0,761,761,
Oklahoma,U.S. Senate,Robert Murphy,LIB,550037,0,0,41,41,
Oklahoma,U.S. Senate,Mike Workman,DEM,550037,0,0,207,207,
Oklahoma,U.S. Senate,Mark Beard,IND,550037,0,0,21,21,
Oklahoma,U.S. Senate,Sean Braddy,IND,550037,0,0,18,18,
Oklahoma,U.S. House,Steve Russell,REP,550037,0,0,717,717,05
Oklahoma,U.S. House,Zachary Knight,LIB,550037,0,0,68,68,05
Oklahoma,U.S. House,Al Mcaffrey,DEM,550037,0,0,255,255,05
Oklahoma,State House,Ryan Martinez,REP,550037,0,0,769,769,39
Oklahoma,State House,Clark Duffe,LIB,550037,0,0,215,215,39
Oklahoma,President,Donald Trump,REP,550038,0,0,533,533,
Oklahoma,President,Gary Johnson,LIB,550038,0,0,78,78,
Oklahoma,President,Hillary Clinton,DEM,550038,0,0,308,308,
Oklahoma,U.S. Senate,James Lankford,REP,550038,0,0,588,588,
Oklahoma,U.S. Senate,Robert Murphy,LIB,550038,0,0,45,45,
Oklahoma,U.S. Senate,Mike Workman,DEM,550038,0,0,238,238,
Oklahoma,U.S. Senate,Mark Beard,IND,550038,0,0,21,21,
Oklahoma,U.S. Senate,Sean Braddy,IND,550038,0,0,29,29,
Oklahoma,U.S. House,Steve Russell,REP,550038,0,0,582,582,05
Oklahoma,U.S. House,Zachary Knight,LIB,550038,0,0,66,66,05
Oklahoma,U.S. House,Al Mcaffrey,DEM,550038,0,0,265,265,05
Oklahoma,State House,Ryan Martinez,REP,550038,0,0,604,604,39
Oklahoma,State House,Clark Duffe,LIB,550038,0,0,246,246,39
Oklahoma,President,Donald Trump,REP,550039,0,0,685,685,
Oklahoma,President,Gary Johnson,LIB,550039,0,0,91,91,
Oklahoma,President,Hillary Clinton,DEM,550039,0,0,378,378,
Oklahoma,U.S. Senate,James Lankford,REP,550039,0,0,778,778,
Oklahoma,U.S. Senate,Robert Murphy,LIB,550039,0,0,40,40,
Oklahoma,U.S. Senate,Mike Workman,DEM,550039,0,0,282,282,
Oklahoma,U.S. Senate,Mark Beard,IND,550039,0,0,16,16,
Oklahoma,U.S. Senate,Sean Braddy,IND,550039,0,0,42,42,
Oklahoma,U.S. House,Steve Russell,REP,550039,0,0,745,745,05
Oklahoma,U.S. House,Zachary Knight,LIB,550039,0,0,67,67,05
Oklahoma,U.S. House,Al Mcaffrey,DEM,550039,0,0,339,339,05
Oklahoma,State Senate,Greg Treat,REP,550039,0,0,680,680,47
Oklahoma,State Senate,Judy Mullen Hopper,DEM,550039,0,0,391,391,47
Oklahoma,State Senate,Steven Weber,IND,550039,0,0,76,76,47
Oklahoma,President,Donald Trump,REP,550040,0,0,864,864,
Oklahoma,President,Gary Johnson,LIB,550040,0,0,146,146,
Oklahoma,President,Hillary Clinton,DEM,550040,0,0,484,484,
Oklahoma,U.S. Senate,James Lankford,REP,550040,0,0,995,995,
Oklahoma,U.S. Senate,Robert Murphy,LIB,550040,0,0,74,74,
Oklahoma,U.S. Senate,Mike Workman,DEM,550040,0,0,354,354,
Oklahoma,U.S. Senate,Mark Beard,IND,550040,0,0,28,28,
Oklahoma,U.S. Senate,Sean Braddy,IND,550040,0,0,40,40,
Oklahoma,U.S. House,Steve Russell,REP,550040,0,0,949,949,05
Oklahoma,U.S. House,Zachary Knight,LIB,550040,0,0,118,118,05
Oklahoma,U.S. House,Al Mcaffrey,DEM,550040,0,0,418,418,05
Oklahoma,State House,Ryan Martinez,REP,550040,0,0,1005,1005,39
Oklahoma,State House,Clark Duffe,LIB,550040,0,0,383,383,39
Oklahoma,President,Donald Trump,REP,550041,0,0,622,622,
Oklahoma,President,Gary Johnson,LIB,550041,0,0,111,111,
Oklahoma,President,Hillary Clinton,DEM,550041,0,0,384,384,
Oklahoma,U.S. Senate,James Lankford,REP,550041,0,0,717,717,
Oklahoma,U.S. Senate,Robert Murphy,LIB,550041,0,0,52,52,
Oklahoma,U.S. Senate,Mike Workman,DEM,550041,0,0,290,290,
Oklahoma,U.S. Senate,Mark Beard,IND,550041,0,0,25,25,
Oklahoma,U.S. Senate,Sean Braddy,IND,550041,0,0,34,34,
Oklahoma,U.S. House,Steve Russell,REP,550041,0,0,682,682,05
Oklahoma,U.S. House,Zachary Knight,LIB,550041,0,0,90,90,05
Oklahoma,U.S. House,Al Mcaffrey,DEM,550041,0,0,333,333,05
Oklahoma,State House,Ryan Martinez,REP,550041,0,0,748,748,39
Oklahoma,State House,Clark Duffe,LIB,550041,0,0,298,298,39
Oklahoma,President,Donald Trump,REP,550042,0,0,920,920,
Oklahoma,President,Gary Johnson,LIB,550042,0,0,102,102,
Oklahoma,President,Hillary Clinton,DEM,550042,0,0,386,386,
Oklahoma,U.S. Senate,James Lankford,REP,550042,0,0,1021,1021,
Oklahoma,U.S. Senate,Robert Murphy,LIB,550042,0,0,60,60,
Oklahoma,U.S. Senate,Mike Workman,DEM,550042,0,0,281,281,
Oklahoma,U.S. Senate,Mark Beard,IND,550042,0,0,27,27,
Oklahoma,U.S. Senate,Sean Braddy,IND,550042,0,0,37,37,
Oklahoma,U.S. House,Steve Russell,REP,550042,0,0,995,995,05
Oklahoma,U.S. House,Zachary Knight,LIB,550042,0,0,109,109,05
Oklahoma,U.S. House,Al Mcaffrey,DEM,550042,0,0,318,318,05
Oklahoma,State Senate,Adam Pugh,REP,550042,0,0,939,939,41
Oklahoma,State Senate,Richard Prawdzienski,LIB,550042,0,0,75,75,41
Oklahoma,State Senate,Kevin Mcdonald,DEM,550042,0,0,402,402,41
Oklahoma,State House,Ryan Martinez,REP,550042,0,0,1049,1049,39
Oklahoma,State House,Clark Duffe,LIB,550042,0,0,293,293,39
Oklahoma,President,Donald Trump,REP,550043,0,0,1291,1291,
Oklahoma,President,Gary Johnson,LIB,550043,0,0,101,101,
Oklahoma,President,Hillary Clinton,DEM,550043,0,0,318,318,
Oklahoma,U.S. Senate,James Lankford,REP,550043,0,0,1397,1397,
Oklahoma,U.S. Senate,Robert Murphy,LIB,550043,0,0,46,46,
Oklahoma,U.S. Senate,Mike Workman,DEM,550043,0,0,230,230,
Oklahoma,U.S. Senate,Mark Beard,IND,550043,0,0,19,19,
Oklahoma,U.S. Senate,Sean Braddy,IND,550043,0,0,25,25,
Oklahoma,U.S. House,Steve Russell,REP,550043,0,0,1382,1382,05
Oklahoma,U.S. House,Zachary Knight,LIB,550043,0,0,65,65,05
Oklahoma,U.S. House,Al Mcaffrey,DEM,550043,0,0,259,259,05
Oklahoma,State Senate,Adam Pugh,REP,550043,0,0,1283,1283,41
Oklahoma,State Senate,Richard Prawdzienski,LIB,550043,0,0,60,60,41
Oklahoma,State Senate,Kevin Mcdonald,DEM,550043,0,0,357,357,41
Oklahoma,State House,Ryan Martinez,REP,550043,0,0,1369,1369,39
Oklahoma,State House,Clark Duffe,LIB,550043,0,0,256,256,39
Oklahoma,President,Donald Trump,REP,550044,0,0,962,962,
Oklahoma,President,Gary Johnson,LIB,550044,0,0,141,141,
Oklahoma,President,Hillary Clinton,DEM,550044,0,0,525,525,
Oklahoma,U.S. Senate,James Lankford,REP,550044,0,0,1097,1097,
Oklahoma,U.S. Senate,Robert Murphy,LIB,550044,0,0,74,74,
Oklahoma,U.S. Senate,Mike Workman,DEM,550044,0,0,393,393,
Oklahoma,U.S. Senate,Mark Beard,IND,550044,0,0,27,27,
Oklahoma,U.S. Senate,Sean Braddy,IND,550044,0,0,37,37,
Oklahoma,U.S. House,Steve Russell,REP,550044,0,0,1051,1051,05
Oklahoma,U.S. House,Zachary Knight,LIB,550044,0,0,125,125,05
Oklahoma,U.S. House,Al Mcaffrey,DEM,550044,0,0,433,433,05
Oklahoma,State Senate,Adam Pugh,REP,550044,0,0,996,996,41
Oklahoma,State Senate,Richard Prawdzienski,LIB,550044,0,0,98,98,41
Oklahoma,State Senate,Kevin Mcdonald,DEM,550044,0,0,515,515,41
Oklahoma,State House,Ryan Martinez,REP,550044,0,0,1106,1106,39
Oklahoma,State House,Clark Duffe,LIB,550044,0,0,407,407,39
Oklahoma,President,Donald Trump,REP,550045,0,0,919,919,
Oklahoma,President,Gary Johnson,LIB,550045,0,0,134,134,
Oklahoma,President,Hillary Clinton,DEM,550045,0,0,379,379,
Oklahoma,U.S. Senate,James Lankford,REP,550045,0,0,1056,1056,
Oklahoma,U.S. Senate,Robert Murphy,LIB,550045,0,0,77,77,
Oklahoma,U.S. Senate,Mike Workman,DEM,550045,0,0,263,263,
Oklahoma,U.S. Senate,Mark Beard,IND,550045,0,0,21,21,
Oklahoma,U.S. Senate,Sean Braddy,IND,550045,0,0,26,26,
Oklahoma,U.S. House,Steve Russell,REP,550045,0,0,1024,1024,05
Oklahoma,U.S. House,Zachary Knight,LIB,550045,0,0,106,106,05
Oklahoma,U.S. House,Al Mcaffrey,DEM,550045,0,0,301,301,05
Oklahoma,State Senate,Adam Pugh,REP,550045,0,0,932,932,41
Oklahoma,State Senate,Richard Prawdzienski,LIB,550045,0,0,88,88,41
Oklahoma,State Senate,Kevin Mcdonald,DEM,550045,0,0,417,417,41
Oklahoma,State House,Ryan Martinez,REP,550045,0,0,1090,1090,39
Oklahoma,State House,Clark Duffe,LIB,550045,0,0,256,256,39
Oklahoma,President,Donald Trump,REP,550046,0,0,344,344,
Oklahoma,President,Gary Johnson,LIB,550046,0,0,99,99,
Oklahoma,President,Hillary Clinton,DEM,550046,0,0,317,317,
Oklahoma,U.S. Senate,James Lankford,REP,550046,0,0,393,393,
Oklahoma,U.S. Senate,Robert Murphy,LIB,550046,0,0,43,43,
Oklahoma,U.S. Senate,Mike Workman,DEM,550046,0,0,242,242,
Oklahoma,U.S. Senate,Mark Beard,IND,550046,0,0,36,36,
Oklahoma,U.S. Senate,Sean Braddy,IND,550046,0,0,42,42,
Oklahoma,U.S. House,Steve Russell,REP,550046,0,0,378,378,05
Oklahoma,U.S. House,Zachary Knight,LIB,550046,0,0,91,91,05
Oklahoma,U.S. House,Al Mcaffrey,DEM,550046,0,0,280,280,05
Oklahoma,State Senate,Adam Pugh,REP,550046,0,0,362,362,41
Oklahoma,State Senate,Richard Prawdzienski,LIB,550046,0,0,77,77,41
Oklahoma,State Senate,Kevin Mcdonald,DEM,550046,0,0,309,309,41
Oklahoma,State House,Mike Osburn,REP,550046,0,0,351,351,81
Oklahoma,State House,Steve Long,LIB,550046,0,0,87,87,81
Oklahoma,State House,Dan Myers,DEM,550046,0,0,307,307,81
Oklahoma,President,Donald Trump,REP,550047,0,0,287,287,
Oklahoma,President,Gary Johnson,LIB,550047,0,0,65,65,
Oklahoma,President,Hillary Clinton,DEM,550047,0,0,266,266,
Oklahoma,U.S. Senate,James Lankford,REP,550047,0,0,337,337,
Oklahoma,U.S. Senate,Robert Murphy,LIB,550047,0,0,31,31,
Oklahoma,U.S. Senate,Mike Workman,DEM,550047,0,0,213,213,
Oklahoma,U.S. Senate,Mark Beard,IND,550047,0,0,14,14,
Oklahoma,U.S. Senate,Sean Braddy,IND,550047,0,0,18,18,
Oklahoma,U.S. House,Steve Russell,REP,550047,0,0,315,315,05
Oklahoma,U.S. House,Zachary Knight,LIB,550047,0,0,55,55,05
Oklahoma,U.S. House,Al Mcaffrey,DEM,550047,0,0,236,236,05
Oklahoma,State Senate,Adam Pugh,REP,550047,0,0,286,286,41
Oklahoma,State Senate,Richard Prawdzienski,LIB,550047,0,0,49,49,41
Oklahoma,State Senate,Kevin Mcdonald,DEM,550047,0,0,269,269,41
Oklahoma,State House,Mike Osburn,REP,550047,0,0,266,266,81
Oklahoma,State House,Steve Long,LIB,550047,0,0,66,66,81
Oklahoma,State House,Dan Myers,DEM,550047,0,0,266,266,81
Oklahoma,President,Donald Trump,REP,550048,0,0,495,495,
Oklahoma,President,Gary Johnson,LIB,550048,0,0,78,78,
Oklahoma,President,Hillary Clinton,DEM,550048,0,0,326,326,
Oklahoma,U.S. Senate,James Lankford,REP,550048,0,0,535,535,
Oklahoma,U.S. Senate,Robert Murphy,LIB,550048,0,0,55,55,
Oklahoma,U.S. Senate,Mike Workman,DEM,550048,0,0,231,231,
Oklahoma,U.S. Senate,Mark Beard,IND,550048,0,0,22,22,
Oklahoma,U.S. Senate,Sean Braddy,IND,550048,0,0,41,41,
Oklahoma,U.S. House,Steve Russell,REP,550048,0,0,511,511,05
Oklahoma,U.S. House,Zachary Knight,LIB,550048,0,0,78,78,05
Oklahoma,U.S. House,Al Mcaffrey,DEM,550048,0,0,293,293,05
Oklahoma,State Senate,Adam Pugh,REP,550048,0,0,465,465,41
Oklahoma,State Senate,Richard Prawdzienski,LIB,550048,0,0,71,71,41
Oklahoma,State Senate,Kevin Mcdonald,DEM,550048,0,0,342,342,41
Oklahoma,State House,Ryan Martinez,REP,550048,0,0,550,550,39
Oklahoma,State House,Clark Duffe,LIB,550048,0,0,274,274,39
Oklahoma,President,Donald Trump,REP,550049,0,0,349,349,
Oklahoma,President,Gary Johnson,LIB,550049,0,0,58,58,
Oklahoma,President,Hillary Clinton,DEM,550049,0,0,287,287,
Oklahoma,U.S. Senate,James Lankford,REP,550049,0,0,390,390,
Oklahoma,U.S. Senate,Robert Murphy,LIB,550049,0,0,36,36,
Oklahoma,U.S. Senate,Mike Workman,DEM,550049,0,0,220,220,
Oklahoma,U.S. Senate,Mark Beard,IND,550049,0,0,18,18,
Oklahoma,U.S. Senate,Sean Braddy,IND,550049,0,0,28,28,
Oklahoma,U.S. House,Steve Russell,REP,550049,0,0,371,371,05
Oklahoma,U.S. House,Zachary Knight,LIB,550049,0,0,71,71,05
Oklahoma,U.S. House,Al Mcaffrey,DEM,550049,0,0,247,247,05
Oklahoma,State Senate,Adam Pugh,REP,550049,0,0,348,348,41
Oklahoma,State Senate,Richard Prawdzienski,LIB,550049,0,0,50,50,41
Oklahoma,State Senate,Kevin Mcdonald,DEM,550049,0,0,291,291,41
Oklahoma,State House,Ryan Martinez,REP,550049,0,0,397,397,39
Oklahoma,State House,Clark Duffe,LIB,550049,0,0,240,240,39
Oklahoma,President,Donald Trump,REP,550050,0,0,22,22,
Oklahoma,President,Gary Johnson,LIB,550050,0,0,9,9,
Oklahoma,President,Hillary Clinton,DEM,550050,0,0,30,30,
Oklahoma,U.S. Senate,James Lankford,REP,550050,0,0,27,27,
Oklahoma,U.S. Senate,Robert Murphy,LIB,550050,0,0,4,4,
Oklahoma,U.S. Senate,Mike Workman,DEM,550050,0,0,28,28,
Oklahoma,U.S. Senate,Mark Beard,IND,550050,0,0,1,1,
Oklahoma,U.S. Senate,Sean Braddy,IND,550050,0,0,1,1,
Oklahoma,U.S. House,Steve Russell,REP,550050,0,0,22,22,05
Oklahoma,U.S. House,Zachary Knight,LIB,550050,0,0,9,9,05
Oklahoma,U.S. House,Al Mcaffrey,DEM,550050,0,0,29,29,05
Oklahoma,State Senate,Adam Pugh,REP,550050,0,0,21,21,41
Oklahoma,State Senate,Richard Prawdzienski,LIB,550050,0,0,6,6,41
Oklahoma,State Senate,Kevin Mcdonald,DEM,550050,0,0,32,32,41
Oklahoma,President,Donald Trump,REP,550051,0,0,523,523,
Oklahoma,President,Gary Johnson,LIB,550051,0,0,93,93,
Oklahoma,President,Hillary Clinton,DEM,550051,0,0,404,404,
Oklahoma,U.S. Senate,James Lankford,REP,550051,0,0,607,607,
Oklahoma,U.S. Senate,Robert Murphy,LIB,550051,0,0,53,53,
Oklahoma,U.S. Senate,Mike Workman,DEM,550051,0,0,293,293,
Oklahoma,U.S. Senate,Mark Beard,IND,550051,0,0,22,22,
Oklahoma,U.S. Senate,Sean Braddy,IND,550051,0,0,36,36,
Oklahoma,U.S. House,Steve Russell,REP,550051,0,0,583,583,05
Oklahoma,U.S. House,Zachary Knight,LIB,550051,0,0,79,79,05
Oklahoma,U.S. House,Al Mcaffrey,DEM,550051,0,0,339,339,05
Oklahoma,State Senate,Adam Pugh,REP,550051,0,0,536,536,41
Oklahoma,State Senate,Richard Prawdzienski,LIB,550051,0,0,59,59,41
Oklahoma,State Senate,Kevin Mcdonald,DEM,550051,0,0,404,404,41
Oklahoma,State House,Mike Osburn,REP,550051,0,0,535,535,81
Oklahoma,State House,Steve Long,LIB,550051,0,0,93,93,81
Oklahoma,State House,Dan Myers,DEM,550051,0,0,361,361,81
Oklahoma,President,Donald Trump,REP,550052,0,0,559,559,
Oklahoma,President,Gary Johnson,LIB,550052,0,0,77,77,
Oklahoma,President,Hillary Clinton,DEM,550052,0,0,251,251,
Oklahoma,U.S. Senate,James Lankford,REP,550052,0,0,642,642,
Oklahoma,U.S. Senate,Robert Murphy,LIB,550052,0,0,38,38,
Oklahoma,U.S. Senate,Mike Workman,DEM,550052,0,0,177,177,
Oklahoma,U.S. Senate,Mark Beard,IND,550052,0,0,11,11,
Oklahoma,U.S. Senate,Sean Braddy,IND,550052,0,0,25,25,
Oklahoma,U.S. House,Steve Russell,REP,550052,0,0,619,619,05
Oklahoma,U.S. House,Zachary Knight,LIB,550052,0,0,66,66,05
Oklahoma,U.S. House,Al Mcaffrey,DEM,550052,0,0,200,200,05
Oklahoma,State Senate,Adam Pugh,REP,550052,0,0,515,515,41
Oklahoma,State Senate,Richard Prawdzienski,LIB,550052,0,0,48,48,41
Oklahoma,State Senate,Kevin Mcdonald,DEM,550052,0,0,324,324,41
Oklahoma,State House,Mike Osburn,REP,550052,0,0,584,584,81
Oklahoma,State House,Steve Long,LIB,550052,0,0,68,68,81
Oklahoma,State House,Dan Myers,DEM,550052,0,0,223,223,81
Oklahoma,President,Donald Trump,REP,550053,0,0,611,611,
Oklahoma,President,Gary Johnson,LIB,550053,0,0,112,112,
Oklahoma,President,Hillary Clinton,DEM,550053,0,0,356,356,
Oklahoma,U.S. Senate,James Lankford,REP,550053,0,0,709,709,
Oklahoma,U.S. Senate,Robert Murphy,LIB,550053,0,0,50,50,
Oklahoma,U.S. Senate,Mike Workman,DEM,550053,0,0,257,257,
Oklahoma,U.S. Senate,Mark Beard,IND,550053,0,0,24,24,
Oklahoma,U.S. Senate,Sean Braddy,IND,550053,0,0,38,38,
Oklahoma,U.S. House,Steve Russell,REP,550053,0,0,691,691,05
Oklahoma,U.S. House,Zachary Knight,LIB,550053,0,0,92,92,05
Oklahoma,U.S. House,Al Mcaffrey,DEM,550053,0,0,285,285,05
Oklahoma,State Senate,Adam Pugh,REP,550053,0,0,582,582,41
Oklahoma,State Senate,Richard Prawdzienski,LIB,550053,0,0,73,73,41
Oklahoma,State Senate,Kevin Mcdonald,DEM,550053,0,0,416,416,41
Oklahoma,State House,Mike Osburn,REP,550053,0,0,615,615,81
Oklahoma,State House,Steve Long,LIB,550053,0,0,107,107,81
Oklahoma,State House,Dan Myers,DEM,550053,0,0,330,330,81
Oklahoma,President,Donald Trump,REP,550054,0,0,620,620,
Oklahoma,President,Gary Johnson,LIB,550054,0,0,107,107,
Oklahoma,President,Hillary Clinton,DEM,550054,0,0,290,290,
Oklahoma,U.S. Senate,James Lankford,REP,550054,0,0,728,728,
Oklahoma,U.S. Senate,Robert Murphy,LIB,550054,0,0,40,40,
Oklahoma,U.S. Senate,Mike Workman,DEM,550054,0,0,198,198,
Oklahoma,U.S. Senate,Mark Beard,IND,550054,0,0,27,27,
Oklahoma,U.S. Senate,Sean Braddy,IND,550054,0,0,27,27,
Oklahoma,U.S. House,Steve Russell,REP,550054,0,0,707,707,05
Oklahoma,U.S. House,Zachary Knight,LIB,550054,0,0,76,76,05
Oklahoma,U.S. House,Al Mcaffrey,DEM,550054,0,0,225,225,05
Oklahoma,State Senate,Adam Pugh,REP,550054,0,0,594,594,41
Oklahoma,State Senate,Richard Prawdzienski,LIB,550054,0,0,41,41,41
Oklahoma,State Senate,Kevin Mcdonald,DEM,550054,0,0,374,374,41
Oklahoma,State House,Mike Osburn,REP,550054,0,0,640,640,81
Oklahoma,State House,Steve Long,LIB,550054,0,0,85,85,81
Oklahoma,State House,Dan Myers,DEM,550054,0,0,268,268,81
Oklahoma,President,Donald Trump,REP,550055,0,0,622,622,
Oklahoma,President,Gary Johnson,LIB,550055,0,0,100,100,
Oklahoma,President,Hillary Clinton,DEM,550055,0,0,313,313,
Oklahoma,U.S. Senate,James Lankford,REP,550055,0,0,690,690,
Oklahoma,U.S. Senate,Robert Murphy,LIB,550055,0,0,44,44,
Oklahoma,U.S. Senate,Mike Workman,DEM,550055,0,0,250,250,
Oklahoma,U.S. Senate,Mark Beard,IND,550055,0,0,16,16,
Oklahoma,U.S. Senate,Sean Braddy,IND,550055,0,0,35,35,
Oklahoma,U.S. House,Steve Russell,REP,550055,0,0,659,659,05
Oklahoma,U.S. House,Zachary Knight,LIB,550055,0,0,76,76,05
Oklahoma,U.S. House,Al Mcaffrey,DEM,550055,0,0,286,286,05
Oklahoma,State Senate,Adam Pugh,REP,550055,0,0,562,562,41
Oklahoma,State Senate,Richard Prawdzienski,LIB,550055,0,0,54,54,41
Oklahoma,State Senate,Kevin Mcdonald,DEM,550055,0,0,410,410,41
Oklahoma,State House,Mike Osburn,REP,550055,0,0,615,615,81
Oklahoma,State House,Steve Long,LIB,550055,0,0,94,94,81
Oklahoma,State House,Dan Myers,DEM,550055,0,0,301,301,81
Oklahoma,President,Donald Trump,REP,550056,0,0,529,529,
Oklahoma,President,Gary Johnson,LIB,550056,0,0,90,90,
Oklahoma,President,Hillary Clinton,DEM,550056,0,0,309,309,
Oklahoma,U.S. Senate,James Lankford,REP,550056,0,0,623,623,
Oklahoma,U.S. Senate,Robert Murphy,LIB,550056,0,0,40,40,
Oklahoma,U.S. Senate,Mike Workman,DEM,550056,0,0,228,228,
Oklahoma,U.S. Senate,Mark Beard,IND,550056,0,0,16,16,
Oklahoma,U.S. Senate,Sean Braddy,IND,550056,0,0,32,32,
Oklahoma,U.S. House,Steve Russell,REP,550056,0,0,602,602,05
Oklahoma,U.S. House,Zachary Knight,LIB,550056,0,0,65,65,05
Oklahoma,U.S. House,Al Mcaffrey,DEM,550056,0,0,266,266,05
Oklahoma,State Senate,Adam Pugh,REP,550056,0,0,508,508,41
Oklahoma,State Senate,Richard Prawdzienski,LIB,550056,0,0,52,52,41
Oklahoma,State Senate,Kevin Mcdonald,DEM,550056,0,0,370,370,41
Oklahoma,State House,Mike Osburn,REP,550056,0,0,571,571,81
Oklahoma,State House,Steve Long,LIB,550056,0,0,64,64,81
Oklahoma,State House,Dan Myers,DEM,550056,0,0,289,289,81
Oklahoma,President,Donald Trump,REP,550057,0,0,501,501,
Oklahoma,President,Gary Johnson,LIB,550057,0,0,80,80,
Oklahoma,President,Hillary Clinton,DEM,550057,0,0,324,324,
Oklahoma,U.S. Senate,James Lankford,REP,550057,0,0,559,559,
Oklahoma,U.S. Senate,Robert Murphy,LIB,550057,0,0,44,44,
Oklahoma,U.S. Senate,Mike Workman,DEM,550057,0,0,250,250,
Oklahoma,U.S. Senate,Mark Beard,IND,550057,0,0,23,23,
Oklahoma,U.S. Senate,Sean Braddy,IND,550057,0,0,31,31,
Oklahoma,U.S. House,Steve Russell,REP,550057,0,0,549,549,05
Oklahoma,U.S. House,Zachary Knight,LIB,550057,0,0,71,71,05
Oklahoma,U.S. House,Al Mcaffrey,DEM,550057,0,0,278,278,05
Oklahoma,State Senate,Adam Pugh,REP,550057,0,0,503,503,41
Oklahoma,State Senate,Richard Prawdzienski,LIB,550057,0,0,49,49,41
Oklahoma,State Senate,Kevin Mcdonald,DEM,550057,0,0,337,337,41
Oklahoma,State House,Mike Osburn,REP,550057,0,0,515,515,81
Oklahoma,State House,Steve Long,LIB,550057,0,0,78,78,81
Oklahoma,State House,Dan Myers,DEM,550057,0,0,291,291,81
Oklahoma,President,Donald Trump,REP,550058,0,0,1135,1135,
Oklahoma,President,Gary Johnson,LIB,550058,0,0,107,107,
Oklahoma,President,Hillary Clinton,DEM,550058,0,0,421,421,
Oklahoma,U.S. Senate,James Lankford,REP,550058,0,0,1308,1308,
Oklahoma,U.S. Senate,Robert Murphy,LIB,550058,0,0,52,52,
Oklahoma,U.S. Senate,Mike Workman,DEM,550058,0,0,285,285,
Oklahoma,U.S. Senate,Mark Beard,IND,550058,0,0,15,15,
Oklahoma,U.S. Senate,Sean Braddy,IND,550058,0,0,29,29,
Oklahoma,U.S. House,Steve Russell,REP,550058,0,0,1260,1260,05
Oklahoma,U.S. House,Zachary Knight,LIB,550058,0,0,70,70,05
Oklahoma,U.S. House,Al Mcaffrey,DEM,550058,0,0,334,334,05
Oklahoma,State Senate,Adam Pugh,REP,550058,0,0,1172,1172,41
Oklahoma,State Senate,Richard Prawdzienski,LIB,550058,0,0,56,56,41
Oklahoma,State Senate,Kevin Mcdonald,DEM,550058,0,0,443,443,41
Oklahoma,President,Donald Trump,REP,550059,0,0,1015,1015,
Oklahoma,President,Gary Johnson,LIB,550059,0,0,82,82,
Oklahoma,President,Hillary Clinton,DEM,550059,0,0,268,268,
Oklahoma,U.S. Senate,James Lankford,REP,550059,0,0,1111,1111,
Oklahoma,U.S. Senate,Robert Murphy,LIB,550059,0,0,45,45,
Oklahoma,U.S. Senate,Mike Workman,DEM,550059,0,0,186,186,
Oklahoma,U.S. Senate,Mark Beard,IND,550059,0,0,13,13,
Oklahoma,U.S. Senate,Sean Braddy,IND,550059,0,0,17,17,
Oklahoma,U.S. House,Steve Russell,REP,550059,0,0,1086,1086,05
Oklahoma,U.S. House,Zachary Knight,LIB,550059,0,0,62,62,05
Oklahoma,U.S. House,Al Mcaffrey,DEM,550059,0,0,215,215,05
Oklahoma,State Senate,Adam Pugh,REP,550059,0,0,1013,1013,41
Oklahoma,State Senate,Richard Prawdzienski,LIB,550059,0,0,58,58,41
Oklahoma,State Senate,Kevin Mcdonald,DEM,550059,0,0,288,288,41
Oklahoma,State House,Jason Murphey,REP,550059,0,0,1110,1110,31
Oklahoma,State House,John Tiller,DEM,550059,0,0,240,240,31
Oklahoma,President,Donald Trump,REP,550060,0,0,1109,1109,
Oklahoma,President,Gary Johnson,LIB,550060,0,0,129,129,
Oklahoma,President,Hillary Clinton,DEM,550060,0,0,401,401,
Oklahoma,U.S. Senate,James Lankford,REP,550060,0,0,1231,1231,
Oklahoma,U.S. Senate,Robert Murphy,LIB,550060,0,0,70,70,
Oklahoma,U.S. Senate,Mike Workman,DEM,550060,0,0,302,302,
Oklahoma,U.S. Senate,Mark Beard,IND,550060,0,0,21,21,
Oklahoma,U.S. Senate,Sean Braddy,IND,550060,0,0,32,32,
Oklahoma,U.S. House,Steve Russell,REP,550060,0,0,1198,1198,05
Oklahoma,U.S. House,Zachary Knight,LIB,550060,0,0,97,97,05
Oklahoma,U.S. House,Al Mcaffrey,DEM,550060,0,0,350,350,05
Oklahoma,State Senate,Adam Pugh,REP,550060,0,0,1084,1084,41
Oklahoma,State Senate,Richard Prawdzienski,LIB,550060,0,0,78,78,41
Oklahoma,State Senate,Kevin Mcdonald,DEM,550060,0,0,479,479,41
Oklahoma,President,Donald Trump,REP,550061,0,0,930,930,
Oklahoma,President,Gary Johnson,LIB,550061,0,0,96,96,
Oklahoma,President,Hillary Clinton,DEM,550061,0,0,352,352,
Oklahoma,U.S. Senate,James Lankford,REP,550061,0,0,1079,1079,
Oklahoma,U.S. Senate,Robert Murphy,LIB,550061,0,0,39,39,
Oklahoma,U.S. Senate,Mike Workman,DEM,550061,0,0,226,226,
Oklahoma,U.S. Senate,Mark Beard,IND,550061,0,0,22,22,
Oklahoma,U.S. Senate,Sean Braddy,IND,550061,0,0,22,22,
Oklahoma,U.S. House,Steve Russell,REP,550061,0,0,1037,1037,05
Oklahoma,U.S. House,Zachary Knight,LIB,550061,0,0,66,66,05
Oklahoma,U.S. House,Al Mcaffrey,DEM,550061,0,0,271,271,05
Oklahoma,State Senate,Adam Pugh,REP,550061,0,0,881,881,41
Oklahoma,State Senate,Richard Prawdzienski,LIB,550061,0,0,40,40,41
Oklahoma,State Senate,Kevin Mcdonald,DEM,550061,0,0,446,446,41
Oklahoma,State House,Mike Osburn,REP,550061,0,0,962,962,81
Oklahoma,State House,Steve Long,LIB,550061,0,0,72,72,81
Oklahoma,State House,Dan Myers,DEM,550061,0,0,313,313,81
Oklahoma,President,Donald Trump,REP,550062,0,0,954,954,
Oklahoma,President,Gary Johnson,LIB,550062,0,0,147,147,
Oklahoma,President,Hillary Clinton,DEM,550062,0,0,433,433,
Oklahoma,U.S. Senate,James Lankford,REP,550062,0,0,1162,1162,
Oklahoma,U.S. Senate,Robert Murphy,LIB,550062,0,0,59,59,
Oklahoma,U.S. Senate,Mike Workman,DEM,550062,0,0,274,274,
Oklahoma,U.S. Senate,Mark Beard,IND,550062,0,0,26,26,
Oklahoma,U.S. Senate,Sean Braddy,IND,550062,0,0,33,33,
Oklahoma,U.S. House,Steve Russell,REP,550062,0,0,1119,1119,05
Oklahoma,U.S. House,Zachary Knight,LIB,550062,0,0,95,95,05
Oklahoma,U.S. House,Al Mcaffrey,DEM,550062,0,0,327,327,05
Oklahoma,State Senate,Adam Pugh,REP,550062,0,0,912,912,41
Oklahoma,State Senate,Richard Prawdzienski,LIB,550062,0,0,60,60,41
Oklahoma,State Senate,Kevin Mcdonald,DEM,550062,0,0,571,571,41
Oklahoma,State House,Mike Osburn,REP,550062,0,0,1035,1035,81
Oklahoma,State House,Steve Long,LIB,550062,0,0,107,107,81
Oklahoma,State House,Dan Myers,DEM,550062,0,0,372,372,81
Oklahoma,President,Donald Trump,REP,550063,0,0,436,436,
Oklahoma,President,Gary Johnson,LIB,550063,0,0,56,56,
Oklahoma,President,Hillary Clinton,DEM,550063,0,0,124,124,
Oklahoma,U.S. Senate,James Lankford,REP,550063,0,0,499,499,
Oklahoma,U.S. Senate,Robert Murphy,LIB,550063,0,0,22,22,
Oklahoma,U.S. Senate,Mike Workman,DEM,550063,0,0,83,83,
Oklahoma,U.S. Senate,Mark Beard,IND,550063,0,0,4,4,
Oklahoma,U.S. Senate,Sean Braddy,IND,550063,0,0,12,12,
Oklahoma,U.S. House,Steve Russell,REP,550063,0,0,487,487,05
Oklahoma,U.S. House,Zachary Knight,LIB,550063,0,0,31,31,05
Oklahoma,U.S. House,Al Mcaffrey,DEM,550063,0,0,94,94,05
Oklahoma,State Senate,Adam Pugh,REP,550063,0,0,429,429,41
Oklahoma,State Senate,Richard Prawdzienski,LIB,550063,0,0,23,23,41
Oklahoma,State Senate,Kevin Mcdonald,DEM,550063,0,0,161,161,41
Oklahoma,President,Donald Trump,REP,550064,0,0,1114,1114,
Oklahoma,President,Gary Johnson,LIB,550064,0,0,85,85,
Oklahoma,President,Hillary Clinton,DEM,550064,0,0,366,366,
Oklahoma,U.S. Senate,James Lankford,REP,550064,0,0,1246,1246,
Oklahoma,U.S. Senate,Robert Murphy,LIB,550064,0,0,52,52,
Oklahoma,U.S. Senate,Mike Workman,DEM,550064,0,0,235,235,
Oklahoma,U.S. Senate,Mark Beard,IND,550064,0,0,15,15,
Oklahoma,U.S. Senate,Sean Braddy,IND,550064,0,0,26,26,
Oklahoma,U.S. House,Steve Russell,REP,550064,0,0,1207,1207,05
Oklahoma,U.S. House,Zachary Knight,LIB,550064,0,0,80,80,05
Oklahoma,U.S. House,Al Mcaffrey,DEM,550064,0,0,270,270,05
Oklahoma,State Senate,Adam Pugh,REP,550064,0,0,1073,1073,41
Oklahoma,State Senate,Richard Prawdzienski,LIB,550064,0,0,60,60,41
Oklahoma,State Senate,Kevin Mcdonald,DEM,550064,0,0,419,419,41
Oklahoma,President,Donald Trump,REP,550065,0,0,686,686,
Oklahoma,President,Gary Johnson,LIB,550065,0,0,49,49,
Oklahoma,President,Hillary Clinton,DEM,550065,0,0,255,255,
Oklahoma,U.S. Senate,James Lankford,REP,550065,0,0,745,745,
Oklahoma,U.S. Senate,Robert Murphy,LIB,550065,0,0,27,27,
Oklahoma,U.S. Senate,Mike Workman,DEM,550065,0,0,190,190,
Oklahoma,U.S. Senate,Mark Beard,IND,550065,0,0,15,15,
Oklahoma,U.S. Senate,Sean Braddy,IND,550065,0,0,27,27,
Oklahoma,U.S. House,Steve Russell,REP,550065,0,0,729,729,05
Oklahoma,U.S. House,Zachary Knight,LIB,550065,0,0,48,48,05
Oklahoma,U.S. House,Al Mcaffrey,DEM,550065,0,0,222,222,05
Oklahoma,State Senate,Adam Pugh,REP,550065,0,0,651,651,41
Oklahoma,State Senate,Richard Prawdzienski,LIB,550065,0,0,54,54,41
Oklahoma,State Senate,Kevin Mcdonald,DEM,550065,0,0,283,283,41
Oklahoma,President,Donald Trump,REP,550066,0,0,182,182,
Oklahoma,President,Gary Johnson,LIB,550066,0,0,43,43,
Oklahoma,President,Hillary Clinton,DEM,550066,0,0,764,764,
Oklahoma,U.S. Senate,James Lankford,REP,550066,0,0,241,241,
Oklahoma,U.S. Senate,Robert Murphy,LIB,550066,0,0,27,27,
Oklahoma,U.S. Senate,Mike Workman,DEM,550066,0,0,669,669,
Oklahoma,U.S. Senate,Mark Beard,IND,550066,0,0,15,15,
Oklahoma,U.S. Senate,Sean Braddy,IND,550066,0,0,39,39,
Oklahoma,U.S. House,Steve Russell,REP,550066,0,0,210,210,05
Oklahoma,U.S. House,Zachary Knight,LIB,550066,0,0,38,38,05
Oklahoma,U.S. House,Al Mcaffrey,DEM,550066,0,0,733,733,05
Oklahoma,State House,Tonni Canaday,REP,550066,0,0,186,186,97
Oklahoma,State House,Jason Lowe,DEM,550066,0,0,792,792,97
Oklahoma,President,Donald Trump,REP,550067,0,0,962,962,
Oklahoma,President,Gary Johnson,LIB,550067,0,0,68,68,
Oklahoma,President,Hillary Clinton,DEM,550067,0,0,195,195,
Oklahoma,U.S. Senate,James Lankford,REP,550067,0,0,965,965,
Oklahoma,U.S. Senate,Robert Murphy,LIB,550067,0,0,39,39,
Oklahoma,U.S. Senate,Mike Workman,DEM,550067,0,0,163,163,
Oklahoma,U.S. Senate,Mark Beard,IND,550067,0,0,27,27,
Oklahoma,U.S. Senate,Sean Braddy,IND,550067,0,0,31,31,
Oklahoma,U.S. House,Steve Russell,REP,550067,0,0,918,918,05
Oklahoma,U.S. House,Zachary Knight,LIB,550067,0,0,87,87,05
Oklahoma,U.S. House,Al Mcaffrey,DEM,550067,0,0,218,218,05
Oklahoma,State House,Tess Teague,REP,550067,0,0,884,884,10
Oklahoma,State House,Cheryl Hessman,DEM,550067,0,0,330,330,10
Oklahoma,President,Donald Trump,REP,550068,0,0,687,687,
Oklahoma,President,Gary Johnson,LIB,550068,0,0,34,34,
Oklahoma,President,Hillary Clinton,DEM,550068,0,0,134,134,
Oklahoma,U.S. Senate,James Lankford,REP,550068,0,0,707,707,
Oklahoma,U.S. Senate,Robert Murphy,LIB,550068,0,0,23,23,
Oklahoma,U.S. Senate,Mike Workman,DEM,550068,0,0,102,102,
Oklahoma,U.S. Senate,Mark Beard,IND,550068,0,0,11,11,
Oklahoma,U.S. Senate,Sean Braddy,IND,550068,0,0,16,16,
Oklahoma,U.S. House,Steve Russell,REP,550068,0,0,683,683,05
Oklahoma,U.S. House,Zachary Knight,LIB,550068,0,0,49,49,05
Oklahoma,U.S. House,Al Mcaffrey,DEM,550068,0,0,121,121,05
Oklahoma,President,Donald Trump,REP,550069,0,0,775,775,
Oklahoma,President,Gary Johnson,LIB,550069,0,0,77,77,
Oklahoma,President,Hillary Clinton,DEM,550069,0,0,206,206,
Oklahoma,U.S. Senate,James Lankford,REP,550069,0,0,826,826,
Oklahoma,U.S. Senate,Robert Murphy,LIB,550069,0,0,34,34,
Oklahoma,U.S. Senate,Mike Workman,DEM,550069,0,0,155,155,
Oklahoma,U.S. Senate,Mark Beard,IND,550069,0,0,18,18,
Oklahoma,U.S. Senate,Sean Braddy,IND,550069,0,0,26,26,
Oklahoma,U.S. House,Steve Russell,REP,550069,0,0,782,782,05
Oklahoma,U.S. House,Zachary Knight,LIB,550069,0,0,77,77,05
Oklahoma,U.S. House,Al Mcaffrey,DEM,550069,0,0,193,193,05
Oklahoma,President,Donald Trump,REP,550070,0,0,683,683,
Oklahoma,President,Gary Johnson,LIB,550070,0,0,35,35,
Oklahoma,President,Hillary Clinton,DEM,550070,0,0,153,153,
Oklahoma,U.S. Senate,James Lankford,REP,550070,0,0,683,683,
Oklahoma,U.S. Senate,Robert Murphy,LIB,550070,0,0,24,24,
Oklahoma,U.S. Senate,Mike Workman,DEM,550070,0,0,127,127,
Oklahoma,U.S. Senate,Mark Beard,IND,550070,0,0,14,14,
Oklahoma,U.S. Senate,Sean Braddy,IND,550070,0,0,23,23,
Oklahoma,U.S. House,Steve Russell,REP,550070,0,0,655,655,05
Oklahoma,U.S. House,Zachary Knight,LIB,550070,0,0,58,58,05
Oklahoma,U.S. House,Al Mcaffrey,DEM,550070,0,0,151,151,05
Oklahoma,President,Donald Trump,REP,550071,0,0,968,968,
Oklahoma,President,Gary Johnson,LIB,550071,0,0,72,72,
Oklahoma,President,Hillary Clinton,DEM,550071,0,0,221,221,
Oklahoma,U.S. Senate,James Lankford,REP,550071,0,0,997,997,
Oklahoma,U.S. Senate,Robert Murphy,LIB,550071,0,0,42,42,
Oklahoma,U.S. Senate,Mike Workman,DEM,550071,0,0,173,173,
Oklahoma,U.S. Senate,Mark Beard,IND,550071,0,0,18,18,
Oklahoma,U.S. Senate,Sean Braddy,IND,550071,0,0,38,38,
Oklahoma,U.S. House,Steve Russell,REP,550071,0,0,925,925,05
Oklahoma,U.S. House,Zachary Knight,LIB,550071,0,0,77,77,05
Oklahoma,U.S. House,Al Mcaffrey,DEM,550071,0,0,243,243,05
Oklahoma,President,Donald Trump,REP,550072,0,0,582,582,
Oklahoma,President,Gary Johnson,LIB,550072,0,0,54,54,
Oklahoma,President,Hillary Clinton,DEM,550072,0,0,178,178,
Oklahoma,U.S. Senate,James Lankford,REP,550072,0,0,598,598,
Oklahoma,U.S. Senate,Robert Murphy,LIB,550072,0,0,36,36,
Oklahoma,U.S. Senate,Mike Workman,DEM,550072,0,0,137,137,
Oklahoma,U.S. Senate,Mark Beard,IND,550072,0,0,19,19,
Oklahoma,U.S. Senate,Sean Braddy,IND,550072,0,0,21,21,
Oklahoma,U.S. House,Steve Russell,REP,550072,0,0,566,566,05
Oklahoma,U.S. House,Zachary Knight,LIB,550072,0,0,66,66,05
Oklahoma,U.S. House,Al Mcaffrey,DEM,550072,0,0,169,169,05
Oklahoma,President,Donald Trump,REP,550073,0,0,207,207,
Oklahoma,President,Gary Johnson,LIB,550073,0,0,26,26,
Oklahoma,President,Hillary Clinton,DEM,550073,0,0,55,55,
Oklahoma,U.S. Senate,James Lankford,REP,550073,0,0,225,225,
Oklahoma,U.S. Senate,Robert Murphy,LIB,550073,0,0,14,14,
Oklahoma,U.S. Senate,Mike Workman,DEM,550073,0,0,41,41,
Oklahoma,U.S. Senate,Mark Beard,IND,550073,0,0,5,5,
Oklahoma,U.S. Senate,Sean Braddy,IND,550073,0,0,6,6,
Oklahoma,U.S. House,Steve Russell,REP,550073,0,0,207,207,05
Oklahoma,U.S. House,Zachary Knight,LIB,550073,0,0,23,23,05
Oklahoma,U.S. House,Al Mcaffrey,DEM,550073,0,0,57,57,05
Oklahoma,State House,Tonni Canaday,REP,550073,0,0,190,190,97
Oklahoma,State House,Jason Lowe,DEM,550073,0,0,93,93,97
Oklahoma,President,Donald Trump,REP,550074,0,0,59,59,
Oklahoma,President,Gary Johnson,LIB,550074,0,0,5,5,
Oklahoma,President,Hillary Clinton,DEM,550074,0,0,221,221,
Oklahoma,U.S. Senate,James Lankford,REP,550074,0,0,67,67,
Oklahoma,U.S. Senate,Robert Murphy,LIB,550074,0,0,1,1,
Oklahoma,U.S. Senate,Mike Workman,DEM,550074,0,0,209,209,
Oklahoma,U.S. Senate,Mark Beard,IND,550074,0,0,3,3,
Oklahoma,U.S. Senate,Sean Braddy,IND,550074,0,0,5,5,
Oklahoma,U.S. House,Steve Russell,REP,550074,0,0,59,59,05
Oklahoma,U.S. House,Zachary Knight,LIB,550074,0,0,6,6,05
Oklahoma,U.S. House,Al Mcaffrey,DEM,550074,0,0,217,217,05
Oklahoma,State House,Tonni Canaday,REP,550074,0,0,48,48,97
Oklahoma,State House,Jason Lowe,DEM,550074,0,0,233,233,97
Oklahoma,President,Donald Trump,REP,550075,0,0,222,222,
Oklahoma,President,Gary Johnson,LIB,550075,0,0,34,34,
Oklahoma,President,Hillary Clinton,DEM,550075,0,0,692,692,
Oklahoma,U.S. Senate,James Lankford,REP,550075,0,0,282,282,
Oklahoma,U.S. Senate,Robert Murphy,LIB,550075,0,0,19,19,
Oklahoma,U.S. Senate,Mike Workman,DEM,550075,0,0,599,599,
Oklahoma,U.S. Senate,Mark Beard,IND,550075,0,0,18,18,
Oklahoma,U.S. Senate,Sean Braddy,IND,550075,0,0,31,31,
Oklahoma,U.S. House,Steve Russell,REP,550075,0,0,243,243,05
Oklahoma,U.S. House,Zachary Knight,LIB,550075,0,0,47,47,05
Oklahoma,U.S. House,Al Mcaffrey,DEM,550075,0,0,656,656,05
Oklahoma,State House,Tonni Canaday,REP,550075,0,0,216,216,97
Oklahoma,State House,Jason Lowe,DEM,550075,0,0,730,730,97
Oklahoma,President,Donald Trump,REP,550076,0,0,646,646,
Oklahoma,President,Gary Johnson,LIB,550076,0,0,54,54,
Oklahoma,President,Hillary Clinton,DEM,550076,0,0,221,221,
Oklahoma,U.S. Senate,James Lankford,REP,550076,0,0,659,659,
Oklahoma,U.S. Senate,Robert Murphy,LIB,550076,0,0,33,33,
Oklahoma,U.S. Senate,Mike Workman,DEM,550076,0,0,185,185,
Oklahoma,U.S. Senate,Mark Beard,IND,550076,0,0,17,17,
Oklahoma,U.S. Senate,Sean Braddy,IND,550076,0,0,26,26,
Oklahoma,U.S. House,Steve Russell,REP,550076,0,0,633,633,05
Oklahoma,U.S. House,Zachary Knight,LIB,550076,0,0,61,61,05
Oklahoma,U.S. House,Al Mcaffrey,DEM,550076,0,0,215,215,05
Oklahoma,President,Donald Trump,REP,550077,0,0,238,238,
Oklahoma,President,Gary Johnson,LIB,550077,0,0,55,55,
Oklahoma,President,Hillary Clinton,DEM,550077,0,0,612,612,
Oklahoma,U.S. Senate,James Lankford,REP,550077,0,0,285,285,
Oklahoma,U.S. Senate,Robert Murphy,LIB,550077,0,0,33,33,
Oklahoma,U.S. Senate,Mike Workman,DEM,550077,0,0,527,527,
Oklahoma,U.S. Senate,Mark Beard,IND,550077,0,0,22,22,
Oklahoma,U.S. Senate,Sean Braddy,IND,550077,0,0,39,39,
Oklahoma,U.S. House,Steve Russell,REP,550077,0,0,251,251,05
Oklahoma,U.S. House,Zachary Knight,LIB,550077,0,0,63,63,05
Oklahoma,U.S. House,Al Mcaffrey,DEM,550077,0,0,590,590,05
Oklahoma,State House,Tonni Canaday,REP,550077,0,0,239,239,97
Oklahoma,State House,Jason Lowe,DEM,550077,0,0,661,661,97
Oklahoma,President,Donald Trump,REP,550078,0,0,142,142,
Oklahoma,President,Gary Johnson,LIB,550078,0,0,32,32,
Oklahoma,President,Hillary Clinton,DEM,550078,0,0,523,523,
Oklahoma,U.S. Senate,James Lankford,REP,550078,0,0,179,179,
Oklahoma,U.S. Senate,Robert Murphy,LIB,550078,0,0,21,21,
Oklahoma,U.S. Senate,Mike Workman,DEM,550078,0,0,468,468,
Oklahoma,U.S. Senate,Mark Beard,IND,550078,0,0,13,13,
Oklahoma,U.S. Senate,Sean Braddy,IND,550078,0,0,14,14,
Oklahoma,U.S. House,Steve Russell,REP,550078,0,0,159,159,05
Oklahoma,U.S. House,Zachary Knight,LIB,550078,0,0,35,35,05
Oklahoma,U.S. House,Al Mcaffrey,DEM,550078,0,0,498,498,05
Oklahoma,State House,Tonni Canaday,REP,550078,0,0,140,140,97
Oklahoma,State House,Jason Lowe,DEM,550078,0,0,549,549,97
Oklahoma,President,Donald Trump,REP,550079,0,0,205,205,
Oklahoma,President,Gary Johnson,LIB,550079,0,0,55,55,
Oklahoma,President,Hillary Clinton,DEM,550079,0,0,725,725,
Oklahoma,U.S. Senate,James Lankford,REP,550079,0,0,256,256,
Oklahoma,U.S. Senate,Robert Murphy,LIB,550079,0,0,25,25,
Oklahoma,U.S. Senate,Mike Workman,DEM,550079,0,0,629,629,
Oklahoma,U.S. Senate,Mark Beard,IND,550079,0,0,24,24,
Oklahoma,U.S. Senate,Sean Braddy,IND,550079,0,0,46,46,
Oklahoma,U.S. House,Steve Russell,REP,550079,0,0,207,207,05
Oklahoma,U.S. House,Zachary Knight,LIB,550079,0,0,62,62,05
Oklahoma,U.S. House,Al Mcaffrey,DEM,550079,0,0,706,706,05
Oklahoma,State House,Tonni Canaday,REP,550079,0,0,194,194,97
Oklahoma,State House,Jason Lowe,DEM,550079,0,0,778,778,97
Oklahoma,President,Donald Trump,REP,550080,0,0,872,872,
Oklahoma,President,Gary Johnson,LIB,550080,0,0,124,124,
Oklahoma,President,Hillary Clinton,DEM,550080,0,0,609,609,
Oklahoma,U.S. Senate,James Lankford,REP,550080,0,0,964,964,
Oklahoma,U.S. Senate,Robert Murphy,LIB,550080,0,0,69,69,
Oklahoma,U.S. Senate,Mike Workman,DEM,550080,0,0,467,467,
Oklahoma,U.S. Senate,Mark Beard,IND,550080,0,0,47,47,
Oklahoma,U.S. Senate,Sean Braddy,IND,550080,0,0,57,57,
Oklahoma,U.S. House,Tom Cole,REP,550080,0,0,968,968,04
Oklahoma,U.S. House,Sevier White,LIB,550080,0,0,86,86,04
Oklahoma,U.S. House,Christina Owen,DEM,550080,0,0,539,539,04
Oklahoma,State House,Roger Ford,REP,550080,0,0,902,902,95
Oklahoma,State House,James Cook,DEM,550080,0,0,680,680,95
Oklahoma,President,Donald Trump,REP,550081,0,0,503,503,
Oklahoma,President,Gary Johnson,LIB,550081,0,0,73,73,
Oklahoma,President,Hillary Clinton,DEM,550081,0,0,310,310,
Oklahoma,U.S. Senate,James Lankford,REP,550081,0,0,536,536,
Oklahoma,U.S. Senate,Robert Murphy,LIB,550081,0,0,38,38,
Oklahoma,U.S. Senate,Mike Workman,DEM,550081,0,0,244,244,
Oklahoma,U.S. Senate,Mark Beard,IND,550081,0,0,30,30,
Oklahoma,U.S. Senate,Sean Braddy,IND,550081,0,0,31,31,
Oklahoma,U.S. House,Tom Cole,REP,550081,0,0,541,541,04
Oklahoma,U.S. House,Sevier White,LIB,550081,0,0,59,59,04
Oklahoma,U.S. House,Christina Owen,DEM,550081,0,0,278,278,04
Oklahoma,State House,Roger Ford,REP,550081,0,0,522,522,95
Oklahoma,State House,James Cook,DEM,550081,0,0,344,344,95
Oklahoma,President,Donald Trump,REP,550082,0,0,207,207,
Oklahoma,President,Gary Johnson,LIB,550082,0,0,51,51,
Oklahoma,President,Hillary Clinton,DEM,550082,0,0,212,212,
Oklahoma,U.S. Senate,James Lankford,REP,550082,0,0,248,248,
Oklahoma,U.S. Senate,Robert Murphy,LIB,550082,0,0,19,19,
Oklahoma,U.S. Senate,Mike Workman,DEM,550082,0,0,158,158,
Oklahoma,U.S. Senate,Mark Beard,IND,550082,0,0,14,14,
Oklahoma,U.S. Senate,Sean Braddy,IND,550082,0,0,27,27,
Oklahoma,U.S. House,Tom Cole,REP,550082,0,0,235,235,04
Oklahoma,U.S. House,Sevier White,LIB,550082,0,0,33,33,04
Oklahoma,U.S. House,Christina Owen,DEM,550082,0,0,193,193,04
Oklahoma,State House,Roger Ford,REP,550082,0,0,220,220,95
Oklahoma,State House,James Cook,DEM,550082,0,0,237,237,95
Oklahoma,President,Donald Trump,REP,550083,0,0,597,597,
Oklahoma,President,Gary Johnson,LIB,550083,0,0,116,116,
Oklahoma,President,Hillary Clinton,DEM,550083,0,0,415,415,
Oklahoma,U.S. Senate,James Lankford,REP,550083,0,0,625,625,
Oklahoma,U.S. Senate,Robert Murphy,LIB,550083,0,0,57,57,
Oklahoma,U.S. Senate,Mike Workman,DEM,550083,0,0,315,315,
Oklahoma,U.S. Senate,Mark Beard,IND,550083,0,0,46,46,
Oklahoma,U.S. Senate,Sean Braddy,IND,550083,0,0,80,80,
Oklahoma,U.S. House,Tom Cole,REP,550083,0,0,631,631,04
Oklahoma,U.S. House,Sevier White,LIB,550083,0,0,96,96,04
Oklahoma,U.S. House,Christina Owen,DEM,550083,0,0,391,391,04
Oklahoma,State House,Roger Ford,REP,550083,0,0,639,639,95
Oklahoma,State House,James Cook,DEM,550083,0,0,470,470,95
Oklahoma,President,Donald Trump,REP,550084,0,0,382,382,
Oklahoma,President,Gary Johnson,LIB,550084,0,0,62,62,
Oklahoma,President,Hillary Clinton,DEM,550084,0,0,297,297,
Oklahoma,U.S. Senate,James Lankford,REP,550084,0,0,399,399,
Oklahoma,U.S. Senate,Robert Murphy,LIB,550084,0,0,36,36,
Oklahoma,U.S. Senate,Mike Workman,DEM,550084,0,0,238,238,
Oklahoma,U.S. Senate,Mark Beard,IND,550084,0,0,27,27,
Oklahoma,U.S. Senate,Sean Braddy,IND,550084,0,0,34,34,
Oklahoma,U.S. House,Tom Cole,REP,550084,0,0,401,401,04
Oklahoma,U.S. House,Sevier White,LIB,550084,0,0,49,49,04
Oklahoma,U.S. House,Christina Owen,DEM,550084,0,0,281,281,04
Oklahoma,State House,Roger Ford,REP,550084,0,0,395,395,95
Oklahoma,State House,James Cook,DEM,550084,0,0,331,331,95
Oklahoma,President,Donald Trump,REP,550085,0,0,618,618,
Oklahoma,President,Gary Johnson,LIB,550085,0,0,96,96,
Oklahoma,President,Hillary Clinton,DEM,550085,0,0,421,421,
Oklahoma,U.S. Senate,James Lankford,REP,550085,0,0,660,660,
Oklahoma,U.S. Senate,Robert Murphy,LIB,550085,0,0,45,45,
Oklahoma,U.S. Senate,Mike Workman,DEM,550085,0,0,337,337,
Oklahoma,U.S. Senate,Mark Beard,IND,550085,0,0,36,36,
Oklahoma,U.S. Senate,Sean Braddy,IND,550085,0,0,47,47,
Oklahoma,U.S. House,Tom Cole,REP,550085,0,0,673,673,04
Oklahoma,U.S. House,Sevier White,LIB,550085,0,0,71,71,04
Oklahoma,U.S. House,Christina Owen,DEM,550085,0,0,382,382,04
Oklahoma,State House,Roger Ford,REP,550085,0,0,629,629,95
Oklahoma,State House,James Cook,DEM,550085,0,0,492,492,95
Oklahoma,President,Donald Trump,REP,550086,0,0,676,676,
Oklahoma,President,Gary Johnson,LIB,550086,0,0,94,94,
Oklahoma,President,Hillary Clinton,DEM,550086,0,0,435,435,
Oklahoma,U.S. Senate,James Lankford,REP,550086,0,0,756,756,
Oklahoma,U.S. Senate,Robert Murphy,LIB,550086,0,0,44,44,
Oklahoma,U.S. Senate,Mike Workman,DEM,550086,0,0,352,352,
Oklahoma,U.S. Senate,Mark Beard,IND,550086,0,0,19,19,
Oklahoma,U.S. Senate,Sean Braddy,IND,550086,0,0,41,41,
Oklahoma,U.S. House,Tom Cole,REP,550086,0,0,756,756,04
Oklahoma,U.S. House,Sevier White,LIB,550086,0,0,55,55,04
Oklahoma,U.S. House,Christina Owen,DEM,550086,0,0,397,397,04
Oklahoma,State House,Roger Ford,REP,550086,0,0,678,678,95
Oklahoma,State House,James Cook,DEM,550086,0,0,526,526,95
Oklahoma,President,Donald Trump,REP,550087,0,0,238,238,
Oklahoma,President,Gary Johnson,LIB,550087,0,0,45,45,
Oklahoma,President,Hillary Clinton,DEM,550087,0,0,297,297,
Oklahoma,U.S. Senate,James Lankford,REP,550087,0,0,270,270,
Oklahoma,U.S. Senate,Robert Murphy,LIB,550087,0,0,27,27,
Oklahoma,U.S. Senate,Mike Workman,DEM,550087,0,0,232,232,
Oklahoma,U.S. Senate,Mark Beard,IND,550087,0,0,18,18,
Oklahoma,U.S. Senate,Sean Braddy,IND,550087,0,0,32,32,
Oklahoma,U.S. House,Tom Cole,REP,550087,0,0,278,278,04
Oklahoma,U.S. House,Sevier White,LIB,550087,0,0,29,29,04
Oklahoma,U.S. House,Christina Owen,DEM,550087,0,0,270,270,04
Oklahoma,State House,Roger Ford,REP,550087,0,0,255,255,95
Oklahoma,State House,James Cook,DEM,550087,0,0,318,318,95
Oklahoma,President,Donald Trump,REP,550088,0,0,111,111,
Oklahoma,President,Gary Johnson,LIB,550088,0,0,23,23,
Oklahoma,President,Hillary Clinton,DEM,550088,0,0,243,243,
Oklahoma,U.S. Senate,James Lankford,REP,550088,0,0,125,125,
Oklahoma,U.S. Senate,Robert Murphy,LIB,550088,0,0,16,16,
Oklahoma,U.S. Senate,Mike Workman,DEM,550088,0,0,214,214,
Oklahoma,U.S. Senate,Mark Beard,IND,550088,0,0,4,4,
Oklahoma,U.S. Senate,Sean Braddy,IND,550088,0,0,8,8,
Oklahoma,U.S. House,Tom Cole,REP,550088,0,0,130,130,04
Oklahoma,U.S. House,Sevier White,LIB,550088,0,0,14,14,04
Oklahoma,U.S. House,Christina Owen,DEM,550088,0,0,224,224,04
Oklahoma,State House,Tess Teague,REP,550088,0,0,108,108,10
Oklahoma,State House,Cheryl Hessman,DEM,550088,0,0,251,251,10
Oklahoma,President,Donald Trump,REP,550089,0,0,207,207,
Oklahoma,President,Gary Johnson,LIB,550089,0,0,31,31,
Oklahoma,President,Hillary Clinton,DEM,550089,0,0,481,481,
Oklahoma,U.S. Senate,James Lankford,REP,550089,0,0,232,232,
Oklahoma,U.S. Senate,Robert Murphy,LIB,550089,0,0,15,15,
Oklahoma,U.S. Senate,Mike Workman,DEM,550089,0,0,414,414,
Oklahoma,U.S. Senate,Mark Beard,IND,550089,0,0,13,13,
Oklahoma,U.S. Senate,Sean Braddy,IND,550089,0,0,34,34,
Oklahoma,U.S. House,Steve Russell,REP,550089,0,0,224,224,05
Oklahoma,U.S. House,Zachary Knight,LIB,550089,0,0,32,32,05
Oklahoma,U.S. House,Al Mcaffrey,DEM,550089,0,0,450,450,05
Oklahoma,State House,Tonni Canaday,REP,550089,0,0,203,203,97
Oklahoma,State House,Jason Lowe,DEM,550089,0,0,495,495,97
Oklahoma,President,Donald Trump,REP,550090,0,0,44,44,
Oklahoma,President,Gary Johnson,LIB,550090,0,0,8,8,
Oklahoma,President,Hillary Clinton,DEM,550090,0,0,90,90,
Oklahoma,U.S. Senate,James Lankford,REP,550090,0,0,51,51,
Oklahoma,U.S. Senate,Robert Murphy,LIB,550090,0,0,7,7,
Oklahoma,U.S. Senate,Mike Workman,DEM,550090,0,0,82,82,
Oklahoma,U.S. Senate,Mark Beard,IND,550090,0,0,2,2,
Oklahoma,U.S. Senate,Sean Braddy,IND,550090,0,0,1,1,
Oklahoma,U.S. House,Steve Russell,REP,550090,0,0,44,44,05
Oklahoma,U.S. House,Zachary Knight,LIB,550090,0,0,11,11,05
Oklahoma,U.S. House,Al Mcaffrey,DEM,550090,0,0,86,86,05
Oklahoma,State House,Tess Teague,REP,550090,0,0,43,43,10
Oklahoma,State House,Cheryl Hessman,DEM,550090,0,0,98,98,10
Oklahoma,President,Donald Trump,REP,550091,0,0,84,84,
Oklahoma,President,Gary Johnson,LIB,550091,0,0,12,12,
Oklahoma,President,Hillary Clinton,DEM,550091,0,0,98,98,
Oklahoma,U.S. Senate,James Lankford,REP,550091,0,0,83,83,
Oklahoma,U.S. Senate,Robert Murphy,LIB,550091,0,0,12,12,
Oklahoma,U.S. Senate,Mike Workman,DEM,550091,0,0,82,82,
Oklahoma,U.S. Senate,Mark Beard,IND,550091,0,0,8,8,
Oklahoma,U.S. Senate,Sean Braddy,IND,550091,0,0,6,6,
Oklahoma,U.S. House,Tom Cole,REP,550091,0,0,80,80,04
Oklahoma,U.S. House,Sevier White,LIB,550091,0,0,15,15,04
Oklahoma,U.S. House,Christina Owen,DEM,550091,0,0,93,93,04
Oklahoma,State House,Tess Teague,REP,550091,0,0,77,77,10
Oklahoma,State House,Cheryl Hessman,DEM,550091,0,0,107,107,10
Oklahoma,President,Donald Trump,REP,550092,0,0,658,658,
Oklahoma,President,Gary Johnson,LIB,550092,0,0,92,92,
Oklahoma,President,Hillary Clinton,DEM,550092,0,0,603,603,
Oklahoma,U.S. Senate,James Lankford,REP,550092,0,0,711,711,
Oklahoma,U.S. Senate,Robert Murphy,LIB,550092,0,0,44,44,
Oklahoma,U.S. Senate,Mike Workman,DEM,550092,0,0,507,507,
Oklahoma,U.S. Senate,Mark Beard,IND,550092,0,0,37,37,
Oklahoma,U.S. Senate,Sean Braddy,IND,550092,0,0,48,48,
Oklahoma,U.S. House,Tom Cole,REP,550092,0,0,697,697,04
Oklahoma,U.S. House,Sevier White,LIB,550092,0,0,61,61,04
Oklahoma,U.S. House,Christina Owen,DEM,550092,0,0,588,588,04
Oklahoma,State House,Tess Teague,REP,550092,0,0,673,673,10
Oklahoma,State House,Cheryl Hessman,DEM,550092,0,0,654,654,10
Oklahoma,President,Donald Trump,REP,550093,0,0,463,463,
Oklahoma,President,Gary Johnson,LIB,550093,0,0,46,46,
Oklahoma,President,Hillary Clinton,DEM,550093,0,0,187,187,
Oklahoma,U.S. Senate,James Lankford,REP,550093,0,0,524,524,
Oklahoma,U.S. Senate,Robert Murphy,LIB,550093,0,0,19,19,
Oklahoma,U.S. Senate,Mike Workman,DEM,550093,0,0,141,141,
Oklahoma,U.S. Senate,Mark Beard,IND,550093,0,0,6,6,
Oklahoma,U.S. Senate,Sean Braddy,IND,550093,0,0,15,15,
Oklahoma,U.S. House,Tom Cole,REP,550093,0,0,528,528,04
Oklahoma,U.S. House,Sevier White,LIB,550093,0,0,20,20,04
Oklahoma,U.S. House,Christina Owen,DEM,550093,0,0,157,157,04
Oklahoma,State House,Tess Teague,REP,550093,0,0,471,471,10
Oklahoma,State House,Cheryl Hessman,DEM,550093,0,0,224,224,10
Oklahoma,President,Donald Trump,REP,550094,0,0,738,738,
Oklahoma,President,Gary Johnson,LIB,550094,0,0,83,83,
Oklahoma,President,Hillary Clinton,DEM,550094,0,0,321,321,
Oklahoma,U.S. Senate,James Lankford,REP,550094,0,0,796,796,
Oklahoma,U.S. Senate,Robert Murphy,LIB,550094,0,0,40,40,
Oklahoma,U.S. Senate,Mike Workman,DEM,550094,0,0,258,258,
Oklahoma,U.S. Senate,Mark Beard,IND,550094,0,0,27,27,
Oklahoma,U.S. Senate,Sean Braddy,IND,550094,0,0,27,27,
Oklahoma,U.S. House,Tom Cole,REP,550094,0,0,802,802,04
Oklahoma,U.S. House,Sevier White,LIB,550094,0,0,51,51,04
Oklahoma,U.S. House,Christina Owen,DEM,550094,0,0,288,288,04
Oklahoma,State House,Tess Teague,REP,550094,0,0,735,735,10
Oklahoma,State House,Cheryl Hessman,DEM,550094,0,0,387,387,10
Oklahoma,President,Donald Trump,REP,550095,0,0,514,514,
Oklahoma,President,Gary Johnson,LIB,550095,0,0,59,59,
Oklahoma,President,Hillary Clinton,DEM,550095,0,0,249,249,
Oklahoma,U.S. Senate,James Lankford,REP,550095,0,0,574,574,
Oklahoma,U.S. Senate,Robert Murphy,LIB,550095,0,0,27,27,
Oklahoma,U.S. Senate,Mike Workman,DEM,550095,0,0,182,182,
Oklahoma,U.S. Senate,Mark Beard,IND,550095,0,0,16,16,
Oklahoma,U.S. Senate,Sean Braddy,IND,550095,0,0,27,27,
Oklahoma,U.S. House,Tom Cole,REP,550095,0,0,566,566,04
Oklahoma,U.S. House,Sevier White,LIB,550095,0,0,39,39,04
Oklahoma,U.S. House,Christina Owen,DEM,550095,0,0,216,216,04
Oklahoma,State House,Tess Teague,REP,550095,0,0,512,512,10
Oklahoma,State House,Cheryl Hessman,DEM,550095,0,0,291,291,10
Oklahoma,President,Donald Trump,REP,550096,0,0,669,669,
Oklahoma,President,Gary Johnson,LIB,550096,0,0,84,84,
Oklahoma,President,Hillary Clinton,DEM,550096,0,0,438,438,
Oklahoma,U.S. Senate,James Lankford,REP,550096,0,0,737,737,
Oklahoma,U.S. Senate,Robert Murphy,LIB,550096,0,0,44,44,
Oklahoma,U.S. Senate,Mike Workman,DEM,550096,0,0,340,340,
Oklahoma,U.S. Senate,Mark Beard,IND,550096,0,0,27,27,
Oklahoma,U.S. Senate,Sean Braddy,IND,550096,0,0,39,39,
Oklahoma,U.S. House,Tom Cole,REP,550096,0,0,739,739,04
Oklahoma,U.S. House,Sevier White,LIB,550096,0,0,63,63,04
Oklahoma,U.S. House,Christina Owen,DEM,550096,0,0,384,384,04
Oklahoma,State House,Tess Teague,REP,550096,0,0,713,713,10
Oklahoma,State House,Cheryl Hessman,DEM,550096,0,0,459,459,10
Oklahoma,President,Donald Trump,REP,550097,0,0,464,464,
Oklahoma,President,Gary Johnson,LIB,550097,0,0,44,44,
Oklahoma,President,Hillary Clinton,DEM,550097,0,0,250,250,
Oklahoma,U.S. Senate,James Lankford,REP,550097,0,0,497,497,
Oklahoma,U.S. Senate,Robert Murphy,LIB,550097,0,0,27,27,
Oklahoma,U.S. Senate,Mike Workman,DEM,550097,0,0,199,199,
Oklahoma,U.S. Senate,Mark Beard,IND,550097,0,0,12,12,
Oklahoma,U.S. Senate,Sean Braddy,IND,550097,0,0,24,24,
Oklahoma,U.S. House,Tom Cole,REP,550097,0,0,502,502,04
Oklahoma,U.S. House,Sevier White,LIB,550097,0,0,31,31,04
Oklahoma,U.S. House,Christina Owen,DEM,550097,0,0,225,225,04
Oklahoma,State House,Tess Teague,REP,550097,0,0,449,449,10
Oklahoma,State House,Cheryl Hessman,DEM,550097,0,0,294,294,10
Oklahoma,President,Donald Trump,REP,550098,0,0,1072,1072,
Oklahoma,President,Gary Johnson,LIB,550098,0,0,105,105,
Oklahoma,President,Hillary Clinton,DEM,550098,0,0,332,332,
Oklahoma,U.S. Senate,James Lankford,REP,550098,0,0,1130,1130,
Oklahoma,U.S. Senate,Robert Murphy,LIB,550098,0,0,55,55,
Oklahoma,U.S. Senate,Mike Workman,DEM,550098,0,0,260,260,
Oklahoma,U.S. Senate,Mark Beard,IND,550098,0,0,29,29,
Oklahoma,U.S. Senate,Sean Braddy,IND,550098,0,0,42,42,
Oklahoma,U.S. House,Tom Cole,REP,550098,0,0,1124,1124,04
Oklahoma,U.S. House,Sevier White,LIB,550098,0,0,79,79,04
Oklahoma,U.S. House,Christina Owen,DEM,550098,0,0,307,307,04
Oklahoma,State House,Tess Teague,REP,550098,0,0,1037,1037,10
Oklahoma,State House,Cheryl Hessman,DEM,550098,0,0,452,452,10
Oklahoma,President,Donald Trump,REP,550099,0,0,514,514,
Oklahoma,President,Gary Johnson,LIB,550099,0,0,68,68,
Oklahoma,President,Hillary Clinton,DEM,550099,0,0,352,352,
Oklahoma,U.S. Senate,James Lankford,REP,550099,0,0,625,625,
Oklahoma,U.S. Senate,Robert Murphy,LIB,550099,0,0,38,38,
Oklahoma,U.S. Senate,Mike Workman,DEM,550099,0,0,237,237,
Oklahoma,U.S. Senate,Mark Beard,IND,550099,0,0,11,11,
Oklahoma,U.S. Senate,Sean Braddy,IND,550099,0,0,28,28,
Oklahoma,U.S. House,Steve Russell,REP,550099,0,0,593,593,05
Oklahoma,U.S. House,Zachary Knight,LIB,550099,0,0,45,45,05
Oklahoma,U.S. House,Al Mcaffrey,DEM,550099,0,0,290,290,05
Oklahoma,State House,Matt Jackson,REP,550099,0,0,485,485,85
Oklahoma,State House,Cyndi Munson,DEM,550099,0,0,447,447,85
Oklahoma,President,Donald Trump,REP,550100,0,0,670,670,
Oklahoma,President,Gary Johnson,LIB,550100,0,0,94,94,
Oklahoma,President,Hillary Clinton,DEM,550100,0,0,386,386,
Oklahoma,U.S. Senate,James Lankford,REP,550100,0,0,841,841,
Oklahoma,U.S. Senate,Robert Murphy,LIB,550100,0,0,46,46,
Oklahoma,U.S. Senate,Mike Workman,DEM,550100,0,0,248,248,
Oklahoma,U.S. Senate,Mark Beard,IND,550100,0,0,10,10,
Oklahoma,U.S. Senate,Sean Braddy,IND,550100,0,0,13,13,
Oklahoma,U.S. House,Steve Russell,REP,550100,0,0,806,806,05
Oklahoma,U.S. House,Zachary Knight,LIB,550100,0,0,42,42,05
Oklahoma,U.S. House,Al Mcaffrey,DEM,550100,0,0,294,294,05
Oklahoma,President,Donald Trump,REP,550101,0,0,275,275,
Oklahoma,President,Gary Johnson,LIB,550101,0,0,35,35,
Oklahoma,President,Hillary Clinton,DEM,550101,0,0,149,149,
Oklahoma,U.S. Senate,James Lankford,REP,550101,0,0,353,353,
Oklahoma,U.S. Senate,Robert Murphy,LIB,550101,0,0,9,9,
Oklahoma,U.S. Senate,Mike Workman,DEM,550101,0,0,100,100,
Oklahoma,U.S. Senate,Mark Beard,IND,550101,0,0,4,4,
Oklahoma,U.S. Senate,Sean Braddy,IND,550101,0,0,5,5,
Oklahoma,U.S. House,Steve Russell,REP,550101,0,0,334,334,05
Oklahoma,U.S. House,Zachary Knight,LIB,550101,0,0,13,13,05
Oklahoma,U.S. House,Al Mcaffrey,DEM,550101,0,0,123,123,05
Oklahoma,President,Donald Trump,REP,550102,0,0,733,733,
Oklahoma,President,Gary Johnson,LIB,550102,0,0,93,93,
Oklahoma,President,Hillary Clinton,DEM,550102,0,0,449,449,
Oklahoma,U.S. Senate,James Lankford,REP,550102,0,0,867,867,
Oklahoma,U.S. Senate,Robert Murphy,LIB,550102,0,0,49,49,
Oklahoma,U.S. Senate,Mike Workman,DEM,550102,0,0,310,310,
Oklahoma,U.S. Senate,Mark Beard,IND,550102,0,0,23,23,
Oklahoma,U.S. Senate,Sean Braddy,IND,550102,0,0,26,26,
Oklahoma,U.S. House,Steve Russell,REP,550102,0,0,812,812,05
Oklahoma,U.S. House,Zachary Knight,LIB,550102,0,0,78,78,05
Oklahoma,U.S. House,Al Mcaffrey,DEM,550102,0,0,378,378,05
Oklahoma,State House,Matt Jackson,REP,550102,0,0,680,680,85
Oklahoma,State House,Cyndi Munson,DEM,550102,0,0,585,585,85
Oklahoma,President,Donald Trump,REP,550103,0,0,373,373,
Oklahoma,President,Gary Johnson,LIB,550103,0,0,104,104,
Oklahoma,President,Hillary Clinton,DEM,550103,0,0,349,349,
Oklahoma,U.S. Senate,James Lankford,REP,550103,0,0,452,452,
Oklahoma,U.S. Senate,Robert Murphy,LIB,550103,0,0,50,50,
Oklahoma,U.S. Senate,Mike Workman,DEM,550103,0,0,271,271,
Oklahoma,U.S. Senate,Mark Beard,IND,550103,0,0,21,21,
Oklahoma,U.S. Senate,Sean Braddy,IND,550103,0,0,45,45,
Oklahoma,U.S. House,Steve Russell,REP,550103,0,0,405,405,05
Oklahoma,U.S. House,Zachary Knight,LIB,550103,0,0,86,86,05
Oklahoma,U.S. House,Al Mcaffrey,DEM,550103,0,0,334,334,05
Oklahoma,President,Donald Trump,REP,550104,0,0,286,286,
Oklahoma,President,Gary Johnson,LIB,550104,0,0,42,42,
Oklahoma,President,Hillary Clinton,DEM,550104,0,0,353,353,
Oklahoma,U.S. Senate,James Lankford,REP,550104,0,0,338,338,
Oklahoma,U.S. Senate,Robert Murphy,LIB,550104,0,0,20,20,
Oklahoma,U.S. Senate,Mike Workman,DEM,550104,0,0,278,278,
Oklahoma,U.S. Senate,Mark Beard,IND,550104,0,0,15,15,
Oklahoma,U.S. Senate,Sean Braddy,IND,550104,0,0,31,31,
Oklahoma,U.S. House,Steve Russell,REP,550104,0,0,317,317,05
Oklahoma,U.S. House,Zachary Knight,LIB,550104,0,0,39,39,05
Oklahoma,U.S. House,Al Mcaffrey,DEM,550104,0,0,323,323,05
Oklahoma,President,Donald Trump,REP,550105,0,0,494,494,
Oklahoma,President,Gary Johnson,LIB,550105,0,0,80,80,
Oklahoma,President,Hillary Clinton,DEM,550105,0,0,348,348,
Oklahoma,U.S. Senate,James Lankford,REP,550105,0,0,575,575,
Oklahoma,U.S. Senate,Robert Murphy,LIB,550105,0,0,38,38,
Oklahoma,U.S. Senate,Mike Workman,DEM,550105,0,0,253,253,
Oklahoma,U.S. Senate,Mark Beard,IND,550105,0,0,15,15,
Oklahoma,U.S. Senate,Sean Braddy,IND,550105,0,0,47,47,
Oklahoma,U.S. House,Steve Russell,REP,550105,0,0,543,543,05
Oklahoma,U.S. House,Zachary Knight,LIB,550105,0,0,69,69,05
Oklahoma,U.S. House,Al Mcaffrey,DEM,550105,0,0,307,307,05
Oklahoma,President,Donald Trump,REP,550106,0,0,564,564,
Oklahoma,President,Gary Johnson,LIB,550106,0,0,94,94,
Oklahoma,President,Hillary Clinton,DEM,550106,0,0,409,409,
Oklahoma,U.S. Senate,James Lankford,REP,550106,0,0,687,687,
Oklahoma,U.S. Senate,Robert Murphy,LIB,550106,0,0,43,43,
Oklahoma,U.S. Senate,Mike Workman,DEM,550106,0,0,293,293,
Oklahoma,U.S. Senate,Mark Beard,IND,550106,0,0,22,22,
Oklahoma,U.S. Senate,Sean Braddy,IND,550106,0,0,22,22,
Oklahoma,U.S. House,Steve Russell,REP,550106,0,0,635,635,05
Oklahoma,U.S. House,Zachary Knight,LIB,550106,0,0,58,58,05
Oklahoma,U.S. House,Al Mcaffrey,DEM,550106,0,0,361,361,05
Oklahoma,State House,Matt Jackson,REP,550106,0,0,529,529,85
Oklahoma,State House,Cyndi Munson,DEM,550106,0,0,538,538,85
Oklahoma,President,Donald Trump,REP,550107,0,0,275,275,
Oklahoma,President,Gary Johnson,LIB,550107,0,0,35,35,
Oklahoma,President,Hillary Clinton,DEM,550107,0,0,106,106,
Oklahoma,U.S. Senate,James Lankford,REP,550107,0,0,296,296,
Oklahoma,U.S. Senate,Robert Murphy,LIB,550107,0,0,18,18,
Oklahoma,U.S. Senate,Mike Workman,DEM,550107,0,0,85,85,
Oklahoma,U.S. Senate,Mark Beard,IND,550107,0,0,8,8,
Oklahoma,U.S. Senate,Sean Braddy,IND,550107,0,0,10,10,
Oklahoma,U.S. House,Steve Russell,REP,550107,0,0,272,272,05
Oklahoma,U.S. House,Zachary Knight,LIB,550107,0,0,35,35,05
Oklahoma,U.S. House,Al Mcaffrey,DEM,550107,0,0,106,106,05
Oklahoma,State Senate,Adam Pugh,REP,550107,0,0,261,261,41
Oklahoma,State Senate,Richard Prawdzienski,LIB,550107,0,0,28,28,41
Oklahoma,State Senate,Kevin Mcdonald,DEM,550107,0,0,122,122,41
Oklahoma,President,Donald Trump,REP,550108,0,0,204,204,
Oklahoma,President,Gary Johnson,LIB,550108,0,0,18,18,
Oklahoma,President,Hillary Clinton,DEM,550108,0,0,79,79,
Oklahoma,U.S. Senate,James Lankford,REP,550108,0,0,225,225,
Oklahoma,U.S. Senate,Robert Murphy,LIB,550108,0,0,9,9,
Oklahoma,U.S. Senate,Mike Workman,DEM,550108,0,0,68,68,
Oklahoma,U.S. Senate,Mark Beard,IND,550108,0,0,2,2,
Oklahoma,U.S. Senate,Sean Braddy,IND,550108,0,0,3,3,
Oklahoma,U.S. House,Steve Russell,REP,550108,0,0,212,212,05
Oklahoma,U.S. House,Zachary Knight,LIB,550108,0,0,18,18,05
Oklahoma,U.S. House,Al Mcaffrey,DEM,550108,0,0,73,73,05
Oklahoma,State Senate,Adam Pugh,REP,550108,0,0,194,194,41
Oklahoma,State Senate,Richard Prawdzienski,LIB,550108,0,0,12,12,41
Oklahoma,State Senate,Kevin Mcdonald,DEM,550108,0,0,96,96,41
Oklahoma,President,Donald Trump,REP,550109,0,0,920,920,
Oklahoma,President,Gary Johnson,LIB,550109,0,0,103,103,
Oklahoma,President,Hillary Clinton,DEM,550109,0,0,443,443,
Oklahoma,U.S. Senate,James Lankford,REP,550109,0,0,1088,1088,
Oklahoma,U.S. Senate,Robert Murphy,LIB,550109,0,0,38,38,
Oklahoma,U.S. Senate,Mike Workman,DEM,550109,0,0,320,320,
Oklahoma,U.S. Senate,Mark Beard,IND,550109,0,0,16,16,
Oklahoma,U.S. Senate,Sean Braddy,IND,550109,0,0,21,21,
Oklahoma,U.S. House,Steve Russell,REP,550109,0,0,1055,1055,05
Oklahoma,U.S. House,Zachary Knight,LIB,550109,0,0,51,51,05
Oklahoma,U.S. House,Al Mcaffrey,DEM,550109,0,0,368,368,05
Oklahoma,State House,Tonni Canaday,REP,550109,0,0,992,992,97
Oklahoma,State House,Jason Lowe,DEM,550109,0,0,445,445,97
Oklahoma,President,Donald Trump,REP,550110,0,0,251,251,
Oklahoma,President,Gary Johnson,LIB,550110,0,0,43,43,
Oklahoma,President,Hillary Clinton,DEM,550110,0,0,107,107,
Oklahoma,U.S. Senate,James Lankford,REP,550110,0,0,290,290,
Oklahoma,U.S. Senate,Robert Murphy,LIB,550110,0,0,15,15,
Oklahoma,U.S. Senate,Mike Workman,DEM,550110,0,0,78,78,
Oklahoma,U.S. Senate,Mark Beard,IND,550110,0,0,4,4,
Oklahoma,U.S. Senate,Sean Braddy,IND,550110,0,0,10,10,
Oklahoma,U.S. House,Steve Russell,REP,550110,0,0,279,279,05
Oklahoma,U.S. House,Zachary Knight,LIB,550110,0,0,22,22,05
Oklahoma,U.S. House,Al Mcaffrey,DEM,550110,0,0,93,93,05
Oklahoma,State Senate,Adam Pugh,REP,550110,0,0,262,262,41
Oklahoma,State Senate,Richard Prawdzienski,LIB,550110,0,0,17,17,41
Oklahoma,State Senate,Kevin Mcdonald,DEM,550110,0,0,116,116,41
Oklahoma,State House,Tonni Canaday,REP,550110,0,0,280,280,97
Oklahoma,State House,Jason Lowe,DEM,550110,0,0,103,103,97
Oklahoma,President,Donald Trump,REP,550111,0,0,891,891,
Oklahoma,President,Gary Johnson,LIB,550111,0,0,128,128,
Oklahoma,President,Hillary Clinton,DEM,550111,0,0,408,408,
Oklahoma,U.S. Senate,James Lankford,REP,550111,0,0,1054,1054,
Oklahoma,U.S. Senate,Robert Murphy,LIB,550111,0,0,65,65,
Oklahoma,U.S. Senate,Mike Workman,DEM,550111,0,0,288,288,
Oklahoma,U.S. Senate,Mark Beard,IND,550111,0,0,20,20,
Oklahoma,U.S. Senate,Sean Braddy,IND,550111,0,0,31,31,
Oklahoma,U.S. House,Steve Russell,REP,550111,0,0,1023,1023,05
Oklahoma,U.S. House,Zachary Knight,LIB,550111,0,0,80,80,05
Oklahoma,U.S. House,Al Mcaffrey,DEM,550111,0,0,343,343,05
Oklahoma,State Senate,Adam Pugh,REP,550111,0,0,918,918,41
Oklahoma,State Senate,Richard Prawdzienski,LIB,550111,0,0,61,61,41
Oklahoma,State Senate,Kevin Mcdonald,DEM,550111,0,0,467,467,41
Oklahoma,State House,Mike Osburn,REP,550111,0,0,929,929,81
Oklahoma,State House,Steve Long,LIB,550111,0,0,103,103,81
Oklahoma,State House,Dan Myers,DEM,550111,0,0,392,392,81
Oklahoma,President,Donald Trump,REP,550112,0,0,93,93,
Oklahoma,President,Gary Johnson,LIB,550112,0,0,12,12,
Oklahoma,President,Hillary Clinton,DEM,550112,0,0,47,47,
Oklahoma,U.S. Senate,James Lankford,REP,550112,0,0,116,116,
Oklahoma,U.S. Senate,Robert Murphy,LIB,550112,0,0,1,1,
Oklahoma,U.S. Senate,Mike Workman,DEM,550112,0,0,30,30,
Oklahoma,U.S. Senate,Mark Beard,IND,550112,0,0,3,3,
Oklahoma,U.S. Senate,Sean Braddy,IND,550112,0,0,7,7,
Oklahoma,U.S. House,Steve Russell,REP,550112,0,0,107,107,05
Oklahoma,U.S. House,Zachary Knight,LIB,550112,0,0,6,6,05
Oklahoma,U.S. House,Al Mcaffrey,DEM,550112,0,0,43,43,05
Oklahoma,State House,Tonni Canaday,REP,550112,0,0,104,104,97
Oklahoma,State House,Jason Lowe,DEM,550112,0,0,50,50,97
Oklahoma,President,Donald Trump,REP,550113,0,0,145,145,
Oklahoma,President,Gary Johnson,LIB,550113,0,0,22,22,
Oklahoma,President,Hillary Clinton,DEM,550113,0,0,95,95,
Oklahoma,U.S. Senate,James Lankford,REP,550113,0,0,174,174,
Oklahoma,U.S. Senate,Robert Murphy,LIB,550113,0,0,11,11,
Oklahoma,U.S. Senate,Mike Workman,DEM,550113,0,0,73,73,
Oklahoma,U.S. Senate,Mark Beard,IND,550113,0,0,0,0,
Oklahoma,U.S. Senate,Sean Braddy,IND,550113,0,0,2,2,
Oklahoma,U.S. House,Steve Russell,REP,550113,0,0,152,152,05
Oklahoma,U.S. House,Zachary Knight,LIB,550113,0,0,13,13,05
Oklahoma,U.S. House,Al Mcaffrey,DEM,550113,0,0,97,97,05
Oklahoma,State House,Tonni Canaday,REP,550113,0,0,143,143,97
Oklahoma,State House,Jason Lowe,DEM,550113,0,0,111,111,97
Oklahoma,President,Donald Trump,REP,550114,0,0,82,82,
Oklahoma,President,Gary Johnson,LIB,550114,0,0,18,18,
Oklahoma,President,Hillary Clinton,DEM,550114,0,0,664,664,
Oklahoma,U.S. Senate,James Lankford,REP,550114,0,0,134,134,
Oklahoma,U.S. Senate,Robert Murphy,LIB,550114,0,0,13,13,
Oklahoma,U.S. Senate,Mike Workman,DEM,550114,0,0,582,582,
Oklahoma,U.S. Senate,Mark Beard,IND,550114,0,0,8,8,
Oklahoma,U.S. Senate,Sean Braddy,IND,550114,0,0,21,21,
Oklahoma,U.S. House,Steve Russell,REP,550114,0,0,103,103,05
Oklahoma,U.S. House,Zachary Knight,LIB,550114,0,0,17,17,05
Oklahoma,U.S. House,Al Mcaffrey,DEM,550114,0,0,638,638,05
Oklahoma,State House,Tonni Canaday,REP,550114,0,0,94,94,97
Oklahoma,State House,Jason Lowe,DEM,550114,0,0,664,664,97
Oklahoma,President,Donald Trump,REP,550115,0,0,38,38,
Oklahoma,President,Gary Johnson,LIB,550115,0,0,31,31,
Oklahoma,President,Hillary Clinton,DEM,550115,0,0,929,929,
Oklahoma,U.S. Senate,James Lankford,REP,550115,0,0,97,97,
Oklahoma,U.S. Senate,Robert Murphy,LIB,550115,0,0,22,22,
Oklahoma,U.S. Senate,Mike Workman,DEM,550115,0,0,805,805,
Oklahoma,U.S. Senate,Mark Beard,IND,550115,0,0,17,17,
Oklahoma,U.S. Senate,Sean Braddy,IND,550115,0,0,53,53,
Oklahoma,U.S. House,Steve Russell,REP,550115,0,0,62,62,05
Oklahoma,U.S. House,Zachary Knight,LIB,550115,0,0,36,36,05
Oklahoma,U.S. House,Al Mcaffrey,DEM,550115,0,0,897,897,05
Oklahoma,State House,Tonni Canaday,REP,550115,0,0,56,56,97
Oklahoma,State House,Jason Lowe,DEM,550115,0,0,940,940,97
Oklahoma,President,Donald Trump,REP,550116,0,0,159,159,
Oklahoma,President,Gary Johnson,LIB,550116,0,0,54,54,
Oklahoma,President,Hillary Clinton,DEM,550116,0,0,221,221,
Oklahoma,U.S. Senate,James Lankford,REP,550116,0,0,205,205,
Oklahoma,U.S. Senate,Robert Murphy,LIB,550116,0,0,29,29,
Oklahoma,U.S. Senate,Mike Workman,DEM,550116,0,0,172,172,
Oklahoma,U.S. Senate,Mark Beard,IND,550116,0,0,4,4,
Oklahoma,U.S. Senate,Sean Braddy,IND,550116,0,0,23,23,
Oklahoma,U.S. House,Steve Russell,REP,550116,0,0,183,183,05
Oklahoma,U.S. House,Zachary Knight,LIB,550116,0,0,43,43,05
Oklahoma,U.S. House,Al Mcaffrey,DEM,550116,0,0,204,204,05
Oklahoma,State House,George Young,DEM,550116,0,0,253,253,99
Oklahoma,State House,Marina Mangiaracina,IND,550116,0,0,125,125,99
Oklahoma,President,Donald Trump,REP,550117,0,0,122,122,
Oklahoma,President,Gary Johnson,LIB,550117,0,0,35,35,
Oklahoma,President,Hillary Clinton,DEM,550117,0,0,1003,1003,
Oklahoma,U.S. Senate,James Lankford,REP,550117,0,0,195,195,
Oklahoma,U.S. Senate,Robert Murphy,LIB,550117,0,0,26,26,
Oklahoma,U.S. Senate,Mike Workman,DEM,550117,0,0,868,868,
Oklahoma,U.S. Senate,Mark Beard,IND,550117,0,0,21,21,
Oklahoma,U.S. Senate,Sean Braddy,IND,550117,0,0,46,46,
Oklahoma,U.S. House,Steve Russell,REP,550117,0,0,145,145,05
Oklahoma,U.S. House,Zachary Knight,LIB,550117,0,0,40,40,05
Oklahoma,U.S. House,Al Mcaffrey,DEM,550117,0,0,970,970,05
Oklahoma,State House,Tonni Canaday,REP,550117,0,0,124,124,97
Oklahoma,State House,Jason Lowe,DEM,550117,0,0,1025,1025,97
Oklahoma,President,Donald Trump,REP,550118,0,0,208,208,
Oklahoma,President,Gary Johnson,LIB,550118,0,0,65,65,
Oklahoma,President,Hillary Clinton,DEM,550118,0,0,829,829,
Oklahoma,U.S. Senate,James Lankford,REP,550118,0,0,262,262,
Oklahoma,U.S. Senate,Robert Murphy,LIB,550118,0,0,42,42,
Oklahoma,U.S. Senate,Mike Workman,DEM,550118,0,0,714,714,
Oklahoma,U.S. Senate,Mark Beard,IND,550118,0,0,33,33,
Oklahoma,U.S. Senate,Sean Braddy,IND,550118,0,0,48,48,
Oklahoma,U.S. House,Steve Russell,REP,550118,0,0,227,227,05
Oklahoma,U.S. House,Zachary Knight,LIB,550118,0,0,88,88,05
Oklahoma,U.S. House,Al Mcaffrey,DEM,550118,0,0,778,778,05
Oklahoma,State House,George Young,DEM,550118,0,0,838,838,99
Oklahoma,State House,Marina Mangiaracina,IND,550118,0,0,215,215,99
Oklahoma,President,Donald Trump,REP,550119,0,0,69,69,
Oklahoma,President,Gary Johnson,LIB,550119,0,0,17,17,
Oklahoma,President,Hillary Clinton,DEM,550119,0,0,81,81,
Oklahoma,U.S. Senate,James Lankford,REP,550119,0,0,83,83,
Oklahoma,U.S. Senate,Robert Murphy,LIB,550119,0,0,11,11,
Oklahoma,U.S. Senate,Mike Workman,DEM,550119,0,0,64,64,
Oklahoma,U.S. Senate,Mark Beard,IND,550119,0,0,3,3,
Oklahoma,U.S. Senate,Sean Braddy,IND,550119,0,0,6,6,
Oklahoma,U.S. House,Steve Russell,REP,550119,0,0,81,81,05
Oklahoma,U.S. House,Zachary Knight,LIB,550119,0,0,13,13,05
Oklahoma,U.S. House,Al Mcaffrey,DEM,550119,0,0,73,73,05
Oklahoma,President,Donald Trump,REP,550120,0,0,203,203,
Oklahoma,President,Gary Johnson,LIB,550120,0,0,61,61,
Oklahoma,President,Hillary Clinton,DEM,550120,0,0,679,679,
Oklahoma,U.S. Senate,James Lankford,REP,550120,0,0,242,242,
Oklahoma,U.S. Senate,Robert Murphy,LIB,550120,0,0,36,36,
Oklahoma,U.S. Senate,Mike Workman,DEM,550120,0,0,574,574,
Oklahoma,U.S. Senate,Mark Beard,IND,550120,0,0,25,25,
Oklahoma,U.S. Senate,Sean Braddy,IND,550120,0,0,62,62,
Oklahoma,U.S. House,Steve Russell,REP,550120,0,0,212,212,05
Oklahoma,U.S. House,Zachary Knight,LIB,550120,0,0,65,65,05
Oklahoma,U.S. House,Al Mcaffrey,DEM,550120,0,0,658,658,05
Oklahoma,State House,George Young,DEM,550120,0,0,692,692,99
Oklahoma,State House,Marina Mangiaracina,IND,550120,0,0,207,207,99
Oklahoma,President,Donald Trump,REP,550121,0,0,250,250,
Oklahoma,President,Gary Johnson,LIB,550121,0,0,99,99,
Oklahoma,President,Hillary Clinton,DEM,550121,0,0,964,964,
Oklahoma,U.S. Senate,James Lankford,REP,550121,0,0,334,334,
Oklahoma,U.S. Senate,Robert Murphy,LIB,550121,0,0,49,49,
Oklahoma,U.S. Senate,Mike Workman,DEM,550121,0,0,832,832,
Oklahoma,U.S. Senate,Mark Beard,IND,550121,0,0,32,32,
Oklahoma,U.S. Senate,Sean Braddy,IND,550121,0,0,68,68,
Oklahoma,U.S. House,Steve Russell,REP,550121,0,0,297,297,05
Oklahoma,U.S. House,Zachary Knight,LIB,550121,0,0,89,89,05
Oklahoma,U.S. House,Al Mcaffrey,DEM,550121,0,0,924,924,05
Oklahoma,State House,George Young,DEM,550121,0,0,985,985,99
Oklahoma,State House,Marina Mangiaracina,IND,550121,0,0,265,265,99
Oklahoma,President,Donald Trump,REP,550122,0,0,217,217,
Oklahoma,President,Gary Johnson,LIB,550122,0,0,57,57,
Oklahoma,President,Hillary Clinton,DEM,550122,0,0,607,607,
Oklahoma,U.S. Senate,James Lankford,REP,550122,0,0,274,274,
Oklahoma,U.S. Senate,Robert Murphy,LIB,550122,0,0,31,31,
Oklahoma,U.S. Senate,Mike Workman,DEM,550122,0,0,498,498,
Oklahoma,U.S. Senate,Mark Beard,IND,550122,0,0,28,28,
Oklahoma,U.S. Senate,Sean Braddy,IND,550122,0,0,51,51,
Oklahoma,U.S. House,Steve Russell,REP,550122,0,0,241,241,05
Oklahoma,U.S. House,Zachary Knight,LIB,550122,0,0,63,63,05
Oklahoma,U.S. House,Al Mcaffrey,DEM,550122,0,0,571,571,05
Oklahoma,State House,George Young,DEM,550122,0,0,600,600,99
Oklahoma,State House,Marina Mangiaracina,IND,550122,0,0,200,200,99
Oklahoma,President,Donald Trump,REP,550123,0,0,254,254,
Oklahoma,President,Gary Johnson,LIB,550123,0,0,52,52,
Oklahoma,President,Hillary Clinton,DEM,550123,0,0,601,601,
Oklahoma,U.S. Senate,James Lankford,REP,550123,0,0,314,314,
Oklahoma,U.S. Senate,Robert Murphy,LIB,550123,0,0,22,22,
Oklahoma,U.S. Senate,Mike Workman,DEM,550123,0,0,505,505,
Oklahoma,U.S. Senate,Mark Beard,IND,550123,0,0,27,27,
Oklahoma,U.S. Senate,Sean Braddy,IND,550123,0,0,38,38,
Oklahoma,U.S. House,Steve Russell,REP,550123,0,0,294,294,05
Oklahoma,U.S. House,Zachary Knight,LIB,550123,0,0,47,47,05
Oklahoma,U.S. House,Al Mcaffrey,DEM,550123,0,0,563,563,05
Oklahoma,State House,George Young,DEM,550123,0,0,633,633,99
Oklahoma,State House,Marina Mangiaracina,IND,550123,0,0,194,194,99
Oklahoma,President,Donald Trump,REP,550124,0,0,323,323,
Oklahoma,President,Gary Johnson,LIB,550124,0,0,60,60,
Oklahoma,President,Hillary Clinton,DEM,550124,0,0,509,509,
Oklahoma,U.S. Senate,James Lankford,REP,550124,0,0,399,399,
Oklahoma,U.S. Senate,Robert Murphy,LIB,550124,0,0,32,32,
Oklahoma,U.S. Senate,Mike Workman,DEM,550124,0,0,422,422,
Oklahoma,U.S. Senate,Mark Beard,IND,550124,0,0,19,19,
Oklahoma,U.S. Senate,Sean Braddy,IND,550124,0,0,31,31,
Oklahoma,U.S. House,Steve Russell,REP,550124,0,0,375,375,05
Oklahoma,U.S. House,Zachary Knight,LIB,550124,0,0,54,54,05
Oklahoma,U.S. House,Al Mcaffrey,DEM,550124,0,0,469,469,05
Oklahoma,President,Donald Trump,REP,550125,0,0,135,135,
Oklahoma,President,Gary Johnson,LIB,550125,0,0,72,72,
Oklahoma,President,Hillary Clinton,DEM,550125,0,0,374,374,
Oklahoma,U.S. Senate,James Lankford,REP,550125,0,0,175,175,
Oklahoma,U.S. Senate,Robert Murphy,LIB,550125,0,0,26,26,
Oklahoma,U.S. Senate,Mike Workman,DEM,550125,0,0,312,312,
Oklahoma,U.S. Senate,Mark Beard,IND,550125,0,0,11,11,
Oklahoma,U.S. Senate,Sean Braddy,IND,550125,0,0,48,48,
Oklahoma,U.S. House,Steve Russell,REP,550125,0,0,164,164,05
Oklahoma,U.S. House,Zachary Knight,LIB,550125,0,0,56,56,05
Oklahoma,U.S. House,Al Mcaffrey,DEM,550125,0,0,350,350,05
Oklahoma,State House,George Young,DEM,550125,0,0,390,390,99
Oklahoma,State House,Marina Mangiaracina,IND,550125,0,0,157,157,99
Oklahoma,President,Donald Trump,REP,550126,0,0,264,264,
Oklahoma,President,Gary Johnson,LIB,550126,0,0,64,64,
Oklahoma,President,Hillary Clinton,DEM,550126,0,0,609,609,
Oklahoma,U.S. Senate,James Lankford,REP,550126,0,0,328,328,
Oklahoma,U.S. Senate,Robert Murphy,LIB,550126,0,0,37,37,
Oklahoma,U.S. Senate,Mike Workman,DEM,550126,0,0,502,502,
Oklahoma,U.S. Senate,Mark Beard,IND,550126,0,0,27,27,
Oklahoma,U.S. Senate,Sean Braddy,IND,550126,0,0,38,38,
Oklahoma,U.S. House,Steve Russell,REP,550126,0,0,284,284,05
Oklahoma,U.S. House,Zachary Knight,LIB,550126,0,0,67,67,05
Oklahoma,U.S. House,Al Mcaffrey,DEM,550126,0,0,574,574,05
Oklahoma,President,Donald Trump,REP,550127,0,0,589,589,
Oklahoma,President,Gary Johnson,LIB,550127,0,0,68,68,
Oklahoma,President,Hillary Clinton,DEM,550127,0,0,444,444,
Oklahoma,U.S. Senate,James Lankford,REP,550127,0,0,678,678,
Oklahoma,U.S. Senate,Robert Murphy,LIB,550127,0,0,37,37,
Oklahoma,U.S. Senate,Mike Workman,DEM,550127,0,0,329,329,
Oklahoma,U.S. Senate,Mark Beard,IND,550127,0,0,17,17,
Oklahoma,U.S. Senate,Sean Braddy,IND,550127,0,0,38,38,
Oklahoma,U.S. House,Steve Russell,REP,550127,0,0,656,656,05
Oklahoma,U.S. House,Zachary Knight,LIB,550127,0,0,64,64,05
Oklahoma,U.S. House,Al Mcaffrey,DEM,550127,0,0,373,373,05
Oklahoma,State Senate,Greg Treat,REP,550127,0,0,590,590,47
Oklahoma,State Senate,Judy Mullen Hopper,DEM,550127,0,0,425,425,47
Oklahoma,State Senate,Steven Weber,IND,550127,0,0,66,66,47
Oklahoma,President,Donald Trump,REP,550128,0,0,589,589,
Oklahoma,President,Gary Johnson,LIB,550128,0,0,84,84,
Oklahoma,President,Hillary Clinton,DEM,550128,0,0,496,496,
Oklahoma,U.S. Senate,James Lankford,REP,550128,0,0,658,658,
Oklahoma,U.S. Senate,Robert Murphy,LIB,550128,0,0,50,50,
Oklahoma,U.S. Senate,Mike Workman,DEM,550128,0,0,392,392,
Oklahoma,U.S. Senate,Mark Beard,IND,550128,0,0,19,19,
Oklahoma,U.S. Senate,Sean Braddy,IND,550128,0,0,53,53,
Oklahoma,U.S. House,Steve Russell,REP,550128,0,0,632,632,05
Oklahoma,U.S. House,Zachary Knight,LIB,550128,0,0,81,81,05
Oklahoma,U.S. House,Al Mcaffrey,DEM,550128,0,0,456,456,05
Oklahoma,State Senate,Greg Treat,REP,550128,0,0,576,576,47
Oklahoma,State Senate,Judy Mullen Hopper,DEM,550128,0,0,495,495,47
Oklahoma,State Senate,Steven Weber,IND,550128,0,0,91,91,47
Oklahoma,President,Donald Trump,REP,550129,0,0,324,324,
Oklahoma,President,Gary Johnson,LIB,550129,0,0,49,49,
Oklahoma,President,Hillary Clinton,DEM,550129,0,0,299,299,
Oklahoma,U.S. Senate,James Lankford,REP,550129,0,0,398,398,
Oklahoma,U.S. Senate,Robert Murphy,LIB,550129,0,0,26,26,
Oklahoma,U.S. Senate,Mike Workman,DEM,550129,0,0,224,224,
Oklahoma,U.S. Senate,Mark Beard,IND,550129,0,0,12,12,
Oklahoma,U.S. Senate,Sean Braddy,IND,550129,0,0,20,20,
Oklahoma,U.S. House,Steve Russell,REP,550129,0,0,383,383,05
Oklahoma,U.S. House,Zachary Knight,LIB,550129,0,0,47,47,05
Oklahoma,U.S. House,Al Mcaffrey,DEM,550129,0,0,242,242,05
Oklahoma,State Senate,Greg Treat,REP,550129,0,0,339,339,47
Oklahoma,State Senate,Judy Mullen Hopper,DEM,550129,0,0,271,271,47
Oklahoma,State Senate,Steven Weber,IND,550129,0,0,52,52,47
Oklahoma,President,Donald Trump,REP,550130,0,0,767,767,
Oklahoma,President,Gary Johnson,LIB,550130,0,0,128,128,
Oklahoma,President,Hillary Clinton,DEM,550130,0,0,593,593,
Oklahoma,U.S. Senate,James Lankford,REP,550130,0,0,898,898,
Oklahoma,U.S. Senate,Robert Murphy,LIB,550130,0,0,57,57,
Oklahoma,U.S. Senate,Mike Workman,DEM,550130,0,0,469,469,
Oklahoma,U.S. Senate,Mark Beard,IND,550130,0,0,28,28,
Oklahoma,U.S. Senate,Sean Braddy,IND,550130,0,0,40,40,
Oklahoma,U.S. House,Steve Russell,REP,550130,0,0,877,877,05
Oklahoma,U.S. House,Zachary Knight,LIB,550130,0,0,81,81,05
Oklahoma,U.S. House,Al Mcaffrey,DEM,550130,0,0,519,519,05
Oklahoma,State Senate,Greg Treat,REP,550130,0,0,781,781,47
Oklahoma,State Senate,Judy Mullen Hopper,DEM,550130,0,0,589,589,47
Oklahoma,State Senate,Steven Weber,IND,550130,0,0,97,97,47
Oklahoma,President,Donald Trump,REP,550131,0,0,429,429,
Oklahoma,President,Gary Johnson,LIB,550131,0,0,59,59,
Oklahoma,President,Hillary Clinton,DEM,550131,0,0,211,211,
Oklahoma,U.S. Senate,James Lankford,REP,550131,0,0,507,507,
Oklahoma,U.S. Senate,Robert Murphy,LIB,550131,0,0,18,18,
Oklahoma,U.S. Senate,Mike Workman,DEM,550131,0,0,154,154,
Oklahoma,U.S. Senate,Mark Beard,IND,550131,0,0,8,8,
Oklahoma,U.S. Senate,Sean Braddy,IND,550131,0,0,12,12,
Oklahoma,U.S. House,Steve Russell,REP,550131,0,0,489,489,05
Oklahoma,U.S. House,Zachary Knight,LIB,550131,0,0,34,34,05
Oklahoma,U.S. House,Al Mcaffrey,DEM,550131,0,0,169,169,05
Oklahoma,State Senate,Greg Treat,REP,550131,0,0,435,435,47
Oklahoma,State Senate,Judy Mullen Hopper,DEM,550131,0,0,208,208,47
Oklahoma,State Senate,Steven Weber,IND,550131,0,0,40,40,47
Oklahoma,President,Donald Trump,REP,550132,0,0,529,529,
Oklahoma,President,Gary Johnson,LIB,550132,0,0,44,44,
Oklahoma,President,Hillary Clinton,DEM,550132,0,0,327,327,
Oklahoma,U.S. Senate,James Lankford,REP,550132,0,0,590,590,
Oklahoma,U.S. Senate,Robert Murphy,LIB,550132,0,0,21,21,
Oklahoma,U.S. Senate,Mike Workman,DEM,550132,0,0,254,254,
Oklahoma,U.S. Senate,Mark Beard,IND,550132,0,0,7,7,
Oklahoma,U.S. Senate,Sean Braddy,IND,550132,0,0,30,30,
Oklahoma,U.S. House,Steve Russell,REP,550132,0,0,560,560,05
Oklahoma,U.S. House,Zachary Knight,LIB,550132,0,0,40,40,05
Oklahoma,U.S. House,Al Mcaffrey,DEM,550132,0,0,296,296,05
Oklahoma,State Senate,Greg Treat,REP,550132,0,0,515,515,47
Oklahoma,State Senate,Judy Mullen Hopper,DEM,550132,0,0,314,314,47
Oklahoma,State Senate,Steven Weber,IND,550132,0,0,64,64,47
Oklahoma,President,Donald Trump,REP,550133,0,0,521,521,
Oklahoma,President,Gary Johnson,LIB,550133,0,0,77,77,
Oklahoma,President,Hillary Clinton,DEM,550133,0,0,349,349,
Oklahoma,U.S. Senate,James Lankford,REP,550133,0,0,595,595,
Oklahoma,U.S. Senate,Robert Murphy,LIB,550133,0,0,40,40,
Oklahoma,U.S. Senate,Mike Workman,DEM,550133,0,0,248,248,
Oklahoma,U.S. Senate,Mark Beard,IND,550133,0,0,21,21,
Oklahoma,U.S. Senate,Sean Braddy,IND,550133,0,0,35,35,
Oklahoma,U.S. House,Steve Russell,REP,550133,0,0,574,574,05
Oklahoma,U.S. House,Zachary Knight,LIB,550133,0,0,68,68,05
Oklahoma,U.S. House,Al Mcaffrey,DEM,550133,0,0,281,281,05
Oklahoma,State House,Ryan Martinez,REP,550133,0,0,609,609,39
Oklahoma,State House,Clark Duffe,LIB,550133,0,0,259,259,39
Oklahoma,President,Donald Trump,REP,550134,0,0,1017,1017,
Oklahoma,President,Gary Johnson,LIB,550134,0,0,133,133,
Oklahoma,President,Hillary Clinton,DEM,550134,0,0,549,549,
Oklahoma,U.S. Senate,James Lankford,REP,550134,0,0,1146,1146,
Oklahoma,U.S. Senate,Robert Murphy,LIB,550134,0,0,60,60,
Oklahoma,U.S. Senate,Mike Workman,DEM,550134,0,0,429,429,
Oklahoma,U.S. Senate,Mark Beard,IND,550134,0,0,21,21,
Oklahoma,U.S. Senate,Sean Braddy,IND,550134,0,0,41,41,
Oklahoma,U.S. House,Steve Russell,REP,550134,0,0,1091,1091,05
Oklahoma,U.S. House,Zachary Knight,LIB,550134,0,0,103,103,05
Oklahoma,U.S. House,Al Mcaffrey,DEM,550134,0,0,478,478,05
Oklahoma,State House,Kevin Calvey,REP,550134,0,0,970,970,82
Oklahoma,State House,Misty Warfield,DEM,550134,0,0,511,511,82
Oklahoma,State House,Christopher Crawford,IND,550134,0,0,147,147,82
Oklahoma,State House,David Dickerson,IND,550134,0,0,29,29,82
Oklahoma,President,Donald Trump,REP,550135,0,0,387,387,
Oklahoma,President,Gary Johnson,LIB,550135,0,0,59,59,
Oklahoma,President,Hillary Clinton,DEM,550135,0,0,210,210,
Oklahoma,U.S. Senate,James Lankford,REP,550135,0,0,452,452,
Oklahoma,U.S. Senate,Robert Murphy,LIB,550135,0,0,34,34,
Oklahoma,U.S. Senate,Mike Workman,DEM,550135,0,0,153,153,
Oklahoma,U.S. Senate,Mark Beard,IND,550135,0,0,6,6,
Oklahoma,U.S. Senate,Sean Braddy,IND,550135,0,0,18,18,
Oklahoma,U.S. House,Steve Russell,REP,550135,0,0,425,425,05
Oklahoma,U.S. House,Zachary Knight,LIB,550135,0,0,36,36,05
Oklahoma,U.S. House,Al Mcaffrey,DEM,550135,0,0,194,194,05
Oklahoma,State House,Kevin Calvey,REP,550135,0,0,362,362,82
Oklahoma,State House,Misty Warfield,DEM,550135,0,0,218,218,82
Oklahoma,State House,Christopher Crawford,IND,550135,0,0,50,50,82
Oklahoma,State House,David Dickerson,IND,550135,0,0,12,12,82
Oklahoma,President,Donald Trump,REP,550136,0,0,1223,1223,
Oklahoma,President,Gary Johnson,LIB,550136,0,0,161,161,
Oklahoma,President,Hillary Clinton,DEM,550136,0,0,704,704,
Oklahoma,U.S. Senate,James Lankford,REP,550136,0,0,1397,1397,
Oklahoma,U.S. Senate,Robert Murphy,LIB,550136,0,0,73,73,
Oklahoma,U.S. Senate,Mike Workman,DEM,550136,0,0,519,519,
Oklahoma,U.S. Senate,Mark Beard,IND,550136,0,0,42,42,
Oklahoma,U.S. Senate,Sean Braddy,IND,550136,0,0,68,68,
Oklahoma,U.S. House,Steve Russell,REP,550136,0,0,1339,1339,05
Oklahoma,U.S. House,Zachary Knight,LIB,550136,0,0,143,143,05
Oklahoma,U.S. House,Al Mcaffrey,DEM,550136,0,0,595,595,05
Oklahoma,State House,Kevin Calvey,REP,550136,0,0,1180,1180,82
Oklahoma,State House,Misty Warfield,DEM,550136,0,0,648,648,82
Oklahoma,State House,Christopher Crawford,IND,550136,0,0,185,185,82
Oklahoma,State House,David Dickerson,IND,550136,0,0,41,41,82
Oklahoma,President,Donald Trump,REP,550137,0,0,1033,1033,
Oklahoma,President,Gary Johnson,LIB,550137,0,0,132,132,
Oklahoma,President,Hillary Clinton,DEM,550137,0,0,331,331,
Oklahoma,U.S. Senate,James Lankford,REP,550137,0,0,1185,1185,
Oklahoma,U.S. Senate,Robert Murphy,LIB,550137,0,0,51,51,
Oklahoma,U.S. Senate,Mike Workman,DEM,550137,0,0,205,205,
Oklahoma,U.S. Senate,Mark Beard,IND,550137,0,0,27,27,
Oklahoma,U.S. Senate,Sean Braddy,IND,550137,0,0,26,26,
Oklahoma,U.S. House,Steve Russell,REP,550137,0,0,1147,1147,05
Oklahoma,U.S. House,Zachary Knight,LIB,550137,0,0,67,67,05
Oklahoma,U.S. House,Al Mcaffrey,DEM,550137,0,0,265,265,05
Oklahoma,State House,Kevin Calvey,REP,550137,0,0,1038,1038,82
Oklahoma,State House,Misty Warfield,DEM,550137,0,0,315,315,82
Oklahoma,State House,Christopher Crawford,IND,550137,0,0,73,73,82
Oklahoma,State House,David Dickerson,IND,550137,0,0,27,27,82
Oklahoma,President,Donald Trump,REP,550138,0,0,432,432,
Oklahoma,President,Gary Johnson,LIB,550138,0,0,43,43,
Oklahoma,President,Hillary Clinton,DEM,550138,0,0,101,101,
Oklahoma,U.S. Senate,James Lankford,REP,550138,0,0,470,470,
Oklahoma,U.S. Senate,Robert Murphy,LIB,550138,0,0,20,20,
Oklahoma,U.S. Senate,Mike Workman,DEM,550138,0,0,70,70,
Oklahoma,U.S. Senate,Mark Beard,IND,550138,0,0,12,12,
Oklahoma,U.S. Senate,Sean Braddy,IND,550138,0,0,8,8,
Oklahoma,U.S. House,Steve Russell,REP,550138,0,0,462,462,05
Oklahoma,U.S. House,Zachary Knight,LIB,550138,0,0,27,27,05
Oklahoma,U.S. House,Al Mcaffrey,DEM,550138,0,0,86,86,05
Oklahoma,President,Donald Trump,REP,550139,0,0,1373,1373,
Oklahoma,President,Gary Johnson,LIB,550139,0,0,149,149,
Oklahoma,President,Hillary Clinton,DEM,550139,0,0,617,617,
Oklahoma,U.S. Senate,James Lankford,REP,550139,0,0,1564,1564,
Oklahoma,U.S. Senate,Robert Murphy,LIB,550139,0,0,53,53,
Oklahoma,U.S. Senate,Mike Workman,DEM,550139,0,0,446,446,
Oklahoma,U.S. Senate,Mark Beard,IND,550139,0,0,36,36,
Oklahoma,U.S. Senate,Sean Braddy,IND,550139,0,0,43,43,
Oklahoma,U.S. House,Steve Russell,REP,550139,0,0,1498,1498,05
Oklahoma,U.S. House,Zachary Knight,LIB,550139,0,0,106,106,05
Oklahoma,U.S. House,Al Mcaffrey,DEM,550139,0,0,511,511,05
Oklahoma,State Senate,Greg Treat,REP,550139,0,0,1361,1361,47
Oklahoma,State Senate,Judy Mullen Hopper,DEM,550139,0,0,653,653,47
Oklahoma,State Senate,Steven Weber,IND,550139,0,0,96,96,47
Oklahoma,State House,Kevin Calvey,REP,550139,0,0,1340,1340,82
Oklahoma,State House,Misty Warfield,DEM,550139,0,0,595,595,82
Oklahoma,State House,Christopher Crawford,IND,550139,0,0,104,104,82
Oklahoma,State House,David Dickerson,IND,550139,0,0,55,55,82
Oklahoma,President,Donald Trump,REP,550140,0,0,577,577,
Oklahoma,President,Gary Johnson,LIB,550140,0,0,51,51,
Oklahoma,President,Hillary Clinton,DEM,550140,0,0,254,254,
Oklahoma,U.S. Senate,James Lankford,REP,550140,0,0,636,636,
Oklahoma,U.S. Senate,Robert Murphy,LIB,550140,0,0,30,30,
Oklahoma,U.S. Senate,Mike Workman,DEM,550140,0,0,186,186,
Oklahoma,U.S. Senate,Mark Beard,IND,550140,0,0,6,6,
Oklahoma,U.S. Senate,Sean Braddy,IND,550140,0,0,26,26,
Oklahoma,U.S. House,Steve Russell,REP,550140,0,0,609,609,05
Oklahoma,U.S. House,Zachary Knight,LIB,550140,0,0,52,52,05
Oklahoma,U.S. House,Al Mcaffrey,DEM,550140,0,0,214,214,05
Oklahoma,State Senate,Greg Treat,REP,550140,0,0,560,560,47
Oklahoma,State Senate,Judy Mullen Hopper,DEM,550140,0,0,263,263,47
Oklahoma,State Senate,Steven Weber,IND,550140,0,0,49,49,47
Oklahoma,State House,Kevin Calvey,REP,550140,0,0,564,564,82
Oklahoma,State House,Misty Warfield,DEM,550140,0,0,242,242,82
Oklahoma,State House,Christopher Crawford,IND,550140,0,0,40,40,82
Oklahoma,State House,David Dickerson,IND,550140,0,0,14,14,82
Oklahoma,President,Donald Trump,REP,550141,0,0,948,948,
Oklahoma,President,Gary Johnson,LIB,550141,0,0,96,96,
Oklahoma,President,Hillary Clinton,DEM,550141,0,0,472,472,
Oklahoma,U.S. Senate,James Lankford,REP,550141,0,0,1061,1061,
Oklahoma,U.S. Senate,Robert Murphy,LIB,550141,0,0,39,39,
Oklahoma,U.S. Senate,Mike Workman,DEM,550141,0,0,357,357,
Oklahoma,U.S. Senate,Mark Beard,IND,550141,0,0,26,26,
Oklahoma,U.S. Senate,Sean Braddy,IND,550141,0,0,44,44,
Oklahoma,U.S. House,Steve Russell,REP,550141,0,0,1025,1025,05
Oklahoma,U.S. House,Zachary Knight,LIB,550141,0,0,78,78,05
Oklahoma,U.S. House,Al Mcaffrey,DEM,550141,0,0,409,409,05
Oklahoma,State Senate,Greg Treat,REP,550141,0,0,916,916,47
Oklahoma,State Senate,Judy Mullen Hopper,DEM,550141,0,0,512,512,47
Oklahoma,State Senate,Steven Weber,IND,550141,0,0,81,81,47
Oklahoma,President,Donald Trump,REP,550142,0,0,868,868,
Oklahoma,President,Gary Johnson,LIB,550142,0,0,128,128,
Oklahoma,President,Hillary Clinton,DEM,550142,0,0,714,714,
Oklahoma,U.S. Senate,James Lankford,REP,550142,0,0,984,984,
Oklahoma,U.S. Senate,Robert Murphy,LIB,550142,0,0,62,62,
Oklahoma,U.S. Senate,Mike Workman,DEM,550142,0,0,550,550,
Oklahoma,U.S. Senate,Mark Beard,IND,550142,0,0,37,37,
Oklahoma,U.S. Senate,Sean Braddy,IND,550142,0,0,61,61,
Oklahoma,U.S. House,Steve Russell,REP,550142,0,0,938,938,05
Oklahoma,U.S. House,Zachary Knight,LIB,550142,0,0,107,107,05
Oklahoma,U.S. House,Al Mcaffrey,DEM,550142,0,0,636,636,05
Oklahoma,State Senate,Greg Treat,REP,550142,0,0,815,815,47
Oklahoma,State Senate,Judy Mullen Hopper,DEM,550142,0,0,749,749,47
Oklahoma,State Senate,Steven Weber,IND,550142,0,0,105,105,47
Oklahoma,State House,Kevin Calvey,REP,550142,0,0,798,798,82
Oklahoma,State House,Misty Warfield,DEM,550142,0,0,719,719,82
Oklahoma,State House,Christopher Crawford,IND,550142,0,0,103,103,82
Oklahoma,State House,David Dickerson,IND,550142,0,0,38,38,82
Oklahoma,President,Donald Trump,REP,550143,0,0,681,681,
Oklahoma,President,Gary Johnson,LIB,550143,0,0,44,44,
Oklahoma,President,Hillary Clinton,DEM,550143,0,0,333,333,
Oklahoma,U.S. Senate,James Lankford,REP,550143,0,0,748,748,
Oklahoma,U.S. Senate,Robert Murphy,LIB,550143,0,0,34,34,
Oklahoma,U.S. Senate,Mike Workman,DEM,550143,0,0,237,237,
Oklahoma,U.S. Senate,Mark Beard,IND,550143,0,0,16,16,
Oklahoma,U.S. Senate,Sean Braddy,IND,550143,0,0,28,28,
Oklahoma,U.S. House,Steve Russell,REP,550143,0,0,726,726,05
Oklahoma,U.S. House,Zachary Knight,LIB,550143,0,0,51,51,05
Oklahoma,U.S. House,Al Mcaffrey,DEM,550143,0,0,278,278,05
Oklahoma,State Senate,Greg Treat,REP,550143,0,0,671,671,47
Oklahoma,State Senate,Judy Mullen Hopper,DEM,550143,0,0,324,324,47
Oklahoma,State Senate,Steven Weber,IND,550143,0,0,57,57,47
Oklahoma,State House,Kevin Calvey,REP,550143,0,0,680,680,82
Oklahoma,State House,Misty Warfield,DEM,550143,0,0,295,295,82
Oklahoma,State House,Christopher Crawford,IND,550143,0,0,50,50,82
Oklahoma,State House,David Dickerson,IND,550143,0,0,19,19,82
Oklahoma,President,Donald Trump,REP,550144,0,0,592,592,
Oklahoma,President,Gary Johnson,LIB,550144,0,0,62,62,
Oklahoma,President,Hillary Clinton,DEM,550144,0,0,325,325,
Oklahoma,U.S. Senate,James Lankford,REP,550144,0,0,675,675,
Oklahoma,U.S. Senate,Robert Murphy,LIB,550144,0,0,36,36,
Oklahoma,U.S. Senate,Mike Workman,DEM,550144,0,0,245,245,
Oklahoma,U.S. Senate,Mark Beard,IND,550144,0,0,9,9,
Oklahoma,U.S. Senate,Sean Braddy,IND,550144,0,0,27,27,
Oklahoma,U.S. House,Steve Russell,REP,550144,0,0,646,646,05
Oklahoma,U.S. House,Zachary Knight,LIB,550144,0,0,59,59,05
Oklahoma,U.S. House,Al Mcaffrey,DEM,550144,0,0,280,280,05
Oklahoma,State Senate,Greg Treat,REP,550144,0,0,602,602,47
Oklahoma,State Senate,Judy Mullen Hopper,DEM,550144,0,0,311,311,47
Oklahoma,State Senate,Steven Weber,IND,550144,0,0,62,62,47
Oklahoma,State House,Kevin Calvey,REP,550144,0,0,590,590,82
Oklahoma,State House,Misty Warfield,DEM,550144,0,0,305,305,82
Oklahoma,State House,Christopher Crawford,IND,550144,0,0,49,49,82
Oklahoma,State House,David Dickerson,IND,550144,0,0,30,30,82
Oklahoma,President,Donald Trump,REP,550145,0,0,571,571,
Oklahoma,President,Gary Johnson,LIB,550145,0,0,49,49,
Oklahoma,President,Hillary Clinton,DEM,550145,0,0,279,279,
Oklahoma,U.S. Senate,James Lankford,REP,550145,0,0,657,657,
Oklahoma,U.S. Senate,Robert Murphy,LIB,550145,0,0,34,34,
Oklahoma,U.S. Senate,Mike Workman,DEM,550145,0,0,194,194,
Oklahoma,U.S. Senate,Mark Beard,IND,550145,0,0,9,9,
Oklahoma,U.S. Senate,Sean Braddy,IND,550145,0,0,16,16,
Oklahoma,U.S. House,Steve Russell,REP,550145,0,0,658,658,05
Oklahoma,U.S. House,Zachary Knight,LIB,550145,0,0,39,39,05
Oklahoma,U.S. House,Al Mcaffrey,DEM,550145,0,0,205,205,05
Oklahoma,President,Donald Trump,REP,550146,0,0,768,768,
Oklahoma,President,Gary Johnson,LIB,550146,0,0,94,94,
Oklahoma,President,Hillary Clinton,DEM,550146,0,0,458,458,
Oklahoma,U.S. Senate,James Lankford,REP,550146,0,0,903,903,
Oklahoma,U.S. Senate,Robert Murphy,LIB,550146,0,0,54,54,
Oklahoma,U.S. Senate,Mike Workman,DEM,550146,0,0,310,310,
Oklahoma,U.S. Senate,Mark Beard,IND,550146,0,0,21,21,
Oklahoma,U.S. Senate,Sean Braddy,IND,550146,0,0,36,36,
Oklahoma,U.S. House,Steve Russell,REP,550146,0,0,854,854,05
Oklahoma,U.S. House,Zachary Knight,LIB,550146,0,0,84,84,05
Oklahoma,U.S. House,Al Mcaffrey,DEM,550146,0,0,379,379,05
Oklahoma,State House,Matt Jackson,REP,550146,0,0,758,758,85
Oklahoma,State House,Cyndi Munson,DEM,550146,0,0,565,565,85
Oklahoma,President,Donald Trump,REP,550147,0,0,246,246,
Oklahoma,President,Gary Johnson,LIB,550147,0,0,19,19,
Oklahoma,President,Hillary Clinton,DEM,550147,0,0,136,136,
Oklahoma,U.S. Senate,James Lankford,REP,550147,0,0,293,293,
Oklahoma,U.S. Senate,Robert Murphy,LIB,550147,0,0,8,8,
Oklahoma,U.S. Senate,Mike Workman,DEM,550147,0,0,100,100,
Oklahoma,U.S. Senate,Mark Beard,IND,550147,0,0,3,3,
Oklahoma,U.S. Senate,Sean Braddy,IND,550147,0,0,9,9,
Oklahoma,U.S. House,Steve Russell,REP,550147,0,0,281,281,05
Oklahoma,U.S. House,Zachary Knight,LIB,550147,0,0,17,17,05
Oklahoma,U.S. House,Al Mcaffrey,DEM,550147,0,0,115,115,05
Oklahoma,State Senate,Greg Treat,REP,550147,0,0,250,250,47
Oklahoma,State Senate,Judy Mullen Hopper,DEM,550147,0,0,141,141,47
Oklahoma,State Senate,Steven Weber,IND,550147,0,0,16,16,47
Oklahoma,State House,Matt Jackson,REP,550147,0,0,244,244,85
Oklahoma,State House,Cyndi Munson,DEM,550147,0,0,168,168,85
Oklahoma,President,Donald Trump,REP,550148,0,0,792,792,
Oklahoma,President,Gary Johnson,LIB,550148,0,0,109,109,
Oklahoma,President,Hillary Clinton,DEM,550148,0,0,515,515,
Oklahoma,U.S. Senate,James Lankford,REP,550148,0,0,884,884,
Oklahoma,U.S. Senate,Robert Murphy,LIB,550148,0,0,57,57,
Oklahoma,U.S. Senate,Mike Workman,DEM,550148,0,0,411,411,
Oklahoma,U.S. Senate,Mark Beard,IND,550148,0,0,26,26,
Oklahoma,U.S. Senate,Sean Braddy,IND,550148,0,0,44,44,
Oklahoma,U.S. House,Steve Russell,REP,550148,0,0,852,852,05
Oklahoma,U.S. House,Zachary Knight,LIB,550148,0,0,90,90,05
Oklahoma,U.S. House,Al Mcaffrey,DEM,550148,0,0,463,463,05
Oklahoma,State Senate,Greg Treat,REP,550148,0,0,752,752,47
Oklahoma,State Senate,Judy Mullen Hopper,DEM,550148,0,0,553,553,47
Oklahoma,State Senate,Steven Weber,IND,550148,0,0,99,99,47
Oklahoma,State House,Kevin Calvey,REP,550148,0,0,776,776,82
Oklahoma,State House,Misty Warfield,DEM,550148,0,0,503,503,82
Oklahoma,State House,Christopher Crawford,IND,550148,0,0,74,74,82
Oklahoma,State House,David Dickerson,IND,550148,0,0,32,32,82
Oklahoma,President,Donald Trump,REP,550149,0,0,863,863,
Oklahoma,President,Gary Johnson,LIB,550149,0,0,71,71,
Oklahoma,President,Hillary Clinton,DEM,550149,0,0,384,384,
Oklahoma,U.S. Senate,James Lankford,REP,550149,0,0,961,961,
Oklahoma,U.S. Senate,Robert Murphy,LIB,550149,0,0,31,31,
Oklahoma,U.S. Senate,Mike Workman,DEM,550149,0,0,304,304,
Oklahoma,U.S. Senate,Mark Beard,IND,550149,0,0,26,26,
Oklahoma,U.S. Senate,Sean Braddy,IND,550149,0,0,11,11,
Oklahoma,U.S. House,Steve Russell,REP,550149,0,0,919,919,05
Oklahoma,U.S. House,Zachary Knight,LIB,550149,0,0,58,58,05
Oklahoma,U.S. House,Al Mcaffrey,DEM,550149,0,0,338,338,05
Oklahoma,State Senate,Greg Treat,REP,550149,0,0,838,838,47
Oklahoma,State Senate,Judy Mullen Hopper,DEM,550149,0,0,406,406,47
Oklahoma,State Senate,Steven Weber,IND,550149,0,0,65,65,47
Oklahoma,State House,Kevin Calvey,REP,550149,0,0,836,836,82
Oklahoma,State House,Misty Warfield,DEM,550149,0,0,390,390,82
Oklahoma,State House,Christopher Crawford,IND,550149,0,0,57,57,82
Oklahoma,State House,David Dickerson,IND,550149,0,0,21,21,82
Oklahoma,President,Donald Trump,REP,550150,0,0,823,823,
Oklahoma,President,Gary Johnson,LIB,550150,0,0,99,99,
Oklahoma,President,Hillary Clinton,DEM,550150,0,0,589,589,
Oklahoma,U.S. Senate,James Lankford,REP,550150,0,0,942,942,
Oklahoma,U.S. Senate,Robert Murphy,LIB,550150,0,0,59,59,
Oklahoma,U.S. Senate,Mike Workman,DEM,550150,0,0,442,442,
Oklahoma,U.S. Senate,Mark Beard,IND,550150,0,0,22,22,
Oklahoma,U.S. Senate,Sean Braddy,IND,550150,0,0,38,38,
Oklahoma,U.S. House,Steve Russell,REP,550150,0,0,908,908,05
Oklahoma,U.S. House,Zachary Knight,LIB,550150,0,0,94,94,05
Oklahoma,U.S. House,Al Mcaffrey,DEM,550150,0,0,490,490,05
Oklahoma,State Senate,Greg Treat,REP,550150,0,0,774,774,47
Oklahoma,State Senate,Judy Mullen Hopper,DEM,550150,0,0,620,620,47
Oklahoma,State Senate,Steven Weber,IND,550150,0,0,86,86,47
Oklahoma,State House,Elise Hall,REP,550150,0,0,798,798,10
Oklahoma,State House,Christina Wright,LIB,550150,0,0,97,97,10
Oklahoma,State House,Donald Wentroth Jr.,DEM,550150,0,0,595,595,10
Oklahoma,President,Donald Trump,REP,550151,0,0,866,866,
Oklahoma,President,Gary Johnson,LIB,550151,0,0,115,115,
Oklahoma,President,Hillary Clinton,DEM,550151,0,0,574,574,
Oklahoma,U.S. Senate,James Lankford,REP,550151,0,0,1014,1014,
Oklahoma,U.S. Senate,Robert Murphy,LIB,550151,0,0,55,55,
Oklahoma,U.S. Senate,Mike Workman,DEM,550151,0,0,421,421,
Oklahoma,U.S. Senate,Mark Beard,IND,550151,0,0,30,30,
Oklahoma,U.S. Senate,Sean Braddy,IND,550151,0,0,33,33,
Oklahoma,U.S. House,Steve Russell,REP,550151,0,0,930,930,05
Oklahoma,U.S. House,Zachary Knight,LIB,550151,0,0,111,111,05
Oklahoma,U.S. House,Al Mcaffrey,DEM,550151,0,0,502,502,05
Oklahoma,State Senate,Greg Treat,REP,550151,0,0,824,824,47
Oklahoma,State Senate,Judy Mullen Hopper,DEM,550151,0,0,619,619,47
Oklahoma,State Senate,Steven Weber,IND,550151,0,0,97,97,47
Oklahoma,State House,Elise Hall,REP,550151,0,0,872,872,10
Oklahoma,State House,Christina Wright,LIB,550151,0,0,106,106,10
Oklahoma,State House,Donald Wentroth Jr.,DEM,550151,0,0,556,556,10
Oklahoma,President,Donald Trump,REP,550152,0,0,833,833,
Oklahoma,President,Gary Johnson,LIB,550152,0,0,116,116,
Oklahoma,President,Hillary Clinton,DEM,550152,0,0,552,552,
Oklahoma,U.S. Senate,James Lankford,REP,550152,0,0,945,945,
Oklahoma,U.S. Senate,Robert Murphy,LIB,550152,0,0,51,51,
Oklahoma,U.S. Senate,Mike Workman,DEM,550152,0,0,426,426,
Oklahoma,U.S. Senate,Mark Beard,IND,550152,0,0,35,35,
Oklahoma,U.S. Senate,Sean Braddy,IND,550152,0,0,45,45,
Oklahoma,U.S. House,Steve Russell,REP,550152,0,0,893,893,05
Oklahoma,U.S. House,Zachary Knight,LIB,550152,0,0,89,89,05
Oklahoma,U.S. House,Al Mcaffrey,DEM,550152,0,0,508,508,05
Oklahoma,State Senate,Greg Treat,REP,550152,0,0,767,767,47
Oklahoma,State Senate,Judy Mullen Hopper,DEM,550152,0,0,644,644,47
Oklahoma,State Senate,Steven Weber,IND,550152,0,0,76,76,47
Oklahoma,State House,Elise Hall,REP,550152,0,0,827,827,10
Oklahoma,State House,Christina Wright,LIB,550152,0,0,82,82,10
Oklahoma,State House,Donald Wentroth Jr.,DEM,550152,0,0,578,578,10
Oklahoma,President,Donald Trump,REP,550153,0,0,797,797,
Oklahoma,President,Gary Johnson,LIB,550153,0,0,106,106,
Oklahoma,President,Hillary Clinton,DEM,550153,0,0,541,541,
Oklahoma,U.S. Senate,James Lankford,REP,550153,0,0,887,887,
Oklahoma,U.S. Senate,Robert Murphy,LIB,550153,0,0,67,67,
Oklahoma,U.S. Senate,Mike Workman,DEM,550153,0,0,408,408,
Oklahoma,U.S. Senate,Mark Beard,IND,550153,0,0,32,32,
Oklahoma,U.S. Senate,Sean Braddy,IND,550153,0,0,49,49,
Oklahoma,U.S. House,Steve Russell,REP,550153,0,0,845,845,05
Oklahoma,U.S. House,Zachary Knight,LIB,550153,0,0,103,103,05
Oklahoma,U.S. House,Al Mcaffrey,DEM,550153,0,0,486,486,05
Oklahoma,State Senate,Greg Treat,REP,550153,0,0,706,706,47
Oklahoma,State Senate,Judy Mullen Hopper,DEM,550153,0,0,610,610,47
Oklahoma,State Senate,Steven Weber,IND,550153,0,0,95,95,47
Oklahoma,State House,Elise Hall,REP,550153,0,0,793,793,10
Oklahoma,State House,Christina Wright,LIB,550153,0,0,95,95,10
Oklahoma,State House,Donald Wentroth Jr.,DEM,550153,0,0,540,540,10
Oklahoma,President,Donald Trump,REP,550154,0,0,898,898,
Oklahoma,President,Gary Johnson,LIB,550154,0,0,94,94,
Oklahoma,President,Hillary Clinton,DEM,550154,0,0,613,613,
Oklahoma,U.S. Senate,James Lankford,REP,550154,0,0,1001,1001,
Oklahoma,U.S. Senate,Robert Murphy,LIB,550154,0,0,59,59,
Oklahoma,U.S. Senate,Mike Workman,DEM,550154,0,0,473,473,
Oklahoma,U.S. Senate,Mark Beard,IND,550154,0,0,30,30,
Oklahoma,U.S. Senate,Sean Braddy,IND,550154,0,0,56,56,
Oklahoma,U.S. House,Steve Russell,REP,550154,0,0,948,948,05
Oklahoma,U.S. House,Zachary Knight,LIB,550154,0,0,102,102,05
Oklahoma,U.S. House,Al Mcaffrey,DEM,550154,0,0,552,552,05
Oklahoma,State Senate,Greg Treat,REP,550154,0,0,831,831,47
Oklahoma,State Senate,Judy Mullen Hopper,DEM,550154,0,0,661,661,47
Oklahoma,State Senate,Steven Weber,IND,550154,0,0,94,94,47
Oklahoma,State House,Matt Jackson,REP,550154,0,0,809,809,85
Oklahoma,State House,Cyndi Munson,DEM,550154,0,0,788,788,85
Oklahoma,President,Donald Trump,REP,550155,0,0,300,300,
Oklahoma,President,Gary Johnson,LIB,550155,0,0,31,31,
Oklahoma,President,Hillary Clinton,DEM,550155,0,0,193,193,
Oklahoma,U.S. Senate,James Lankford,REP,550155,0,0,343,343,
Oklahoma,U.S. Senate,Robert Murphy,LIB,550155,0,0,14,14,
Oklahoma,U.S. Senate,Mike Workman,DEM,550155,0,0,137,137,
Oklahoma,U.S. Senate,Mark Beard,IND,550155,0,0,14,14,
Oklahoma,U.S. Senate,Sean Braddy,IND,550155,0,0,18,18,
Oklahoma,U.S. House,Steve Russell,REP,550155,0,0,330,330,05
Oklahoma,U.S. House,Zachary Knight,LIB,550155,0,0,33,33,05
Oklahoma,U.S. House,Al Mcaffrey,DEM,550155,0,0,159,159,05
Oklahoma,State House,Matt Jackson,REP,550155,0,0,278,278,85
Oklahoma,State House,Cyndi Munson,DEM,550155,0,0,245,245,85
Oklahoma,President,Donald Trump,REP,550156,0,0,682,682,
Oklahoma,President,Gary Johnson,LIB,550156,0,0,102,102,
Oklahoma,President,Hillary Clinton,DEM,550156,0,0,689,689,
Oklahoma,U.S. Senate,James Lankford,REP,550156,0,0,752,752,
Oklahoma,U.S. Senate,Robert Murphy,LIB,550156,0,0,53,53,
Oklahoma,U.S. Senate,Mike Workman,DEM,550156,0,0,568,568,
Oklahoma,U.S. Senate,Mark Beard,IND,550156,0,0,31,31,
Oklahoma,U.S. Senate,Sean Braddy,IND,550156,0,0,62,62,
Oklahoma,U.S. House,Steve Russell,REP,550156,0,0,724,724,05
Oklahoma,U.S. House,Zachary Knight,LIB,550156,0,0,99,99,05
Oklahoma,U.S. House,Al Mcaffrey,DEM,550156,0,0,631,631,05
Oklahoma,State House,Matt Jackson,REP,550156,0,0,590,590,85
Oklahoma,State House,Cyndi Munson,DEM,550156,0,0,867,867,85
Oklahoma,President,Donald Trump,REP,550157,0,0,25,25,
Oklahoma,President,Gary Johnson,LIB,550157,0,0,6,6,
Oklahoma,President,Hillary Clinton,DEM,550157,0,0,32,32,
Oklahoma,U.S. Senate,James Lankford,REP,550157,0,0,26,26,
Oklahoma,U.S. Senate,Robert Murphy,LIB,550157,0,0,2,2,
Oklahoma,U.S. Senate,Mike Workman,DEM,550157,0,0,28,28,
Oklahoma,U.S. Senate,Mark Beard,IND,550157,0,0,3,3,
Oklahoma,U.S. Senate,Sean Braddy,IND,550157,0,0,4,4,
Oklahoma,U.S. House,Steve Russell,REP,550157,0,0,22,22,05
Oklahoma,U.S. House,Zachary Knight,LIB,550157,0,0,7,7,05
Oklahoma,U.S. House,Al Mcaffrey,DEM,550157,0,0,32,32,05
Oklahoma,State House,Elise Hall,REP,550157,0,0,24,24,10
Oklahoma,State House,Christina Wright,LIB,550157,0,0,6,6,10
Oklahoma,State House,Donald Wentroth Jr.,DEM,550157,0,0,31,31,10
Oklahoma,President,Donald Trump,REP,550158,0,0,579,579,
Oklahoma,President,Gary Johnson,LIB,550158,0,0,103,103,
Oklahoma,President,Hillary Clinton,DEM,550158,0,0,501,501,
Oklahoma,U.S. Senate,James Lankford,REP,550158,0,0,658,658,
Oklahoma,U.S. Senate,Robert Murphy,LIB,550158,0,0,33,33,
Oklahoma,U.S. Senate,Mike Workman,DEM,550158,0,0,416,416,
Oklahoma,U.S. Senate,Mark Beard,IND,550158,0,0,26,26,
Oklahoma,U.S. Senate,Sean Braddy,IND,550158,0,0,48,48,
Oklahoma,U.S. House,Steve Russell,REP,550158,0,0,616,616,05
Oklahoma,U.S. House,Zachary Knight,LIB,550158,0,0,74,74,05
Oklahoma,U.S. House,Al Mcaffrey,DEM,550158,0,0,483,483,05
Oklahoma,State Senate,Greg Treat,REP,550158,0,0,545,545,47
Oklahoma,State Senate,Judy Mullen Hopper,DEM,550158,0,0,544,544,47
Oklahoma,State Senate,Steven Weber,IND,550158,0,0,70,70,47
Oklahoma,State House,Elise Hall,REP,550158,0,0,557,557,10
Oklahoma,State House,Christina Wright,LIB,550158,0,0,71,71,10
Oklahoma,State House,Donald Wentroth Jr.,DEM,550158,0,0,548,548,10
Oklahoma,President,Donald Trump,REP,550159,0,0,705,705,
Oklahoma,President,Gary Johnson,LIB,550159,0,0,143,143,
Oklahoma,President,Hillary Clinton,DEM,550159,0,0,589,589,
Oklahoma,U.S. Senate,James Lankford,REP,550159,0,0,792,792,
Oklahoma,U.S. Senate,Robert Murphy,LIB,550159,0,0,71,71,
Oklahoma,U.S. Senate,Mike Workman,DEM,550159,0,0,497,497,
Oklahoma,U.S. Senate,Mark Beard,IND,550159,0,0,23,23,
Oklahoma,U.S. Senate,Sean Braddy,IND,550159,0,0,61,61,
Oklahoma,U.S. House,Steve Russell,REP,550159,0,0,750,750,05
Oklahoma,U.S. House,Zachary Knight,LIB,550159,0,0,114,114,05
Oklahoma,U.S. House,Al Mcaffrey,DEM,550159,0,0,571,571,05
Oklahoma,State Senate,Greg Treat,REP,550159,0,0,656,656,47
Oklahoma,State Senate,Judy Mullen Hopper,DEM,550159,0,0,666,666,47
Oklahoma,State Senate,Steven Weber,IND,550159,0,0,103,103,47
Oklahoma,State House,Elise Hall,REP,550159,0,0,657,657,10
Oklahoma,State House,Christina Wright,LIB,550159,0,0,85,85,10
Oklahoma,State House,Donald Wentroth Jr.,DEM,550159,0,0,693,693,10
Oklahoma,President,Donald Trump,REP,550160,0,0,775,775,
Oklahoma,President,Gary Johnson,LIB,550160,0,0,56,56,
Oklahoma,President,Hillary Clinton,DEM,550160,0,0,297,297,
Oklahoma,U.S. Senate,James Lankford,REP,550160,0,0,853,853,
Oklahoma,U.S. Senate,Robert Murphy,LIB,550160,0,0,27,27,
Oklahoma,U.S. Senate,Mike Workman,DEM,550160,0,0,218,218,
Oklahoma,U.S. Senate,Mark Beard,IND,550160,0,0,7,7,
Oklahoma,U.S. Senate,Sean Braddy,IND,550160,0,0,23,23,
Oklahoma,U.S. House,Steve Russell,REP,550160,0,0,825,825,05
Oklahoma,U.S. House,Zachary Knight,LIB,550160,0,0,50,50,05
Oklahoma,U.S. House,Al Mcaffrey,DEM,550160,0,0,244,244,05
Oklahoma,State Senate,Greg Treat,REP,550160,0,0,727,727,47
Oklahoma,State Senate,Judy Mullen Hopper,DEM,550160,0,0,337,337,47
Oklahoma,State Senate,Steven Weber,IND,550160,0,0,48,48,47
Oklahoma,State House,Elise Hall,REP,550160,0,0,647,647,10
Oklahoma,State House,Christina Wright,LIB,550160,0,0,45,45,10
Oklahoma,State House,Donald Wentroth Jr.,DEM,550160,0,0,425,425,10
Oklahoma,President,Donald Trump,REP,550161,0,0,322,322,
Oklahoma,President,Gary Johnson,LIB,550161,0,0,66,66,
Oklahoma,President,Hillary Clinton,DEM,550161,0,0,501,501,
Oklahoma,U.S. Senate,James Lankford,REP,550161,0,0,348,348,
Oklahoma,U.S. Senate,Robert Murphy,LIB,550161,0,0,36,36,
Oklahoma,U.S. Senate,Mike Workman,DEM,550161,0,0,414,414,
Oklahoma,U.S. Senate,Mark Beard,IND,550161,0,0,36,36,
Oklahoma,U.S. Senate,Sean Braddy,IND,550161,0,0,47,47,
Oklahoma,U.S. House,Steve Russell,REP,550161,0,0,335,335,05
Oklahoma,U.S. House,Zachary Knight,LIB,550161,0,0,62,62,05
Oklahoma,U.S. House,Al Mcaffrey,DEM,550161,0,0,478,478,05
Oklahoma,State House,Elise Hall,REP,550161,0,0,307,307,10
Oklahoma,State House,Christina Wright,LIB,550161,0,0,88,88,10
Oklahoma,State House,Donald Wentroth Jr.,DEM,550161,0,0,477,477,10
Oklahoma,President,Donald Trump,REP,550162,0,0,501,501,
Oklahoma,President,Gary Johnson,LIB,550162,0,0,71,71,
Oklahoma,President,Hillary Clinton,DEM,550162,0,0,286,286,
Oklahoma,U.S. Senate,James Lankford,REP,550162,0,0,553,553,
Oklahoma,U.S. Senate,Robert Murphy,LIB,550162,0,0,34,34,
Oklahoma,U.S. Senate,Mike Workman,DEM,550162,0,0,223,223,
Oklahoma,U.S. Senate,Mark Beard,IND,550162,0,0,18,18,
Oklahoma,U.S. Senate,Sean Braddy,IND,550162,0,0,30,30,
Oklahoma,U.S. House,Steve Russell,REP,550162,0,0,519,519,05
Oklahoma,U.S. House,Zachary Knight,LIB,550162,0,0,72,72,05
Oklahoma,U.S. House,Al Mcaffrey,DEM,550162,0,0,262,262,05
Oklahoma,President,Donald Trump,REP,550163,0,0,484,484,
Oklahoma,President,Gary Johnson,LIB,550163,0,0,73,73,
Oklahoma,President,Hillary Clinton,DEM,550163,0,0,490,490,
Oklahoma,U.S. Senate,James Lankford,REP,550163,0,0,525,525,
Oklahoma,U.S. Senate,Robert Murphy,LIB,550163,0,0,54,54,
Oklahoma,U.S. Senate,Mike Workman,DEM,550163,0,0,400,400,
Oklahoma,U.S. Senate,Mark Beard,IND,550163,0,0,19,19,
Oklahoma,U.S. Senate,Sean Braddy,IND,550163,0,0,38,38,
Oklahoma,U.S. House,Steve Russell,REP,550163,0,0,475,475,05
Oklahoma,U.S. House,Zachary Knight,LIB,550163,0,0,94,94,05
Oklahoma,U.S. House,Al Mcaffrey,DEM,550163,0,0,461,461,05
Oklahoma,President,Donald Trump,REP,550164,0,0,473,473,
Oklahoma,President,Gary Johnson,LIB,550164,0,0,64,64,
Oklahoma,President,Hillary Clinton,DEM,550164,0,0,242,242,
Oklahoma,U.S. Senate,James Lankford,REP,550164,0,0,504,504,
Oklahoma,U.S. Senate,Robert Murphy,LIB,550164,0,0,39,39,
Oklahoma,U.S. Senate,Mike Workman,DEM,550164,0,0,191,191,
Oklahoma,U.S. Senate,Mark Beard,IND,550164,0,0,17,17,
Oklahoma,U.S. Senate,Sean Braddy,IND,550164,0,0,24,24,
Oklahoma,U.S. House,Steve Russell,REP,550164,0,0,476,476,05
Oklahoma,U.S. House,Zachary Knight,LIB,550164,0,0,67,67,05
Oklahoma,U.S. House,Al Mcaffrey,DEM,550164,0,0,229,229,05
Oklahoma,President,Donald Trump,REP,550165,0,0,867,867,
Oklahoma,President,Gary Johnson,LIB,550165,0,0,93,93,
Oklahoma,President,Hillary Clinton,DEM,550165,0,0,248,248,
Oklahoma,U.S. Senate,James Lankford,REP,550165,0,0,912,912,
Oklahoma,U.S. Senate,Robert Murphy,LIB,550165,0,0,37,37,
Oklahoma,U.S. Senate,Mike Workman,DEM,550165,0,0,206,206,
Oklahoma,U.S. Senate,Mark Beard,IND,550165,0,0,21,21,
Oklahoma,U.S. Senate,Sean Braddy,IND,550165,0,0,38,38,
Oklahoma,U.S. House,Steve Russell,REP,550165,0,0,868,868,05
Oklahoma,U.S. House,Zachary Knight,LIB,550165,0,0,100,100,05
Oklahoma,U.S. House,Al Mcaffrey,DEM,550165,0,0,240,240,05
Oklahoma,President,Donald Trump,REP,550166,0,0,181,181,
Oklahoma,President,Gary Johnson,LIB,550166,0,0,18,18,
Oklahoma,President,Hillary Clinton,DEM,550166,0,0,76,76,
Oklahoma,U.S. Senate,James Lankford,REP,550166,0,0,186,186,
Oklahoma,U.S. Senate,Robert Murphy,LIB,550166,0,0,8,8,
Oklahoma,U.S. Senate,Mike Workman,DEM,550166,0,0,61,61,
Oklahoma,U.S. Senate,Mark Beard,IND,550166,0,0,9,9,
Oklahoma,U.S. Senate,Sean Braddy,IND,550166,0,0,10,10,
Oklahoma,U.S. House,Steve Russell,REP,550166,0,0,174,174,05
Oklahoma,U.S. House,Zachary Knight,LIB,550166,0,0,17,17,05
Oklahoma,U.S. House,Al Mcaffrey,DEM,550166,0,0,76,76,05
Oklahoma,President,Donald Trump,REP,550167,0,0,227,227,
Oklahoma,President,Gary Johnson,LIB,550167,0,0,46,46,
Oklahoma,President,Hillary Clinton,DEM,550167,0,0,194,194,
Oklahoma,U.S. Senate,James Lankford,REP,550167,0,0,226,226,
Oklahoma,U.S. Senate,Robert Murphy,LIB,550167,0,0,21,21,
Oklahoma,U.S. Senate,Mike Workman,DEM,550167,0,0,165,165,
Oklahoma,U.S. Senate,Mark Beard,IND,550167,0,0,22,22,
Oklahoma,U.S. Senate,Sean Braddy,IND,550167,0,0,35,35,
Oklahoma,U.S. House,Steve Russell,REP,550167,0,0,215,215,05
Oklahoma,U.S. House,Zachary Knight,LIB,550167,0,0,55,55,05
Oklahoma,U.S. House,Al Mcaffrey,DEM,550167,0,0,194,194,05
Oklahoma,President,Donald Trump,REP,550168,0,0,151,151,
Oklahoma,President,Gary Johnson,LIB,550168,0,0,22,22,
Oklahoma,President,Hillary Clinton,DEM,550168,0,0,87,87,
Oklahoma,U.S. Senate,James Lankford,REP,550168,0,0,154,154,
Oklahoma,U.S. Senate,Robert Murphy,LIB,550168,0,0,17,17,
Oklahoma,U.S. Senate,Mike Workman,DEM,550168,0,0,72,72,
Oklahoma,U.S. Senate,Mark Beard,IND,550168,0,0,5,5,
Oklahoma,U.S. Senate,Sean Braddy,IND,550168,0,0,9,9,
Oklahoma,U.S. House,Steve Russell,REP,550168,0,0,151,151,05
Oklahoma,U.S. House,Zachary Knight,LIB,550168,0,0,21,21,05
Oklahoma,U.S. House,Al Mcaffrey,DEM,550168,0,0,84,84,05
Oklahoma,President,Donald Trump,REP,550169,0,0,381,381,
Oklahoma,President,Gary Johnson,LIB,550169,0,0,71,71,
Oklahoma,President,Hillary Clinton,DEM,550169,0,0,405,405,
Oklahoma,U.S. Senate,James Lankford,REP,550169,0,0,413,413,
Oklahoma,U.S. Senate,Robert Murphy,LIB,550169,0,0,35,35,
Oklahoma,U.S. Senate,Mike Workman,DEM,550169,0,0,323,323,
Oklahoma,U.S. Senate,Mark Beard,IND,550169,0,0,30,30,
Oklahoma,U.S. Senate,Sean Braddy,IND,550169,0,0,49,49,
Oklahoma,U.S. House,Steve Russell,REP,550169,0,0,400,400,05
Oklahoma,U.S. House,Zachary Knight,LIB,550169,0,0,78,78,05
Oklahoma,U.S. House,Al Mcaffrey,DEM,550169,0,0,358,358,05
Oklahoma,State House,Tammy West,REP,550169,0,0,402,402,84
Oklahoma,State House,Will Hollander,DEM,550169,0,0,442,442,84
Oklahoma,President,Donald Trump,REP,550170,0,0,363,363,
Oklahoma,President,Gary Johnson,LIB,550170,0,0,58,58,
Oklahoma,President,Hillary Clinton,DEM,550170,0,0,380,380,
Oklahoma,U.S. Senate,James Lankford,REP,550170,0,0,395,395,
Oklahoma,U.S. Senate,Robert Murphy,LIB,550170,0,0,44,44,
Oklahoma,U.S. Senate,Mike Workman,DEM,550170,0,0,292,292,
Oklahoma,U.S. Senate,Mark Beard,IND,550170,0,0,22,22,
Oklahoma,U.S. Senate,Sean Braddy,IND,550170,0,0,41,41,
Oklahoma,U.S. House,Steve Russell,REP,550170,0,0,375,375,05
Oklahoma,U.S. House,Zachary Knight,LIB,550170,0,0,72,72,05
Oklahoma,U.S. House,Al Mcaffrey,DEM,550170,0,0,340,340,05
Oklahoma,President,Donald Trump,REP,550171,0,0,391,391,
Oklahoma,President,Gary Johnson,LIB,550171,0,0,92,92,
Oklahoma,President,Hillary Clinton,DEM,550171,0,0,476,476,
Oklahoma,U.S. Senate,James Lankford,REP,550171,0,0,464,464,
Oklahoma,U.S. Senate,Robert Murphy,LIB,550171,0,0,39,39,
Oklahoma,U.S. Senate,Mike Workman,DEM,550171,0,0,382,382,
Oklahoma,U.S. Senate,Mark Beard,IND,550171,0,0,21,21,
Oklahoma,U.S. Senate,Sean Braddy,IND,550171,0,0,56,56,
Oklahoma,U.S. House,Steve Russell,REP,550171,0,0,428,428,05
Oklahoma,U.S. House,Zachary Knight,LIB,550171,0,0,85,85,05
Oklahoma,U.S. House,Al Mcaffrey,DEM,550171,0,0,438,438,05
Oklahoma,State House,Bruce Lee Smith,REP,550171,0,0,387,387,87
Oklahoma,State House,Elle Collins,LIB,550171,0,0,68,68,87
Oklahoma,State House,Collin Walke,DEM,550171,0,0,501,501,87
Oklahoma,President,Donald Trump,REP,550172,0,0,484,484,
Oklahoma,President,Gary Johnson,LIB,550172,0,0,105,105,
Oklahoma,President,Hillary Clinton,DEM,550172,0,0,509,509,
Oklahoma,U.S. Senate,James Lankford,REP,550172,0,0,545,545,
Oklahoma,U.S. Senate,Robert Murphy,LIB,550172,0,0,50,50,
Oklahoma,U.S. Senate,Mike Workman,DEM,550172,0,0,423,423,
Oklahoma,U.S. Senate,Mark Beard,IND,550172,0,0,28,28,
Oklahoma,U.S. Senate,Sean Braddy,IND,550172,0,0,58,58,
Oklahoma,U.S. House,Steve Russell,REP,550172,0,0,503,503,05
Oklahoma,U.S. House,Zachary Knight,LIB,550172,0,0,95,95,05
Oklahoma,U.S. House,Al Mcaffrey,DEM,550172,0,0,491,491,05
Oklahoma,State House,Bruce Lee Smith,REP,550172,0,0,490,490,87
Oklahoma,State House,Elle Collins,LIB,550172,0,0,88,88,87
Oklahoma,State House,Collin Walke,DEM,550172,0,0,518,518,87
Oklahoma,President,Donald Trump,REP,550173,0,0,562,562,
Oklahoma,President,Gary Johnson,LIB,550173,0,0,90,90,
Oklahoma,President,Hillary Clinton,DEM,550173,0,0,482,482,
Oklahoma,U.S. Senate,James Lankford,REP,550173,0,0,651,651,
Oklahoma,U.S. Senate,Robert Murphy,LIB,550173,0,0,41,41,
Oklahoma,U.S. Senate,Mike Workman,DEM,550173,0,0,389,389,
Oklahoma,U.S. Senate,Mark Beard,IND,550173,0,0,19,19,
Oklahoma,U.S. Senate,Sean Braddy,IND,550173,0,0,32,32,
Oklahoma,U.S. House,Steve Russell,REP,550173,0,0,604,604,05
Oklahoma,U.S. House,Zachary Knight,LIB,550173,0,0,66,66,05
Oklahoma,U.S. House,Al Mcaffrey,DEM,550173,0,0,456,456,05
Oklahoma,State House,Tammy West,REP,550173,0,0,565,565,84
Oklahoma,State House,Will Hollander,DEM,550173,0,0,555,555,84
Oklahoma,President,Donald Trump,REP,550174,0,0,301,301,
Oklahoma,President,Gary Johnson,LIB,550174,0,0,49,49,
Oklahoma,President,Hillary Clinton,DEM,550174,0,0,258,258,
Oklahoma,U.S. Senate,James Lankford,REP,550174,0,0,336,336,
Oklahoma,U.S. Senate,Robert Murphy,LIB,550174,0,0,26,26,
Oklahoma,U.S. Senate,Mike Workman,DEM,550174,0,0,203,203,
Oklahoma,U.S. Senate,Mark Beard,IND,550174,0,0,18,18,
Oklahoma,U.S. Senate,Sean Braddy,IND,550174,0,0,16,16,
Oklahoma,U.S. House,Steve Russell,REP,550174,0,0,316,316,05
Oklahoma,U.S. House,Zachary Knight,LIB,550174,0,0,43,43,05
Oklahoma,U.S. House,Al Mcaffrey,DEM,550174,0,0,241,241,05
Oklahoma,State House,Tammy West,REP,550174,0,0,322,322,84
Oklahoma,State House,Will Hollander,DEM,550174,0,0,277,277,84
Oklahoma,President,Donald Trump,REP,550175,0,0,171,171,
Oklahoma,President,Gary Johnson,LIB,550175,0,0,45,45,
Oklahoma,President,Hillary Clinton,DEM,550175,0,0,165,165,
Oklahoma,U.S. Senate,James Lankford,REP,550175,0,0,183,183,
Oklahoma,U.S. Senate,Robert Murphy,LIB,550175,0,0,29,29,
Oklahoma,U.S. Senate,Mike Workman,DEM,550175,0,0,132,132,
Oklahoma,U.S. Senate,Mark Beard,IND,550175,0,0,17,17,
Oklahoma,U.S. Senate,Sean Braddy,IND,550175,0,0,21,21,
Oklahoma,U.S. House,Steve Russell,REP,550175,0,0,179,179,05
Oklahoma,U.S. House,Zachary Knight,LIB,550175,0,0,49,49,05
Oklahoma,U.S. House,Al Mcaffrey,DEM,550175,0,0,152,152,05
Oklahoma,State House,Tammy West,REP,550175,0,0,189,189,84
Oklahoma,State House,Will Hollander,DEM,550175,0,0,188,188,84
Oklahoma,President,Donald Trump,REP,550176,0,0,483,483,
Oklahoma,President,Gary Johnson,LIB,550176,0,0,85,85,
Oklahoma,President,Hillary Clinton,DEM,550176,0,0,351,351,
Oklahoma,U.S. Senate,James Lankford,REP,550176,0,0,549,549,
Oklahoma,U.S. Senate,Robert Murphy,LIB,550176,0,0,45,45,
Oklahoma,U.S. Senate,Mike Workman,DEM,550176,0,0,266,266,
Oklahoma,U.S. Senate,Mark Beard,IND,550176,0,0,20,20,
Oklahoma,U.S. Senate,Sean Braddy,IND,550176,0,0,41,41,
Oklahoma,U.S. House,Steve Russell,REP,550176,0,0,512,512,05
Oklahoma,U.S. House,Zachary Knight,LIB,550176,0,0,80,80,05
Oklahoma,U.S. House,Al Mcaffrey,DEM,550176,0,0,319,319,05
Oklahoma,State House,Bruce Lee Smith,REP,550176,0,0,464,464,87
Oklahoma,State House,Elle Collins,LIB,550176,0,0,87,87,87
Oklahoma,State House,Collin Walke,DEM,550176,0,0,366,366,87
Oklahoma,President,Donald Trump,REP,550177,0,0,533,533,
Oklahoma,President,Gary Johnson,LIB,550177,0,0,95,95,
Oklahoma,President,Hillary Clinton,DEM,550177,0,0,429,429,
Oklahoma,U.S. Senate,James Lankford,REP,550177,0,0,604,604,
Oklahoma,U.S. Senate,Robert Murphy,LIB,550177,0,0,44,44,
Oklahoma,U.S. Senate,Mike Workman,DEM,550177,0,0,346,346,
Oklahoma,U.S. Senate,Mark Beard,IND,550177,0,0,25,25,
Oklahoma,U.S. Senate,Sean Braddy,IND,550177,0,0,45,45,
Oklahoma,U.S. House,Steve Russell,REP,550177,0,0,586,586,05
Oklahoma,U.S. House,Zachary Knight,LIB,550177,0,0,64,64,05
Oklahoma,U.S. House,Al Mcaffrey,DEM,550177,0,0,406,406,05
Oklahoma,State House,Bruce Lee Smith,REP,550177,0,0,533,533,87
Oklahoma,State House,Elle Collins,LIB,550177,0,0,66,66,87
Oklahoma,State House,Collin Walke,DEM,550177,0,0,459,459,87
Oklahoma,President,Donald Trump,REP,550178,0,0,385,385,
Oklahoma,President,Gary Johnson,LIB,550178,0,0,82,82,
Oklahoma,President,Hillary Clinton,DEM,550178,0,0,328,328,
Oklahoma,U.S. Senate,James Lankford,REP,550178,0,0,447,447,
Oklahoma,U.S. Senate,Robert Murphy,LIB,550178,0,0,44,44,
Oklahoma,U.S. Senate,Mike Workman,DEM,550178,0,0,257,257,
Oklahoma,U.S. Senate,Mark Beard,IND,550178,0,0,16,16,
Oklahoma,U.S. Senate,Sean Braddy,IND,550178,0,0,30,30,
Oklahoma,U.S. House,Steve Russell,REP,550178,0,0,423,423,05
Oklahoma,U.S. House,Zachary Knight,LIB,550178,0,0,70,70,05
Oklahoma,U.S. House,Al Mcaffrey,DEM,550178,0,0,295,295,05
Oklahoma,State House,Bruce Lee Smith,REP,550178,0,0,364,364,87
Oklahoma,State House,Elle Collins,LIB,550178,0,0,72,72,87
Oklahoma,State House,Collin Walke,DEM,550178,0,0,356,356,87
Oklahoma,President,Donald Trump,REP,550179,0,0,502,502,
Oklahoma,President,Gary Johnson,LIB,550179,0,0,98,98,
Oklahoma,President,Hillary Clinton,DEM,550179,0,0,453,453,
Oklahoma,U.S. Senate,James Lankford,REP,550179,0,0,591,591,
Oklahoma,U.S. Senate,Robert Murphy,LIB,550179,0,0,50,50,
Oklahoma,U.S. Senate,Mike Workman,DEM,550179,0,0,352,352,
Oklahoma,U.S. Senate,Mark Beard,IND,550179,0,0,18,18,
Oklahoma,U.S. Senate,Sean Braddy,IND,550179,0,0,43,43,
Oklahoma,U.S. House,Steve Russell,REP,550179,0,0,562,562,05
Oklahoma,U.S. House,Zachary Knight,LIB,550179,0,0,70,70,05
Oklahoma,U.S. House,Al Mcaffrey,DEM,550179,0,0,413,413,05
Oklahoma,State House,Matt Jackson,REP,550179,0,0,470,470,85
Oklahoma,State House,Cyndi Munson,DEM,550179,0,0,581,581,85
Oklahoma,President,Donald Trump,REP,550180,0,0,319,319,
Oklahoma,President,Gary Johnson,LIB,550180,0,0,82,82,
Oklahoma,President,Hillary Clinton,DEM,550180,0,0,338,338,
Oklahoma,U.S. Senate,James Lankford,REP,550180,0,0,384,384,
Oklahoma,U.S. Senate,Robert Murphy,LIB,550180,0,0,49,49,
Oklahoma,U.S. Senate,Mike Workman,DEM,550180,0,0,255,255,
Oklahoma,U.S. Senate,Mark Beard,IND,550180,0,0,23,23,
Oklahoma,U.S. Senate,Sean Braddy,IND,550180,0,0,29,29,
Oklahoma,U.S. House,Steve Russell,REP,550180,0,0,371,371,05
Oklahoma,U.S. House,Zachary Knight,LIB,550180,0,0,70,70,05
Oklahoma,U.S. House,Al Mcaffrey,DEM,550180,0,0,292,292,05
Oklahoma,State House,Matt Jackson,REP,550180,0,0,292,292,85
Oklahoma,State House,Cyndi Munson,DEM,550180,0,0,440,440,85
Oklahoma,President,Donald Trump,REP,550181,0,0,207,207,
Oklahoma,President,Gary Johnson,LIB,550181,0,0,44,44,
Oklahoma,President,Hillary Clinton,DEM,550181,0,0,254,254,
Oklahoma,U.S. Senate,James Lankford,REP,550181,0,0,255,255,
Oklahoma,U.S. Senate,Robert Murphy,LIB,550181,0,0,40,40,
Oklahoma,U.S. Senate,Mike Workman,DEM,550181,0,0,191,191,
Oklahoma,U.S. Senate,Mark Beard,IND,550181,0,0,8,8,
Oklahoma,U.S. Senate,Sean Braddy,IND,550181,0,0,17,17,
Oklahoma,U.S. House,Steve Russell,REP,550181,0,0,240,240,05
Oklahoma,U.S. House,Zachary Knight,LIB,550181,0,0,51,51,05
Oklahoma,U.S. House,Al Mcaffrey,DEM,550181,0,0,212,212,05
Oklahoma,State House,Matt Jackson,REP,550181,0,0,200,200,85
Oklahoma,State House,Cyndi Munson,DEM,550181,0,0,300,300,85
Oklahoma,President,Donald Trump,REP,550182,0,0,140,140,
Oklahoma,President,Gary Johnson,LIB,550182,0,0,50,50,
Oklahoma,President,Hillary Clinton,DEM,550182,0,0,297,297,
Oklahoma,U.S. Senate,James Lankford,REP,550182,0,0,197,197,
Oklahoma,U.S. Senate,Robert Murphy,LIB,550182,0,0,26,26,
Oklahoma,U.S. Senate,Mike Workman,DEM,550182,0,0,229,229,
Oklahoma,U.S. Senate,Mark Beard,IND,550182,0,0,9,9,
Oklahoma,U.S. Senate,Sean Braddy,IND,550182,0,0,23,23,
Oklahoma,U.S. House,Steve Russell,REP,550182,0,0,174,174,05
Oklahoma,U.S. House,Zachary Knight,LIB,550182,0,0,43,43,05
Oklahoma,U.S. House,Al Mcaffrey,DEM,550182,0,0,265,265,05
Oklahoma,State House,Bruce Lee Smith,REP,550182,0,0,149,149,87
Oklahoma,State House,Elle Collins,LIB,550182,0,0,37,37,87
Oklahoma,State House,Collin Walke,DEM,550182,0,0,293,293,87
Oklahoma,President,Donald Trump,REP,550183,0,0,391,391,
Oklahoma,President,Gary Johnson,LIB,550183,0,0,88,88,
Oklahoma,President,Hillary Clinton,DEM,550183,0,0,441,441,
Oklahoma,U.S. Senate,James Lankford,REP,550183,0,0,449,449,
Oklahoma,U.S. Senate,Robert Murphy,LIB,550183,0,0,55,55,
Oklahoma,U.S. Senate,Mike Workman,DEM,550183,0,0,350,350,
Oklahoma,U.S. Senate,Mark Beard,IND,550183,0,0,21,21,
Oklahoma,U.S. Senate,Sean Braddy,IND,550183,0,0,42,42,
Oklahoma,U.S. House,Steve Russell,REP,550183,0,0,418,418,05
Oklahoma,U.S. House,Zachary Knight,LIB,550183,0,0,87,87,05
Oklahoma,U.S. House,Al Mcaffrey,DEM,550183,0,0,401,401,05
Oklahoma,State House,Bruce Lee Smith,REP,550183,0,0,377,377,87
Oklahoma,State House,Elle Collins,LIB,550183,0,0,73,73,87
Oklahoma,State House,Collin Walke,DEM,550183,0,0,462,462,87
Oklahoma,President,Donald Trump,REP,550184,0,0,396,396,
Oklahoma,President,Gary Johnson,LIB,550184,0,0,94,94,
Oklahoma,President,Hillary Clinton,DEM,550184,0,0,564,564,
Oklahoma,U.S. Senate,James Lankford,REP,550184,0,0,436,436,
Oklahoma,U.S. Senate,Robert Murphy,LIB,550184,0,0,72,72,
Oklahoma,U.S. Senate,Mike Workman,DEM,550184,0,0,451,451,
Oklahoma,U.S. Senate,Mark Beard,IND,550184,0,0,31,31,
Oklahoma,U.S. Senate,Sean Braddy,IND,550184,0,0,58,58,
Oklahoma,U.S. House,Steve Russell,REP,550184,0,0,404,404,05
Oklahoma,U.S. House,Zachary Knight,LIB,550184,0,0,113,113,05
Oklahoma,U.S. House,Al Mcaffrey,DEM,550184,0,0,527,527,05
Oklahoma,State House,Bruce Lee Smith,REP,550184,0,0,356,356,87
Oklahoma,State House,Elle Collins,LIB,550184,0,0,102,102,87
Oklahoma,State House,Collin Walke,DEM,550184,0,0,581,581,87
Oklahoma,President,Donald Trump,REP,550185,0,0,136,136,
Oklahoma,President,Gary Johnson,LIB,550185,0,0,35,35,
Oklahoma,President,Hillary Clinton,DEM,550185,0,0,219,219,
Oklahoma,U.S. Senate,James Lankford,REP,550185,0,0,150,150,
Oklahoma,U.S. Senate,Robert Murphy,LIB,550185,0,0,22,22,
Oklahoma,U.S. Senate,Mike Workman,DEM,550185,0,0,172,172,
Oklahoma,U.S. Senate,Mark Beard,IND,550185,0,0,9,9,
Oklahoma,U.S. Senate,Sean Braddy,IND,550185,0,0,29,29,
Oklahoma,U.S. House,Steve Russell,REP,550185,0,0,135,135,05
Oklahoma,U.S. House,Zachary Knight,LIB,550185,0,0,49,49,05
Oklahoma,U.S. House,Al Mcaffrey,DEM,550185,0,0,193,193,05
Oklahoma,President,Donald Trump,REP,550186,0,0,180,180,
Oklahoma,President,Gary Johnson,LIB,550186,0,0,59,59,
Oklahoma,President,Hillary Clinton,DEM,550186,0,0,286,286,
Oklahoma,U.S. Senate,James Lankford,REP,550186,0,0,249,249,
Oklahoma,U.S. Senate,Robert Murphy,LIB,550186,0,0,32,32,
Oklahoma,U.S. Senate,Mike Workman,DEM,550186,0,0,228,228,
Oklahoma,U.S. Senate,Mark Beard,IND,550186,0,0,18,18,
Oklahoma,U.S. Senate,Sean Braddy,IND,550186,0,0,28,28,
Oklahoma,U.S. House,Steve Russell,REP,550186,0,0,228,228,05
Oklahoma,U.S. House,Zachary Knight,LIB,550186,0,0,38,38,05
Oklahoma,U.S. House,Al Mcaffrey,DEM,550186,0,0,286,286,05
Oklahoma,President,Donald Trump,REP,550187,0,0,44,44,
Oklahoma,President,Gary Johnson,LIB,550187,0,0,15,15,
Oklahoma,President,Hillary Clinton,DEM,550187,0,0,71,71,
Oklahoma,U.S. Senate,James Lankford,REP,550187,0,0,57,57,
Oklahoma,U.S. Senate,Robert Murphy,LIB,550187,0,0,7,7,
Oklahoma,U.S. Senate,Mike Workman,DEM,550187,0,0,56,56,
Oklahoma,U.S. Senate,Mark Beard,IND,550187,0,0,2,2,
Oklahoma,U.S. Senate,Sean Braddy,IND,550187,0,0,8,8,
Oklahoma,U.S. House,Steve Russell,REP,550187,0,0,51,51,05
Oklahoma,U.S. House,Zachary Knight,LIB,550187,0,0,14,14,05
Oklahoma,U.S. House,Al Mcaffrey,DEM,550187,0,0,61,61,05
Oklahoma,State House,Joe Griffin,REP,550187,0,0,43,43,92
Oklahoma,State House,Forrest Bennett,DEM,550187,0,0,83,83,92
Oklahoma,President,Donald Trump,REP,550188,0,0,0,0,
Oklahoma,President,Gary Johnson,LIB,550188,0,0,0,0,
Oklahoma,President,Hillary Clinton,DEM,550188,0,0,3,3,
Oklahoma,U.S. Senate,James Lankford,REP,550188,0,0,0,0,
Oklahoma,U.S. Senate,Robert Murphy,LIB,550188,0,0,0,0,
Oklahoma,U.S. Senate,Mike Workman,DEM,550188,0,0,3,3,
Oklahoma,U.S. Senate,Mark Beard,IND,550188,0,0,0,0,
Oklahoma,U.S. Senate,Sean Braddy,IND,550188,0,0,0,0,
Oklahoma,U.S. House,Steve Russell,REP,550188,0,0,0,0,05
Oklahoma,U.S. House,Zachary Knight,LIB,550188,0,0,0,0,05
Oklahoma,U.S. House,Al Mcaffrey,DEM,550188,0,0,3,3,05
Oklahoma,State House,Joe Griffin,REP,550188,0,0,0,0,92
Oklahoma,State House,Forrest Bennett,DEM,550188,0,0,3,3,92
Oklahoma,President,Donald Trump,REP,550189,0,0,63,63,
Oklahoma,President,Gary Johnson,LIB,550189,0,0,14,14,
Oklahoma,President,Hillary Clinton,DEM,550189,0,0,73,73,
Oklahoma,U.S. Senate,James Lankford,REP,550189,0,0,83,83,
Oklahoma,U.S. Senate,Robert Murphy,LIB,550189,0,0,5,5,
Oklahoma,U.S. Senate,Mike Workman,DEM,550189,0,0,54,54,
Oklahoma,U.S. Senate,Mark Beard,IND,550189,0,0,6,6,
Oklahoma,U.S. Senate,Sean Braddy,IND,550189,0,0,5,5,
Oklahoma,U.S. House,Steve Russell,REP,550189,0,0,68,68,05
Oklahoma,U.S. House,Zachary Knight,LIB,550189,0,0,10,10,05
Oklahoma,U.S. House,Al Mcaffrey,DEM,550189,0,0,73,73,05
Oklahoma,State House,Joe Griffin,REP,550189,0,0,63,63,92
Oklahoma,State House,Forrest Bennett,DEM,550189,0,0,88,88,92
Oklahoma,President,Donald Trump,REP,550190,0,0,107,107,
Oklahoma,President,Gary Johnson,LIB,550190,0,0,32,32,
Oklahoma,President,Hillary Clinton,DEM,550190,0,0,310,310,
Oklahoma,U.S. Senate,James Lankford,REP,550190,0,0,129,129,
Oklahoma,U.S. Senate,Robert Murphy,LIB,550190,0,0,27,27,
Oklahoma,U.S. Senate,Mike Workman,DEM,550190,0,0,238,238,
Oklahoma,U.S. Senate,Mark Beard,IND,550190,0,0,18,18,
Oklahoma,U.S. Senate,Sean Braddy,IND,550190,0,0,32,32,
Oklahoma,U.S. House,Steve Russell,REP,550190,0,0,109,109,05
Oklahoma,U.S. House,Zachary Knight,LIB,550190,0,0,44,44,05
Oklahoma,U.S. House,Al Mcaffrey,DEM,550190,0,0,289,289,05
Oklahoma,State House,Joe Griffin,REP,550190,0,0,108,108,92
Oklahoma,State House,Forrest Bennett,DEM,550190,0,0,332,332,92
Oklahoma,President,Donald Trump,REP,550191,0,0,202,202,
Oklahoma,President,Gary Johnson,LIB,550191,0,0,76,76,
Oklahoma,President,Hillary Clinton,DEM,550191,0,0,406,406,
Oklahoma,U.S. Senate,James Lankford,REP,550191,0,0,231,231,
Oklahoma,U.S. Senate,Robert Murphy,LIB,550191,0,0,42,42,
Oklahoma,U.S. Senate,Mike Workman,DEM,550191,0,0,337,337,
Oklahoma,U.S. Senate,Mark Beard,IND,550191,0,0,23,23,
Oklahoma,U.S. Senate,Sean Braddy,IND,550191,0,0,52,52,
Oklahoma,U.S. House,Steve Russell,REP,550191,0,0,190,190,05
Oklahoma,U.S. House,Zachary Knight,LIB,550191,0,0,74,74,05
Oklahoma,U.S. House,Al Mcaffrey,DEM,550191,0,0,420,420,05
Oklahoma,President,Donald Trump,REP,550192,0,0,368,368,
Oklahoma,President,Gary Johnson,LIB,550192,0,0,116,116,
Oklahoma,President,Hillary Clinton,DEM,550192,0,0,718,718,
Oklahoma,U.S. Senate,James Lankford,REP,550192,0,0,458,458,
Oklahoma,U.S. Senate,Robert Murphy,LIB,550192,0,0,81,81,
Oklahoma,U.S. Senate,Mike Workman,DEM,550192,0,0,567,567,
Oklahoma,U.S. Senate,Mark Beard,IND,550192,0,0,27,27,
Oklahoma,U.S. Senate,Sean Braddy,IND,550192,0,0,76,76,
Oklahoma,U.S. House,Steve Russell,REP,550192,0,0,408,408,05
Oklahoma,U.S. House,Zachary Knight,LIB,550192,0,0,110,110,05
Oklahoma,U.S. House,Al Mcaffrey,DEM,550192,0,0,682,682,05
Oklahoma,President,Donald Trump,REP,550193,0,0,211,211,
Oklahoma,President,Gary Johnson,LIB,550193,0,0,67,67,
Oklahoma,President,Hillary Clinton,DEM,550193,0,0,537,537,
Oklahoma,U.S. Senate,James Lankford,REP,550193,0,0,249,249,
Oklahoma,U.S. Senate,Robert Murphy,LIB,550193,0,0,54,54,
Oklahoma,U.S. Senate,Mike Workman,DEM,550193,0,0,440,440,
Oklahoma,U.S. Senate,Mark Beard,IND,550193,0,0,18,18,
Oklahoma,U.S. Senate,Sean Braddy,IND,550193,0,0,57,57,
Oklahoma,U.S. House,Steve Russell,REP,550193,0,0,208,208,05
Oklahoma,U.S. House,Zachary Knight,LIB,550193,0,0,63,63,05
Oklahoma,U.S. House,Al Mcaffrey,DEM,550193,0,0,539,539,05
Oklahoma,President,Donald Trump,REP,550194,0,0,228,228,
Oklahoma,President,Gary Johnson,LIB,550194,0,0,81,81,
Oklahoma,President,Hillary Clinton,DEM,550194,0,0,425,425,
Oklahoma,U.S. Senate,James Lankford,REP,550194,0,0,281,281,
Oklahoma,U.S. Senate,Robert Murphy,LIB,550194,0,0,59,59,
Oklahoma,U.S. Senate,Mike Workman,DEM,550194,0,0,317,317,
Oklahoma,U.S. Senate,Mark Beard,IND,550194,0,0,21,21,
Oklahoma,U.S. Senate,Sean Braddy,IND,550194,0,0,52,52,
Oklahoma,U.S. House,Steve Russell,REP,550194,0,0,243,243,05
Oklahoma,U.S. House,Zachary Knight,LIB,550194,0,0,87,87,05
Oklahoma,U.S. House,Al Mcaffrey,DEM,550194,0,0,394,394,05
Oklahoma,President,Donald Trump,REP,550195,0,0,519,519,
Oklahoma,President,Gary Johnson,LIB,550195,0,0,137,137,
Oklahoma,President,Hillary Clinton,DEM,550195,0,0,687,687,
Oklahoma,U.S. Senate,James Lankford,REP,550195,0,0,624,624,
Oklahoma,U.S. Senate,Robert Murphy,LIB,550195,0,0,69,69,
Oklahoma,U.S. Senate,Mike Workman,DEM,550195,0,0,559,559,
Oklahoma,U.S. Senate,Mark Beard,IND,550195,0,0,30,30,
Oklahoma,U.S. Senate,Sean Braddy,IND,550195,0,0,72,72,
Oklahoma,U.S. House,Steve Russell,REP,550195,0,0,586,586,05
Oklahoma,U.S. House,Zachary Knight,LIB,550195,0,0,97,97,05
Oklahoma,U.S. House,Al Mcaffrey,DEM,550195,0,0,658,658,05
Oklahoma,State House,Bruce Lee Smith,REP,550195,0,0,506,506,87
Oklahoma,State House,Elle Collins,LIB,550195,0,0,117,117,87
Oklahoma,State House,Collin Walke,DEM,550195,0,0,715,715,87
Oklahoma,President,Donald Trump,REP,550196,0,0,642,642,
Oklahoma,President,Gary Johnson,LIB,550196,0,0,103,103,
Oklahoma,President,Hillary Clinton,DEM,550196,0,0,616,616,
Oklahoma,U.S. Senate,James Lankford,REP,550196,0,0,790,790,
Oklahoma,U.S. Senate,Robert Murphy,LIB,550196,0,0,59,59,
Oklahoma,U.S. Senate,Mike Workman,DEM,550196,0,0,445,445,
Oklahoma,U.S. Senate,Mark Beard,IND,550196,0,0,31,31,
Oklahoma,U.S. Senate,Sean Braddy,IND,550196,0,0,45,45,
Oklahoma,U.S. House,Steve Russell,REP,550196,0,0,759,759,05
Oklahoma,U.S. House,Zachary Knight,LIB,550196,0,0,86,86,05
Oklahoma,U.S. House,Al Mcaffrey,DEM,550196,0,0,519,519,05
Oklahoma,State House,Matt Jackson,REP,550196,0,0,611,611,85
Oklahoma,State House,Cyndi Munson,DEM,550196,0,0,756,756,85
Oklahoma,President,Donald Trump,REP,550197,0,0,263,263,
Oklahoma,President,Gary Johnson,LIB,550197,0,0,80,80,
Oklahoma,President,Hillary Clinton,DEM,550197,0,0,511,511,
Oklahoma,U.S. Senate,James Lankford,REP,550197,0,0,317,317,
Oklahoma,U.S. Senate,Robert Murphy,LIB,550197,0,0,45,45,
Oklahoma,U.S. Senate,Mike Workman,DEM,550197,0,0,412,412,
Oklahoma,U.S. Senate,Mark Beard,IND,550197,0,0,23,23,
Oklahoma,U.S. Senate,Sean Braddy,IND,550197,0,0,60,60,
Oklahoma,U.S. House,Steve Russell,REP,550197,0,0,280,280,05
Oklahoma,U.S. House,Zachary Knight,LIB,550197,0,0,69,69,05
Oklahoma,U.S. House,Al Mcaffrey,DEM,550197,0,0,506,506,05
Oklahoma,President,Donald Trump,REP,550198,0,0,245,245,
Oklahoma,President,Gary Johnson,LIB,550198,0,0,83,83,
Oklahoma,President,Hillary Clinton,DEM,550198,0,0,504,504,
Oklahoma,U.S. Senate,James Lankford,REP,550198,0,0,303,303,
Oklahoma,U.S. Senate,Robert Murphy,LIB,550198,0,0,54,54,
Oklahoma,U.S. Senate,Mike Workman,DEM,550198,0,0,390,390,
Oklahoma,U.S. Senate,Mark Beard,IND,550198,0,0,20,20,
Oklahoma,U.S. Senate,Sean Braddy,IND,550198,0,0,56,56,
Oklahoma,U.S. House,Steve Russell,REP,550198,0,0,268,268,05
Oklahoma,U.S. House,Zachary Knight,LIB,550198,0,0,65,65,05
Oklahoma,U.S. House,Al Mcaffrey,DEM,550198,0,0,489,489,05
Oklahoma,State House,Matt Jackson,REP,550198,0,0,223,223,85
Oklahoma,State House,Cyndi Munson,DEM,550198,0,0,605,605,85
Oklahoma,President,Donald Trump,REP,550199,0,0,263,263,
Oklahoma,President,Gary Johnson,LIB,550199,0,0,76,76,
Oklahoma,President,Hillary Clinton,DEM,550199,0,0,450,450,
Oklahoma,U.S. Senate,James Lankford,REP,550199,0,0,372,372,
Oklahoma,U.S. Senate,Robert Murphy,LIB,550199,0,0,33,33,
Oklahoma,U.S. Senate,Mike Workman,DEM,550199,0,0,338,338,
Oklahoma,U.S. Senate,Mark Beard,IND,550199,0,0,16,16,
Oklahoma,U.S. Senate,Sean Braddy,IND,550199,0,0,27,27,
Oklahoma,U.S. House,Steve Russell,REP,550199,0,0,324,324,05
Oklahoma,U.S. House,Zachary Knight,LIB,550199,0,0,49,49,05
Oklahoma,U.S. House,Al Mcaffrey,DEM,550199,0,0,418,418,05
Oklahoma,State House,Matt Jackson,REP,550199,0,0,257,257,85
Oklahoma,State House,Cyndi Munson,DEM,550199,0,0,527,527,85
Oklahoma,President,Donald Trump,REP,550200,0,0,309,309,
Oklahoma,President,Gary Johnson,LIB,550200,0,0,133,133,
Oklahoma,President,Hillary Clinton,DEM,550200,0,0,936,936,
Oklahoma,U.S. Senate,James Lankford,REP,550200,0,0,401,401,
Oklahoma,U.S. Senate,Robert Murphy,LIB,550200,0,0,94,94,
Oklahoma,U.S. Senate,Mike Workman,DEM,550200,0,0,722,722,
Oklahoma,U.S. Senate,Mark Beard,IND,550200,0,0,44,44,
Oklahoma,U.S. Senate,Sean Braddy,IND,550200,0,0,115,115,
Oklahoma,U.S. House,Steve Russell,REP,550200,0,0,342,342,05
Oklahoma,U.S. House,Zachary Knight,LIB,550200,0,0,136,136,05
Oklahoma,U.S. House,Al Mcaffrey,DEM,550200,0,0,893,893,05
Oklahoma,President,Donald Trump,REP,550201,0,0,211,211,
Oklahoma,President,Gary Johnson,LIB,550201,0,0,77,77,
Oklahoma,President,Hillary Clinton,DEM,550201,0,0,516,516,
Oklahoma,U.S. Senate,James Lankford,REP,550201,0,0,262,262,
Oklahoma,U.S. Senate,Robert Murphy,LIB,550201,0,0,57,57,
Oklahoma,U.S. Senate,Mike Workman,DEM,550201,0,0,395,395,
Oklahoma,U.S. Senate,Mark Beard,IND,550201,0,0,26,26,
Oklahoma,U.S. Senate,Sean Braddy,IND,550201,0,0,62,62,
Oklahoma,U.S. House,Steve Russell,REP,550201,0,0,232,232,05
Oklahoma,U.S. House,Zachary Knight,LIB,550201,0,0,83,83,05
Oklahoma,U.S. House,Al Mcaffrey,DEM,550201,0,0,481,481,05
Oklahoma,President,Donald Trump,REP,550202,0,0,191,191,
Oklahoma,President,Gary Johnson,LIB,550202,0,0,53,53,
Oklahoma,President,Hillary Clinton,DEM,550202,0,0,377,377,
Oklahoma,U.S. Senate,James Lankford,REP,550202,0,0,235,235,
Oklahoma,U.S. Senate,Robert Murphy,LIB,550202,0,0,31,31,
Oklahoma,U.S. Senate,Mike Workman,DEM,550202,0,0,300,300,
Oklahoma,U.S. Senate,Mark Beard,IND,550202,0,0,12,12,
Oklahoma,U.S. Senate,Sean Braddy,IND,550202,0,0,46,46,
Oklahoma,U.S. House,Steve Russell,REP,550202,0,0,203,203,05
Oklahoma,U.S. House,Zachary Knight,LIB,550202,0,0,44,44,05
Oklahoma,U.S. House,Al Mcaffrey,DEM,550202,0,0,375,375,05
Oklahoma,President,Donald Trump,REP,550203,0,0,197,197,
Oklahoma,President,Gary Johnson,LIB,550203,0,0,88,88,
Oklahoma,President,Hillary Clinton,DEM,550203,0,0,477,477,
Oklahoma,U.S. Senate,James Lankford,REP,550203,0,0,236,236,
Oklahoma,U.S. Senate,Robert Murphy,LIB,550203,0,0,59,59,
Oklahoma,U.S. Senate,Mike Workman,DEM,550203,0,0,371,371,
Oklahoma,U.S. Senate,Mark Beard,IND,550203,0,0,24,24,
Oklahoma,U.S. Senate,Sean Braddy,IND,550203,0,0,68,68,
Oklahoma,U.S. House,Steve Russell,REP,550203,0,0,210,210,05
Oklahoma,U.S. House,Zachary Knight,LIB,550203,0,0,83,83,05
Oklahoma,U.S. House,Al Mcaffrey,DEM,550203,0,0,463,463,05
Oklahoma,President,Donald Trump,REP,550204,0,0,425,425,
Oklahoma,President,Gary Johnson,LIB,550204,0,0,147,147,
Oklahoma,President,Hillary Clinton,DEM,550204,0,0,911,911,
Oklahoma,U.S. Senate,James Lankford,REP,550204,0,0,602,602,
Oklahoma,U.S. Senate,Robert Murphy,LIB,550204,0,0,90,90,
Oklahoma,U.S. Senate,Mike Workman,DEM,550204,0,0,691,691,
Oklahoma,U.S. Senate,Mark Beard,IND,550204,0,0,25,25,
Oklahoma,U.S. Senate,Sean Braddy,IND,550204,0,0,86,86,
Oklahoma,U.S. House,Steve Russell,REP,550204,0,0,491,491,05
Oklahoma,U.S. House,Zachary Knight,LIB,550204,0,0,98,98,05
Oklahoma,U.S. House,Al Mcaffrey,DEM,550204,0,0,900,900,05
Oklahoma,President,Donald Trump,REP,550205,0,0,232,232,
Oklahoma,President,Gary Johnson,LIB,550205,0,0,75,75,
Oklahoma,President,Hillary Clinton,DEM,550205,0,0,398,398,
Oklahoma,U.S. Senate,James Lankford,REP,550205,0,0,318,318,
Oklahoma,U.S. Senate,Robert Murphy,LIB,550205,0,0,38,38,
Oklahoma,U.S. Senate,Mike Workman,DEM,550205,0,0,300,300,
Oklahoma,U.S. Senate,Mark Beard,IND,550205,0,0,11,11,
Oklahoma,U.S. Senate,Sean Braddy,IND,550205,0,0,43,43,
Oklahoma,U.S. House,Steve Russell,REP,550205,0,0,278,278,05
Oklahoma,U.S. House,Zachary Knight,LIB,550205,0,0,67,67,05
Oklahoma,U.S. House,Al Mcaffrey,DEM,550205,0,0,363,363,05
Oklahoma,State House,Joe Griffin,REP,550205,0,0,285,285,92
Oklahoma,State House,Forrest Bennett,DEM,550205,0,0,408,408,92
Oklahoma,President,Donald Trump,REP,550206,0,0,82,82,
Oklahoma,President,Gary Johnson,LIB,550206,0,0,18,18,
Oklahoma,President,Hillary Clinton,DEM,550206,0,0,175,175,
Oklahoma,U.S. Senate,James Lankford,REP,550206,0,0,100,100,
Oklahoma,U.S. Senate,Robert Murphy,LIB,550206,0,0,8,8,
Oklahoma,U.S. Senate,Mike Workman,DEM,550206,0,0,138,138,
Oklahoma,U.S. Senate,Mark Beard,IND,550206,0,0,9,9,
Oklahoma,U.S. Senate,Sean Braddy,IND,550206,0,0,19,19,
Oklahoma,U.S. House,Steve Russell,REP,550206,0,0,89,89,05
Oklahoma,U.S. House,Zachary Knight,LIB,550206,0,0,20,20,05
Oklahoma,U.S. House,Al Mcaffrey,DEM,550206,0,0,160,160,05
Oklahoma,State House,Joe Griffin,REP,550206,0,0,86,86,92
Oklahoma,State House,Forrest Bennett,DEM,550206,0,0,183,183,92
Oklahoma,President,Donald Trump,REP,550207,0,0,307,307,
Oklahoma,President,Gary Johnson,LIB,550207,0,0,61,61,
Oklahoma,President,Hillary Clinton,DEM,550207,0,0,511,511,
Oklahoma,U.S. Senate,James Lankford,REP,550207,0,0,357,357,
Oklahoma,U.S. Senate,Robert Murphy,LIB,550207,0,0,44,44,
Oklahoma,U.S. Senate,Mike Workman,DEM,550207,0,0,408,408,
Oklahoma,U.S. Senate,Mark Beard,IND,550207,0,0,18,18,
Oklahoma,U.S. Senate,Sean Braddy,IND,550207,0,0,44,44,
Oklahoma,U.S. House,Steve Russell,REP,550207,0,0,337,337,05
Oklahoma,U.S. House,Zachary Knight,LIB,550207,0,0,86,86,05
Oklahoma,U.S. House,Al Mcaffrey,DEM,550207,0,0,443,443,05
Oklahoma,President,Donald Trump,REP,550208,0,0,9,9,
Oklahoma,President,Gary Johnson,LIB,550208,0,0,1,1,
Oklahoma,President,Hillary Clinton,DEM,550208,0,0,7,7,
Oklahoma,U.S. Senate,James Lankford,REP,550208,0,0,9,9,
Oklahoma,U.S. Senate,Robert Murphy,LIB,550208,0,0,2,2,
Oklahoma,U.S. Senate,Mike Workman,DEM,550208,0,0,5,5,
Oklahoma,U.S. Senate,Mark Beard,IND,550208,0,0,0,0,
Oklahoma,U.S. Senate,Sean Braddy,IND,550208,0,0,1,1,
Oklahoma,U.S. House,Steve Russell,REP,550208,0,0,9,9,05
Oklahoma,U.S. House,Zachary Knight,LIB,550208,0,0,2,2,05
Oklahoma,U.S. House,Al Mcaffrey,DEM,550208,0,0,6,6,05
Oklahoma,President,Donald Trump,REP,550209,0,0,284,284,
Oklahoma,President,Gary Johnson,LIB,550209,0,0,50,50,
Oklahoma,President,Hillary Clinton,DEM,550209,0,0,470,470,
Oklahoma,U.S. Senate,James Lankford,REP,550209,0,0,285,285,
Oklahoma,U.S. Senate,Robert Murphy,LIB,550209,0,0,45,45,
Oklahoma,U.S. Senate,Mike Workman,DEM,550209,0,0,380,380,
Oklahoma,U.S. Senate,Mark Beard,IND,550209,0,0,31,31,
Oklahoma,U.S. Senate,Sean Braddy,IND,550209,0,0,47,47,
Oklahoma,U.S. House,Steve Russell,REP,550209,0,0,289,289,05
Oklahoma,U.S. House,Zachary Knight,LIB,550209,0,0,73,73,05
Oklahoma,U.S. House,Al Mcaffrey,DEM,550209,0,0,425,425,05
Oklahoma,President,Donald Trump,REP,550210,0,0,245,245,
Oklahoma,President,Gary Johnson,LIB,550210,0,0,35,35,
Oklahoma,President,Hillary Clinton,DEM,550210,0,0,356,356,
Oklahoma,U.S. Senate,James Lankford,REP,550210,0,0,274,274,
Oklahoma,U.S. Senate,Robert Murphy,LIB,550210,0,0,25,25,
Oklahoma,U.S. Senate,Mike Workman,DEM,550210,0,0,277,277,
Oklahoma,U.S. Senate,Mark Beard,IND,550210,0,0,27,27,
Oklahoma,U.S. Senate,Sean Braddy,IND,550210,0,0,29,29,
Oklahoma,U.S. House,Steve Russell,REP,550210,0,0,253,253,05
Oklahoma,U.S. House,Zachary Knight,LIB,550210,0,0,44,44,05
Oklahoma,U.S. House,Al Mcaffrey,DEM,550210,0,0,325,325,05
Oklahoma,President,Donald Trump,REP,550211,0,0,196,196,
Oklahoma,President,Gary Johnson,LIB,550211,0,0,39,39,
Oklahoma,President,Hillary Clinton,DEM,550211,0,0,327,327,
Oklahoma,U.S. Senate,James Lankford,REP,550211,0,0,228,228,
Oklahoma,U.S. Senate,Robert Murphy,LIB,550211,0,0,28,28,
Oklahoma,U.S. Senate,Mike Workman,DEM,550211,0,0,258,258,
Oklahoma,U.S. Senate,Mark Beard,IND,550211,0,0,16,16,
Oklahoma,U.S. Senate,Sean Braddy,IND,550211,0,0,25,25,
Oklahoma,U.S. House,Steve Russell,REP,550211,0,0,203,203,05
Oklahoma,U.S. House,Zachary Knight,LIB,550211,0,0,47,47,05
Oklahoma,U.S. House,Al Mcaffrey,DEM,550211,0,0,304,304,05
Oklahoma,President,Donald Trump,REP,550212,0,0,197,197,
Oklahoma,President,Gary Johnson,LIB,550212,0,0,33,33,
Oklahoma,President,Hillary Clinton,DEM,550212,0,0,243,243,
Oklahoma,U.S. Senate,James Lankford,REP,550212,0,0,226,226,
Oklahoma,U.S. Senate,Robert Murphy,LIB,550212,0,0,18,18,
Oklahoma,U.S. Senate,Mike Workman,DEM,550212,0,0,201,201,
Oklahoma,U.S. Senate,Mark Beard,IND,550212,0,0,11,11,
Oklahoma,U.S. Senate,Sean Braddy,IND,550212,0,0,12,12,
Oklahoma,U.S. House,Steve Russell,REP,550212,0,0,202,202,05
Oklahoma,U.S. House,Zachary Knight,LIB,550212,0,0,31,31,05
Oklahoma,U.S. House,Al Mcaffrey,DEM,550212,0,0,230,230,05
Oklahoma,President,Donald Trump,REP,550213,0,0,102,102,
Oklahoma,President,Gary Johnson,LIB,550213,0,0,23,23,
Oklahoma,President,Hillary Clinton,DEM,550213,0,0,176,176,
Oklahoma,U.S. Senate,James Lankford,REP,550213,0,0,119,119,
Oklahoma,U.S. Senate,Robert Murphy,LIB,550213,0,0,14,14,
Oklahoma,U.S. Senate,Mike Workman,DEM,550213,0,0,144,144,
Oklahoma,U.S. Senate,Mark Beard,IND,550213,0,0,7,7,
Oklahoma,U.S. Senate,Sean Braddy,IND,550213,0,0,14,14,
Oklahoma,U.S. House,Steve Russell,REP,550213,0,0,111,111,05
Oklahoma,U.S. House,Zachary Knight,LIB,550213,0,0,24,24,05
Oklahoma,U.S. House,Al Mcaffrey,DEM,550213,0,0,162,162,05
Oklahoma,President,Donald Trump,REP,550214,0,0,166,166,
Oklahoma,President,Gary Johnson,LIB,550214,0,0,39,39,
Oklahoma,President,Hillary Clinton,DEM,550214,0,0,172,172,
Oklahoma,U.S. Senate,James Lankford,REP,550214,0,0,179,179,
Oklahoma,U.S. Senate,Robert Murphy,LIB,550214,0,0,17,17,
Oklahoma,U.S. Senate,Mike Workman,DEM,550214,0,0,148,148,
Oklahoma,U.S. Senate,Mark Beard,IND,550214,0,0,17,17,
Oklahoma,U.S. Senate,Sean Braddy,IND,550214,0,0,12,12,
Oklahoma,U.S. House,Steve Russell,REP,550214,0,0,165,165,05
Oklahoma,U.S. House,Zachary Knight,LIB,550214,0,0,39,39,05
Oklahoma,U.S. House,Al Mcaffrey,DEM,550214,0,0,166,166,05
Oklahoma,State House,Jay Means,REP,550214,0,0,137,137,93
Oklahoma,State House,Mickey Dollens,DEM,550214,0,0,231,231,93
Oklahoma,President,Donald Trump,REP,550215,0,0,274,274,
Oklahoma,President,Gary Johnson,LIB,550215,0,0,47,47,
Oklahoma,President,Hillary Clinton,DEM,550215,0,0,311,311,
Oklahoma,U.S. Senate,James Lankford,REP,550215,0,0,307,307,
Oklahoma,U.S. Senate,Robert Murphy,LIB,550215,0,0,23,23,
Oklahoma,U.S. Senate,Mike Workman,DEM,550215,0,0,253,253,
Oklahoma,U.S. Senate,Mark Beard,IND,550215,0,0,18,18,
Oklahoma,U.S. Senate,Sean Braddy,IND,550215,0,0,32,32,
Oklahoma,U.S. House,Steve Russell,REP,550215,0,0,289,289,05
Oklahoma,U.S. House,Zachary Knight,LIB,550215,0,0,45,45,05
Oklahoma,U.S. House,Al Mcaffrey,DEM,550215,0,0,295,295,05
Oklahoma,State House,Joe Griffin,REP,550215,0,0,273,273,92
Oklahoma,State House,Forrest Bennett,DEM,550215,0,0,353,353,92
Oklahoma,President,Donald Trump,REP,550216,0,0,7,7,
Oklahoma,President,Gary Johnson,LIB,550216,0,0,2,2,
Oklahoma,President,Hillary Clinton,DEM,550216,0,0,24,24,
Oklahoma,U.S. Senate,James Lankford,REP,550216,0,0,7,7,
Oklahoma,U.S. Senate,Robert Murphy,LIB,550216,0,0,1,1,
Oklahoma,U.S. Senate,Mike Workman,DEM,550216,0,0,22,22,
Oklahoma,U.S. Senate,Mark Beard,IND,550216,0,0,1,1,
Oklahoma,U.S. Senate,Sean Braddy,IND,550216,0,0,2,2,
Oklahoma,U.S. House,Steve Russell,REP,550216,0,0,7,7,05
Oklahoma,U.S. House,Zachary Knight,LIB,550216,0,0,5,5,05
Oklahoma,U.S. House,Al Mcaffrey,DEM,550216,0,0,21,21,05
Oklahoma,State House,Jay Means,REP,550216,0,0,7,7,93
Oklahoma,State House,Mickey Dollens,DEM,550216,0,0,26,26,93
Oklahoma,President,Donald Trump,REP,550217,0,0,328,328,
Oklahoma,President,Gary Johnson,LIB,550217,0,0,50,50,
Oklahoma,President,Hillary Clinton,DEM,550217,0,0,301,301,
Oklahoma,U.S. Senate,James Lankford,REP,550217,0,0,348,348,
Oklahoma,U.S. Senate,Robert Murphy,LIB,550217,0,0,28,28,
Oklahoma,U.S. Senate,Mike Workman,DEM,550217,0,0,244,244,
Oklahoma,U.S. Senate,Mark Beard,IND,550217,0,0,17,17,
Oklahoma,U.S. Senate,Sean Braddy,IND,550217,0,0,36,36,
Oklahoma,U.S. House,Steve Russell,REP,550217,0,0,329,329,05
Oklahoma,U.S. House,Zachary Knight,LIB,550217,0,0,52,52,05
Oklahoma,U.S. House,Al Mcaffrey,DEM,550217,0,0,281,281,05
Oklahoma,State House,Joe Griffin,REP,550217,0,0,335,335,92
Oklahoma,State House,Forrest Bennett,DEM,550217,0,0,336,336,92
Oklahoma,President,Donald Trump,REP,550218,0,0,500,500,
Oklahoma,President,Gary Johnson,LIB,550218,0,0,74,74,
Oklahoma,President,Hillary Clinton,DEM,550218,0,0,426,426,
Oklahoma,U.S. Senate,James Lankford,REP,550218,0,0,547,547,
Oklahoma,U.S. Senate,Robert Murphy,LIB,550218,0,0,36,36,
Oklahoma,U.S. Senate,Mike Workman,DEM,550218,0,0,338,338,
Oklahoma,U.S. Senate,Mark Beard,IND,550218,0,0,24,24,
Oklahoma,U.S. Senate,Sean Braddy,IND,550218,0,0,42,42,
Oklahoma,U.S. House,Steve Russell,REP,550218,0,0,511,511,05
Oklahoma,U.S. House,Zachary Knight,LIB,550218,0,0,72,72,05
Oklahoma,U.S. House,Al Mcaffrey,DEM,550218,0,0,393,393,05
Oklahoma,State House,Jay Means,REP,550218,0,0,410,410,93
Oklahoma,State House,Mickey Dollens,DEM,550218,0,0,571,571,93
Oklahoma,President,Donald Trump,REP,550219,0,0,243,243,
Oklahoma,President,Gary Johnson,LIB,550219,0,0,42,42,
Oklahoma,President,Hillary Clinton,DEM,550219,0,0,272,272,
Oklahoma,U.S. Senate,James Lankford,REP,550219,0,0,278,278,
Oklahoma,U.S. Senate,Robert Murphy,LIB,550219,0,0,14,14,
Oklahoma,U.S. Senate,Mike Workman,DEM,550219,0,0,223,223,
Oklahoma,U.S. Senate,Mark Beard,IND,550219,0,0,10,10,
Oklahoma,U.S. Senate,Sean Braddy,IND,550219,0,0,28,28,
Oklahoma,U.S. House,Steve Russell,REP,550219,0,0,248,248,05
Oklahoma,U.S. House,Zachary Knight,LIB,550219,0,0,40,40,05
Oklahoma,U.S. House,Al Mcaffrey,DEM,550219,0,0,262,262,05
Oklahoma,State House,Jay Means,REP,550219,0,0,204,204,93
Oklahoma,State House,Mickey Dollens,DEM,550219,0,0,343,343,93
Oklahoma,President,Donald Trump,REP,550220,0,0,455,455,
Oklahoma,President,Gary Johnson,LIB,550220,0,0,52,52,
Oklahoma,President,Hillary Clinton,DEM,550220,0,0,487,487,
Oklahoma,U.S. Senate,James Lankford,REP,550220,0,0,507,507,
Oklahoma,U.S. Senate,Robert Murphy,LIB,550220,0,0,35,35,
Oklahoma,U.S. Senate,Mike Workman,DEM,550220,0,0,389,389,
Oklahoma,U.S. Senate,Mark Beard,IND,550220,0,0,27,27,
Oklahoma,U.S. Senate,Sean Braddy,IND,550220,0,0,30,30,
Oklahoma,U.S. House,Steve Russell,REP,550220,0,0,482,482,05
Oklahoma,U.S. House,Zachary Knight,LIB,550220,0,0,69,69,05
Oklahoma,U.S. House,Al Mcaffrey,DEM,550220,0,0,427,427,05
Oklahoma,State House,Jay Means,REP,550220,0,0,385,385,93
Oklahoma,State House,Mickey Dollens,DEM,550220,0,0,604,604,93
Oklahoma,President,Donald Trump,REP,550221,0,0,502,502,
Oklahoma,President,Gary Johnson,LIB,550221,0,0,50,50,
Oklahoma,President,Hillary Clinton,DEM,550221,0,0,431,431,
Oklahoma,U.S. Senate,James Lankford,REP,550221,0,0,553,553,
Oklahoma,U.S. Senate,Robert Murphy,LIB,550221,0,0,32,32,
Oklahoma,U.S. Senate,Mike Workman,DEM,550221,0,0,342,342,
Oklahoma,U.S. Senate,Mark Beard,IND,550221,0,0,12,12,
Oklahoma,U.S. Senate,Sean Braddy,IND,550221,0,0,42,42,
Oklahoma,U.S. House,Steve Russell,REP,550221,0,0,520,520,05
Oklahoma,U.S. House,Zachary Knight,LIB,550221,0,0,59,59,05
Oklahoma,U.S. House,Al Mcaffrey,DEM,550221,0,0,397,397,05
Oklahoma,State House,Jay Means,REP,550221,0,0,377,377,93
Oklahoma,State House,Mickey Dollens,DEM,550221,0,0,604,604,93
Oklahoma,President,Donald Trump,REP,550222,0,0,297,297,
Oklahoma,President,Gary Johnson,LIB,550222,0,0,49,49,
Oklahoma,President,Hillary Clinton,DEM,550222,0,0,274,274,
Oklahoma,U.S. Senate,James Lankford,REP,550222,0,0,334,334,
Oklahoma,U.S. Senate,Robert Murphy,LIB,550222,0,0,18,18,
Oklahoma,U.S. Senate,Mike Workman,DEM,550222,0,0,213,213,
Oklahoma,U.S. Senate,Mark Beard,IND,550222,0,0,12,12,
Oklahoma,U.S. Senate,Sean Braddy,IND,550222,0,0,40,40,
Oklahoma,U.S. House,Steve Russell,REP,550222,0,0,305,305,05
Oklahoma,U.S. House,Zachary Knight,LIB,550222,0,0,54,54,05
Oklahoma,U.S. House,Al Mcaffrey,DEM,550222,0,0,247,247,05
Oklahoma,State House,Jay Means,REP,550222,0,0,230,230,93
Oklahoma,State House,Mickey Dollens,DEM,550222,0,0,385,385,93
Oklahoma,President,Donald Trump,REP,550223,0,0,199,199,
Oklahoma,President,Gary Johnson,LIB,550223,0,0,27,27,
Oklahoma,President,Hillary Clinton,DEM,550223,0,0,260,260,
Oklahoma,U.S. Senate,James Lankford,REP,550223,0,0,210,210,
Oklahoma,U.S. Senate,Robert Murphy,LIB,550223,0,0,19,19,
Oklahoma,U.S. Senate,Mike Workman,DEM,550223,0,0,221,221,
Oklahoma,U.S. Senate,Mark Beard,IND,550223,0,0,12,12,
Oklahoma,U.S. Senate,Sean Braddy,IND,550223,0,0,18,18,
Oklahoma,U.S. House,Steve Russell,REP,550223,0,0,198,198,05
Oklahoma,U.S. House,Zachary Knight,LIB,550223,0,0,36,36,05
Oklahoma,U.S. House,Al Mcaffrey,DEM,550223,0,0,245,245,05
Oklahoma,President,Donald Trump,REP,550224,0,0,313,313,
Oklahoma,President,Gary Johnson,LIB,550224,0,0,56,56,
Oklahoma,President,Hillary Clinton,DEM,550224,0,0,323,323,
Oklahoma,U.S. Senate,James Lankford,REP,550224,0,0,339,339,
Oklahoma,U.S. Senate,Robert Murphy,LIB,550224,0,0,30,30,
Oklahoma,U.S. Senate,Mike Workman,DEM,550224,0,0,264,264,
Oklahoma,U.S. Senate,Mark Beard,IND,550224,0,0,27,27,
Oklahoma,U.S. Senate,Sean Braddy,IND,550224,0,0,32,32,
Oklahoma,U.S. House,Steve Russell,REP,550224,0,0,335,335,05
Oklahoma,U.S. House,Zachary Knight,LIB,550224,0,0,69,69,05
Oklahoma,U.S. House,Al Mcaffrey,DEM,550224,0,0,284,284,05
Oklahoma,State House,Jay Means,REP,550224,0,0,277,277,93
Oklahoma,State House,Mickey Dollens,DEM,550224,0,0,410,410,93
Oklahoma,President,Donald Trump,REP,550225,0,0,56,56,
Oklahoma,President,Gary Johnson,LIB,550225,0,0,8,8,
Oklahoma,President,Hillary Clinton,DEM,550225,0,0,67,67,
Oklahoma,U.S. Senate,James Lankford,REP,550225,0,0,65,65,
Oklahoma,U.S. Senate,Robert Murphy,LIB,550225,0,0,6,6,
Oklahoma,U.S. Senate,Mike Workman,DEM,550225,0,0,50,50,
Oklahoma,U.S. Senate,Mark Beard,IND,550225,0,0,3,3,
Oklahoma,U.S. Senate,Sean Braddy,IND,550225,0,0,8,8,
Oklahoma,U.S. House,Steve Russell,REP,550225,0,0,54,54,05
Oklahoma,U.S. House,Zachary Knight,LIB,550225,0,0,12,12,05
Oklahoma,U.S. House,Al Mcaffrey,DEM,550225,0,0,64,64,05
Oklahoma,President,Donald Trump,REP,550226,0,0,344,344,
Oklahoma,President,Gary Johnson,LIB,550226,0,0,40,40,
Oklahoma,President,Hillary Clinton,DEM,550226,0,0,295,295,
Oklahoma,U.S. Senate,James Lankford,REP,550226,0,0,349,349,
Oklahoma,U.S. Senate,Robert Murphy,LIB,550226,0,0,22,22,
Oklahoma,U.S. Senate,Mike Workman,DEM,550226,0,0,242,242,
Oklahoma,U.S. Senate,Mark Beard,IND,550226,0,0,17,17,
Oklahoma,U.S. Senate,Sean Braddy,IND,550226,0,0,38,38,
Oklahoma,U.S. House,Steve Russell,REP,550226,0,0,322,322,05
Oklahoma,U.S. House,Zachary Knight,LIB,550226,0,0,56,56,05
Oklahoma,U.S. House,Al Mcaffrey,DEM,550226,0,0,286,286,05
Oklahoma,President,Donald Trump,REP,550227,0,0,264,264,
Oklahoma,President,Gary Johnson,LIB,550227,0,0,42,42,
Oklahoma,President,Hillary Clinton,DEM,550227,0,0,215,215,
Oklahoma,U.S. Senate,James Lankford,REP,550227,0,0,305,305,
Oklahoma,U.S. Senate,Robert Murphy,LIB,550227,0,0,28,28,
Oklahoma,U.S. Senate,Mike Workman,DEM,550227,0,0,156,156,
Oklahoma,U.S. Senate,Mark Beard,IND,550227,0,0,9,9,
Oklahoma,U.S. Senate,Sean Braddy,IND,550227,0,0,21,21,
Oklahoma,U.S. House,Steve Russell,REP,550227,0,0,278,278,05
Oklahoma,U.S. House,Zachary Knight,LIB,550227,0,0,42,42,05
Oklahoma,U.S. House,Al Mcaffrey,DEM,550227,0,0,192,192,05
Oklahoma,President,Donald Trump,REP,550228,0,0,303,303,
Oklahoma,President,Gary Johnson,LIB,550228,0,0,55,55,
Oklahoma,President,Hillary Clinton,DEM,550228,0,0,258,258,
Oklahoma,U.S. Senate,James Lankford,REP,550228,0,0,328,328,
Oklahoma,U.S. Senate,Robert Murphy,LIB,550228,0,0,39,39,
Oklahoma,U.S. Senate,Mike Workman,DEM,550228,0,0,200,200,
Oklahoma,U.S. Senate,Mark Beard,IND,550228,0,0,16,16,
Oklahoma,U.S. Senate,Sean Braddy,IND,550228,0,0,30,30,
Oklahoma,U.S. House,Steve Russell,REP,550228,0,0,311,311,05
Oklahoma,U.S. House,Zachary Knight,LIB,550228,0,0,64,64,05
Oklahoma,U.S. House,Al Mcaffrey,DEM,550228,0,0,237,237,05
Oklahoma,President,Donald Trump,REP,550229,0,0,497,497,
Oklahoma,President,Gary Johnson,LIB,550229,0,0,69,69,
Oklahoma,President,Hillary Clinton,DEM,550229,0,0,293,293,
Oklahoma,U.S. Senate,James Lankford,REP,550229,0,0,546,546,
Oklahoma,U.S. Senate,Robert Murphy,LIB,550229,0,0,26,26,
Oklahoma,U.S. Senate,Mike Workman,DEM,550229,0,0,223,223,
Oklahoma,U.S. Senate,Mark Beard,IND,550229,0,0,17,17,
Oklahoma,U.S. Senate,Sean Braddy,IND,550229,0,0,48,48,
Oklahoma,U.S. House,Steve Russell,REP,550229,0,0,503,503,05
Oklahoma,U.S. House,Zachary Knight,LIB,550229,0,0,62,62,05
Oklahoma,U.S. House,Al Mcaffrey,DEM,550229,0,0,286,286,05
Oklahoma,State House,Jay Means,REP,550229,0,0,355,355,93
Oklahoma,State House,Mickey Dollens,DEM,550229,0,0,498,498,93
Oklahoma,President,Donald Trump,REP,550230,0,0,513,513,
Oklahoma,President,Gary Johnson,LIB,550230,0,0,58,58,
Oklahoma,President,Hillary Clinton,DEM,550230,0,0,269,269,
Oklahoma,U.S. Senate,James Lankford,REP,550230,0,0,562,562,
Oklahoma,U.S. Senate,Robert Murphy,LIB,550230,0,0,23,23,
Oklahoma,U.S. Senate,Mike Workman,DEM,550230,0,0,216,216,
Oklahoma,U.S. Senate,Mark Beard,IND,550230,0,0,19,19,
Oklahoma,U.S. Senate,Sean Braddy,IND,550230,0,0,21,21,
Oklahoma,U.S. House,Steve Russell,REP,550230,0,0,535,535,05
Oklahoma,U.S. House,Zachary Knight,LIB,550230,0,0,47,47,05
Oklahoma,U.S. House,Al Mcaffrey,DEM,550230,0,0,246,246,05
Oklahoma,State House,Jay Means,REP,550230,0,0,342,342,93
Oklahoma,State House,Mickey Dollens,DEM,550230,0,0,491,491,93
Oklahoma,President,Donald Trump,REP,550231,0,0,334,334,
Oklahoma,President,Gary Johnson,LIB,550231,0,0,40,40,
Oklahoma,President,Hillary Clinton,DEM,550231,0,0,252,252,
Oklahoma,U.S. Senate,James Lankford,REP,550231,0,0,378,378,
Oklahoma,U.S. Senate,Robert Murphy,LIB,550231,0,0,21,21,
Oklahoma,U.S. Senate,Mike Workman,DEM,550231,0,0,191,191,
Oklahoma,U.S. Senate,Mark Beard,IND,550231,0,0,14,14,
Oklahoma,U.S. Senate,Sean Braddy,IND,550231,0,0,27,27,
Oklahoma,U.S. House,Steve Russell,REP,550231,0,0,352,352,05
Oklahoma,U.S. House,Zachary Knight,LIB,550231,0,0,48,48,05
Oklahoma,U.S. House,Al Mcaffrey,DEM,550231,0,0,224,224,05
Oklahoma,State House,Jay Means,REP,550231,0,0,260,260,93
Oklahoma,State House,Mickey Dollens,DEM,550231,0,0,364,364,93
Oklahoma,President,Donald Trump,REP,550232,0,0,511,511,
Oklahoma,President,Gary Johnson,LIB,550232,0,0,64,64,
Oklahoma,President,Hillary Clinton,DEM,550232,0,0,270,270,
Oklahoma,U.S. Senate,James Lankford,REP,550232,0,0,538,538,
Oklahoma,U.S. Senate,Robert Murphy,LIB,550232,0,0,27,27,
Oklahoma,U.S. Senate,Mike Workman,DEM,550232,0,0,222,222,
Oklahoma,U.S. Senate,Mark Beard,IND,550232,0,0,21,21,
Oklahoma,U.S. Senate,Sean Braddy,IND,550232,0,0,33,33,
Oklahoma,U.S. House,Steve Russell,REP,550232,0,0,519,519,05
Oklahoma,U.S. House,Zachary Knight,LIB,550232,0,0,62,62,05
Oklahoma,U.S. House,Al Mcaffrey,DEM,550232,0,0,251,251,05
Oklahoma,State House,Kevin West,REP,550232,0,0,479,479,54
Oklahoma,State House,Mary Newcome-Hatch,DEM,550232,0,0,232,232,54
Oklahoma,State House,Elizabeth Larios,IND,550232,0,0,124,124,54
Oklahoma,President,Donald Trump,REP,550233,0,0,182,182,
Oklahoma,President,Gary Johnson,LIB,550233,0,0,25,25,
Oklahoma,President,Hillary Clinton,DEM,550233,0,0,81,81,
Oklahoma,U.S. Senate,James Lankford,REP,550233,0,0,179,179,
Oklahoma,U.S. Senate,Robert Murphy,LIB,550233,0,0,19,19,
Oklahoma,U.S. Senate,Mike Workman,DEM,550233,0,0,67,67,
Oklahoma,U.S. Senate,Mark Beard,IND,550233,0,0,10,10,
Oklahoma,U.S. Senate,Sean Braddy,IND,550233,0,0,9,9,
Oklahoma,U.S. House,Steve Russell,REP,550233,0,0,165,165,05
Oklahoma,U.S. House,Zachary Knight,LIB,550233,0,0,36,36,05
Oklahoma,U.S. House,Al Mcaffrey,DEM,550233,0,0,82,82,05
Oklahoma,State House,Kevin West,REP,550233,0,0,149,149,54
Oklahoma,State House,Mary Newcome-Hatch,DEM,550233,0,0,69,69,54
Oklahoma,State House,Elizabeth Larios,IND,550233,0,0,61,61,54
Oklahoma,President,Donald Trump,REP,550234,0,0,334,334,
Oklahoma,President,Gary Johnson,LIB,550234,0,0,48,48,
Oklahoma,President,Hillary Clinton,DEM,550234,0,0,259,259,
Oklahoma,U.S. Senate,James Lankford,REP,550234,0,0,365,365,
Oklahoma,U.S. Senate,Robert Murphy,LIB,550234,0,0,36,36,
Oklahoma,U.S. Senate,Mike Workman,DEM,550234,0,0,187,187,
Oklahoma,U.S. Senate,Mark Beard,IND,550234,0,0,16,16,
Oklahoma,U.S. Senate,Sean Braddy,IND,550234,0,0,34,34,
Oklahoma,U.S. House,Steve Russell,REP,550234,0,0,355,355,05
Oklahoma,U.S. House,Zachary Knight,LIB,550234,0,0,54,54,05
Oklahoma,U.S. House,Al Mcaffrey,DEM,550234,0,0,227,227,05
Oklahoma,State House,Joe Griffin,REP,550234,0,0,314,314,92
Oklahoma,State House,Forrest Bennett,DEM,550234,0,0,310,310,92
Oklahoma,President,Donald Trump,REP,550235,0,0,192,192,
Oklahoma,President,Gary Johnson,LIB,550235,0,0,30,30,
Oklahoma,President,Hillary Clinton,DEM,550235,0,0,353,353,
Oklahoma,U.S. Senate,James Lankford,REP,550235,0,0,219,219,
Oklahoma,U.S. Senate,Robert Murphy,LIB,550235,0,0,19,19,
Oklahoma,U.S. Senate,Mike Workman,DEM,550235,0,0,297,297,
Oklahoma,U.S. Senate,Mark Beard,IND,550235,0,0,18,18,
Oklahoma,U.S. Senate,Sean Braddy,IND,550235,0,0,16,16,
Oklahoma,U.S. House,Steve Russell,REP,550235,0,0,206,206,05
Oklahoma,U.S. House,Zachary Knight,LIB,550235,0,0,41,41,05
Oklahoma,U.S. House,Al Mcaffrey,DEM,550235,0,0,317,317,05
Oklahoma,State House,Joe Griffin,REP,550235,0,0,184,184,92
Oklahoma,State House,Forrest Bennett,DEM,550235,0,0,382,382,92
Oklahoma,President,Donald Trump,REP,550236,0,0,0,0,
Oklahoma,President,Gary Johnson,LIB,550236,0,0,0,0,
Oklahoma,President,Hillary Clinton,DEM,550236,0,0,0,0,
Oklahoma,U.S. Senate,James Lankford,REP,550236,0,0,0,0,
Oklahoma,U.S. Senate,Robert Murphy,LIB,550236,0,0,0,0,
Oklahoma,U.S. Senate,Mike Workman,DEM,550236,0,0,0,0,
Oklahoma,U.S. Senate,Mark Beard,IND,550236,0,0,0,0,
Oklahoma,U.S. Senate,Sean Braddy,IND,550236,0,0,0,0,
Oklahoma,U.S. House,Steve Russell,REP,550236,0,0,0,0,05
Oklahoma,U.S. House,Zachary Knight,LIB,550236,0,0,0,0,05
Oklahoma,U.S. House,Al Mcaffrey,DEM,550236,0,0,0,0,05
Oklahoma,State House,George Young,DEM,550236,0,0,0,0,99
Oklahoma,State House,Marina Mangiaracina,IND,550236,0,0,0,0,99
Oklahoma,President,Donald Trump,REP,550237,0,0,0,0,
Oklahoma,President,Gary Johnson,LIB,550237,0,0,0,0,
Oklahoma,President,Hillary Clinton,DEM,550237,0,0,3,3,
Oklahoma,U.S. Senate,James Lankford,REP,550237,0,0,0,0,
Oklahoma,U.S. Senate,Robert Murphy,LIB,550237,0,0,0,0,
Oklahoma,U.S. Senate,Mike Workman,DEM,550237,0,0,3,3,
Oklahoma,U.S. Senate,Mark Beard,IND,550237,0,0,0,0,
Oklahoma,U.S. Senate,Sean Braddy,IND,550237,0,0,0,0,
Oklahoma,U.S. House,Steve Russell,REP,550237,0,0,0,0,05
Oklahoma,U.S. House,Zachary Knight,LIB,550237,0,0,0,0,05
Oklahoma,U.S. House,Al Mcaffrey,DEM,550237,0,0,3,3,05
Oklahoma,State House,George Young,DEM,550237,0,0,3,3,99
Oklahoma,State House,Marina Mangiaracina,IND,550237,0,0,0,0,99
Oklahoma,President,Donald Trump,REP,550238,0,0,0,0,
Oklahoma,President,Gary Johnson,LIB,550238,0,0,0,0,
Oklahoma,President,Hillary Clinton,DEM,550238,0,0,0,0,
Oklahoma,U.S. Senate,James Lankford,REP,550238,0,0,0,0,
Oklahoma,U.S. Senate,Robert Murphy,LIB,550238,0,0,0,0,
Oklahoma,U.S. Senate,Mike Workman,DEM,550238,0,0,0,0,
Oklahoma,U.S. Senate,Mark Beard,IND,550238,0,0,0,0,
Oklahoma,U.S. Senate,Sean Braddy,IND,550238,0,0,0,0,
Oklahoma,U.S. House,Steve Russell,REP,550238,0,0,0,0,05
Oklahoma,U.S. House,Zachary Knight,LIB,550238,0,0,0,0,05
Oklahoma,U.S. House,Al Mcaffrey,DEM,550238,0,0,0,0,05
Oklahoma,State House,George Young,DEM,550238,0,0,0,0,99
Oklahoma,State House,Marina Mangiaracina,IND,550238,0,0,0,0,99
Oklahoma,President,Donald Trump,REP,550239,0,0,150,150,
Oklahoma,President,Gary Johnson,LIB,550239,0,0,69,69,
Oklahoma,President,Hillary Clinton,DEM,550239,0,0,568,568,
Oklahoma,U.S. Senate,James Lankford,REP,550239,0,0,229,229,
Oklahoma,U.S. Senate,Robert Murphy,LIB,550239,0,0,39,39,
Oklahoma,U.S. Senate,Mike Workman,DEM,550239,0,0,463,463,
Oklahoma,U.S. Senate,Mark Beard,IND,550239,0,0,12,12,
Oklahoma,U.S. Senate,Sean Braddy,IND,550239,0,0,46,46,
Oklahoma,U.S. House,Steve Russell,REP,550239,0,0,197,197,05
Oklahoma,U.S. House,Zachary Knight,LIB,550239,0,0,51,51,05
Oklahoma,U.S. House,Al Mcaffrey,DEM,550239,0,0,533,533,05
Oklahoma,State House,George Young,DEM,550239,0,0,560,560,99
Oklahoma,State House,Marina Mangiaracina,IND,550239,0,0,167,167,99
Oklahoma,President,Donald Trump,REP,550240,0,0,42,42,
Oklahoma,President,Gary Johnson,LIB,550240,0,0,22,22,
Oklahoma,President,Hillary Clinton,DEM,550240,0,0,660,660,
Oklahoma,U.S. Senate,James Lankford,REP,550240,0,0,82,82,
Oklahoma,U.S. Senate,Robert Murphy,LIB,550240,0,0,13,13,
Oklahoma,U.S. Senate,Mike Workman,DEM,550240,0,0,575,575,
Oklahoma,U.S. Senate,Mark Beard,IND,550240,0,0,13,13,
Oklahoma,U.S. Senate,Sean Braddy,IND,550240,0,0,31,31,
Oklahoma,U.S. House,Steve Russell,REP,550240,0,0,58,58,05
Oklahoma,U.S. House,Zachary Knight,LIB,550240,0,0,19,19,05
Oklahoma,U.S. House,Al Mcaffrey,DEM,550240,0,0,634,634,05
Oklahoma,State House,George Young,DEM,550240,0,0,644,644,99
Oklahoma,State House,Marina Mangiaracina,IND,550240,0,0,57,57,99
Oklahoma,President,Donald Trump,REP,550241,0,0,73,73,
Oklahoma,President,Gary Johnson,LIB,550241,0,0,37,37,
Oklahoma,President,Hillary Clinton,DEM,550241,0,0,491,491,
Oklahoma,U.S. Senate,James Lankford,REP,550241,0,0,125,125,
Oklahoma,U.S. Senate,Robert Murphy,LIB,550241,0,0,27,27,
Oklahoma,U.S. Senate,Mike Workman,DEM,550241,0,0,405,405,
Oklahoma,U.S. Senate,Mark Beard,IND,550241,0,0,11,11,
Oklahoma,U.S. Senate,Sean Braddy,IND,550241,0,0,29,29,
Oklahoma,U.S. House,Steve Russell,REP,550241,0,0,105,105,05
Oklahoma,U.S. House,Zachary Knight,LIB,550241,0,0,35,35,05
Oklahoma,U.S. House,Al Mcaffrey,DEM,550241,0,0,454,454,05
Oklahoma,State House,George Young,DEM,550241,0,0,487,487,99
Oklahoma,State House,Marina Mangiaracina,IND,550241,0,0,88,88,99
Oklahoma,President,Donald Trump,REP,550242,0,0,15,15,
Oklahoma,President,Gary Johnson,LIB,550242,0,0,9,9,
Oklahoma,President,Hillary Clinton,DEM,550242,0,0,458,458,
Oklahoma,U.S. Senate,James Lankford,REP,550242,0,0,44,44,
Oklahoma,U.S. Senate,Robert Murphy,LIB,550242,0,0,10,10,
Oklahoma,U.S. Senate,Mike Workman,DEM,550242,0,0,405,405,
Oklahoma,U.S. Senate,Mark Beard,IND,550242,0,0,9,9,
Oklahoma,U.S. Senate,Sean Braddy,IND,550242,0,0,17,17,
Oklahoma,U.S. House,Steve Russell,REP,550242,0,0,34,34,05
Oklahoma,U.S. House,Zachary Knight,LIB,550242,0,0,13,13,05
Oklahoma,U.S. House,Al Mcaffrey,DEM,550242,0,0,436,436,05
Oklahoma,State House,Tonni Canaday,REP,550242,0,0,18,18,97
Oklahoma,State House,Jason Lowe,DEM,550242,0,0,467,467,97
Oklahoma,President,Donald Trump,REP,550243,0,0,21,21,
Oklahoma,President,Gary Johnson,LIB,550243,0,0,19,19,
Oklahoma,President,Hillary Clinton,DEM,550243,0,0,685,685,
Oklahoma,U.S. Senate,James Lankford,REP,550243,0,0,60,60,
Oklahoma,U.S. Senate,Robert Murphy,LIB,550243,0,0,12,12,
Oklahoma,U.S. Senate,Mike Workman,DEM,550243,0,0,613,613,
Oklahoma,U.S. Senate,Mark Beard,IND,550243,0,0,14,14,
Oklahoma,U.S. Senate,Sean Braddy,IND,550243,0,0,24,24,
Oklahoma,U.S. House,Steve Russell,REP,550243,0,0,35,35,05
Oklahoma,U.S. House,Zachary Knight,LIB,550243,0,0,24,24,05
Oklahoma,U.S. House,Al Mcaffrey,DEM,550243,0,0,661,661,05
Oklahoma,State House,Tonni Canaday,REP,550243,0,0,24,24,97
Oklahoma,State House,Jason Lowe,DEM,550243,0,0,697,697,97
Oklahoma,President,Donald Trump,REP,550244,0,0,25,25,
Oklahoma,President,Gary Johnson,LIB,550244,0,0,15,15,
Oklahoma,President,Hillary Clinton,DEM,550244,0,0,669,669,
Oklahoma,U.S. Senate,James Lankford,REP,550244,0,0,71,71,
Oklahoma,U.S. Senate,Robert Murphy,LIB,550244,0,0,17,17,
Oklahoma,U.S. Senate,Mike Workman,DEM,550244,0,0,568,568,
Oklahoma,U.S. Senate,Mark Beard,IND,550244,0,0,11,11,
Oklahoma,U.S. Senate,Sean Braddy,IND,550244,0,0,35,35,
Oklahoma,U.S. House,Steve Russell,REP,550244,0,0,35,35,05
Oklahoma,U.S. House,Zachary Knight,LIB,550244,0,0,31,31,05
Oklahoma,U.S. House,Al Mcaffrey,DEM,550244,0,0,635,635,05
Oklahoma,State House,George Young,DEM,550244,0,0,654,654,99
Oklahoma,State House,Marina Mangiaracina,IND,550244,0,0,43,43,99
Oklahoma,President,Donald Trump,REP,550245,0,0,22,22,
Oklahoma,President,Gary Johnson,LIB,550245,0,0,19,19,
Oklahoma,President,Hillary Clinton,DEM,550245,0,0,785,785,
Oklahoma,U.S. Senate,James Lankford,REP,550245,0,0,68,68,
Oklahoma,U.S. Senate,Robert Murphy,LIB,550245,0,0,12,12,
Oklahoma,U.S. Senate,Mike Workman,DEM,550245,0,0,687,687,
Oklahoma,U.S. Senate,Mark Beard,IND,550245,0,0,18,18,
Oklahoma,U.S. Senate,Sean Braddy,IND,550245,0,0,33,33,
Oklahoma,U.S. House,Steve Russell,REP,550245,0,0,37,37,05
Oklahoma,U.S. House,Zachary Knight,LIB,550245,0,0,30,30,05
Oklahoma,U.S. House,Al Mcaffrey,DEM,550245,0,0,749,749,05
Oklahoma,State House,George Young,DEM,550245,0,0,762,762,99
Oklahoma,State House,Marina Mangiaracina,IND,550245,0,0,48,48,99
Oklahoma,President,Donald Trump,REP,550246,0,0,112,112,
Oklahoma,President,Gary Johnson,LIB,550246,0,0,18,18,
Oklahoma,President,Hillary Clinton,DEM,550246,0,0,107,107,
Oklahoma,U.S. Senate,James Lankford,REP,550246,0,0,120,120,
Oklahoma,U.S. Senate,Robert Murphy,LIB,550246,0,0,11,11,
Oklahoma,U.S. Senate,Mike Workman,DEM,550246,0,0,93,93,
Oklahoma,U.S. Senate,Mark Beard,IND,550246,0,0,7,7,
Oklahoma,U.S. Senate,Sean Braddy,IND,550246,0,0,7,7,
Oklahoma,U.S. House,Steve Russell,REP,550246,0,0,120,120,05
Oklahoma,U.S. House,Zachary Knight,LIB,550246,0,0,17,17,05
Oklahoma,U.S. House,Al Mcaffrey,DEM,550246,0,0,99,99,05
Oklahoma,State House,Jason Sansone,REP,550246,0,0,92,92,94
Oklahoma,State House,Scott Inman,DEM,550246,0,0,143,143,94
Oklahoma,President,Donald Trump,REP,550247,0,0,227,227,
Oklahoma,President,Gary Johnson,LIB,550247,0,0,36,36,
Oklahoma,President,Hillary Clinton,DEM,550247,0,0,379,379,
Oklahoma,U.S. Senate,James Lankford,REP,550247,0,0,232,232,
Oklahoma,U.S. Senate,Robert Murphy,LIB,550247,0,0,16,16,
Oklahoma,U.S. Senate,Mike Workman,DEM,550247,0,0,340,340,
Oklahoma,U.S. Senate,Mark Beard,IND,550247,0,0,20,20,
Oklahoma,U.S. Senate,Sean Braddy,IND,550247,0,0,31,31,
Oklahoma,U.S. House,Steve Russell,REP,550247,0,0,216,216,05
Oklahoma,U.S. House,Zachary Knight,LIB,550247,0,0,47,47,05
Oklahoma,U.S. House,Al Mcaffrey,DEM,550247,0,0,372,372,05
Oklahoma,State House,Joe Griffin,REP,550247,0,0,213,213,92
Oklahoma,State House,Forrest Bennett,DEM,550247,0,0,427,427,92
Oklahoma,President,Donald Trump,REP,550248,0,0,391,391,
Oklahoma,President,Gary Johnson,LIB,550248,0,0,90,90,
Oklahoma,President,Hillary Clinton,DEM,550248,0,0,793,793,
Oklahoma,U.S. Senate,James Lankford,REP,550248,0,0,474,474,
Oklahoma,U.S. Senate,Robert Murphy,LIB,550248,0,0,33,33,
Oklahoma,U.S. Senate,Mike Workman,DEM,550248,0,0,662,662,
Oklahoma,U.S. Senate,Mark Beard,IND,550248,0,0,32,32,
Oklahoma,U.S. Senate,Sean Braddy,IND,550248,0,0,62,62,
Oklahoma,U.S. House,Steve Russell,REP,550248,0,0,430,430,05
Oklahoma,U.S. House,Zachary Knight,LIB,550248,0,0,70,70,05
Oklahoma,U.S. House,Al Mcaffrey,DEM,550248,0,0,759,759,05
Oklahoma,State House,Jason Sansone,REP,550248,0,0,339,339,94
Oklahoma,State House,Scott Inman,DEM,550248,0,0,921,921,94
Oklahoma,President,Donald Trump,REP,550249,0,0,647,647,
Oklahoma,President,Gary Johnson,LIB,550249,0,0,114,114,
Oklahoma,President,Hillary Clinton,DEM,550249,0,0,768,768,
Oklahoma,U.S. Senate,James Lankford,REP,550249,0,0,753,753,
Oklahoma,U.S. Senate,Robert Murphy,LIB,550249,0,0,39,39,
Oklahoma,U.S. Senate,Mike Workman,DEM,550249,0,0,660,660,
Oklahoma,U.S. Senate,Mark Beard,IND,550249,0,0,24,24,
Oklahoma,U.S. Senate,Sean Braddy,IND,550249,0,0,55,55,
Oklahoma,U.S. House,Steve Russell,REP,550249,0,0,742,742,05
Oklahoma,U.S. House,Zachary Knight,LIB,550249,0,0,83,83,05
Oklahoma,U.S. House,Al Mcaffrey,DEM,550249,0,0,699,699,05
Oklahoma,State Senate,Rob Standridge,REP,550249,0,0,749,749,15
Oklahoma,State Senate,Shawn Sheehan,IND,550249,0,0,619,619,15
Oklahoma,State House,Jason Sansone,REP,550249,0,0,497,497,94
Oklahoma,State House,Scott Inman,DEM,550249,0,0,1028,1028,94
Oklahoma,President,Donald Trump,REP,550250,0,0,547,547,
Oklahoma,President,Gary Johnson,LIB,550250,0,0,79,79,
Oklahoma,President,Hillary Clinton,DEM,550250,0,0,447,447,
Oklahoma,U.S. Senate,James Lankford,REP,550250,0,0,586,586,
Oklahoma,U.S. Senate,Robert Murphy,LIB,550250,0,0,38,38,
Oklahoma,U.S. Senate,Mike Workman,DEM,550250,0,0,363,363,
Oklahoma,U.S. Senate,Mark Beard,IND,550250,0,0,35,35,
Oklahoma,U.S. Senate,Sean Braddy,IND,550250,0,0,50,50,
Oklahoma,U.S. House,Steve Russell,REP,550250,0,0,563,563,05
Oklahoma,U.S. House,Zachary Knight,LIB,550250,0,0,83,83,05
Oklahoma,U.S. House,Al Mcaffrey,DEM,550250,0,0,421,421,05
Oklahoma,State Senate,Rob Standridge,REP,550250,0,0,557,557,15
Oklahoma,State Senate,Shawn Sheehan,IND,550250,0,0,439,439,15
Oklahoma,State House,Jason Sansone,REP,550250,0,0,450,450,94
Oklahoma,State House,Scott Inman,DEM,550250,0,0,620,620,94
Oklahoma,President,Donald Trump,REP,550251,0,0,761,761,
Oklahoma,President,Gary Johnson,LIB,550251,0,0,115,115,
Oklahoma,President,Hillary Clinton,DEM,550251,0,0,702,702,
Oklahoma,U.S. Senate,James Lankford,REP,550251,0,0,855,855,
Oklahoma,U.S. Senate,Robert Murphy,LIB,550251,0,0,60,60,
Oklahoma,U.S. Senate,Mike Workman,DEM,550251,0,0,569,569,
Oklahoma,U.S. Senate,Mark Beard,IND,550251,0,0,34,34,
Oklahoma,U.S. Senate,Sean Braddy,IND,550251,0,0,65,65,
Oklahoma,U.S. House,Tom Cole,REP,550251,0,0,852,852,04
Oklahoma,U.S. House,Sevier White,LIB,550251,0,0,80,80,04
Oklahoma,U.S. House,Christina Owen,DEM,550251,0,0,650,650,04
Oklahoma,State House,Roger Ford,REP,550251,0,0,802,802,95
Oklahoma,State House,James Cook,DEM,550251,0,0,768,768,95
Oklahoma,President,Donald Trump,REP,550252,0,0,1054,1054,
Oklahoma,President,Gary Johnson,LIB,550252,0,0,65,65,
Oklahoma,President,Hillary Clinton,DEM,550252,0,0,317,317,
Oklahoma,U.S. Senate,James Lankford,REP,550252,0,0,1105,1105,
Oklahoma,U.S. Senate,Robert Murphy,LIB,550252,0,0,41,41,
Oklahoma,U.S. Senate,Mike Workman,DEM,550252,0,0,242,242,
Oklahoma,U.S. Senate,Mark Beard,IND,550252,0,0,24,24,
Oklahoma,U.S. Senate,Sean Braddy,IND,550252,0,0,28,28,
Oklahoma,U.S. House,Tom Cole,REP,550252,0,0,1068,1068,04
Oklahoma,U.S. House,Sevier White,LIB,550252,0,0,75,75,04
Oklahoma,U.S. House,Christina Owen,DEM,550252,0,0,289,289,04
Oklahoma,State House,Roger Ford,REP,550252,0,0,1047,1047,95
Oklahoma,State House,James Cook,DEM,550252,0,0,383,383,95
Oklahoma,President,Donald Trump,REP,550253,0,0,376,376,
Oklahoma,President,Gary Johnson,LIB,550253,0,0,22,22,
Oklahoma,President,Hillary Clinton,DEM,550253,0,0,78,78,
Oklahoma,U.S. Senate,James Lankford,REP,550253,0,0,387,387,
Oklahoma,U.S. Senate,Robert Murphy,LIB,550253,0,0,9,9,
Oklahoma,U.S. Senate,Mike Workman,DEM,550253,0,0,54,54,
Oklahoma,U.S. Senate,Mark Beard,IND,550253,0,0,15,15,
Oklahoma,U.S. Senate,Sean Braddy,IND,550253,0,0,10,10,
Oklahoma,U.S. House,Steve Russell,REP,550253,0,0,371,371,05
Oklahoma,U.S. House,Zachary Knight,LIB,550253,0,0,33,33,05
Oklahoma,U.S. House,Al Mcaffrey,DEM,550253,0,0,59,59,05
Oklahoma,State House,Tess Teague,REP,550253,0,0,343,343,10
Oklahoma,State House,Cheryl Hessman,DEM,550253,0,0,110,110,10
Oklahoma,President,Donald Trump,REP,550254,0,0,1025,1025,
Oklahoma,President,Gary Johnson,LIB,550254,0,0,70,70,
Oklahoma,President,Hillary Clinton,DEM,550254,0,0,277,277,
Oklahoma,U.S. Senate,James Lankford,REP,550254,0,0,1089,1089,
Oklahoma,U.S. Senate,Robert Murphy,LIB,550254,0,0,51,51,
Oklahoma,U.S. Senate,Mike Workman,DEM,550254,0,0,196,196,
Oklahoma,U.S. Senate,Mark Beard,IND,550254,0,0,13,13,
Oklahoma,U.S. Senate,Sean Braddy,IND,550254,0,0,29,29,
Oklahoma,U.S. House,Steve Russell,REP,550254,0,0,1042,1042,05
Oklahoma,U.S. House,Zachary Knight,LIB,550254,0,0,86,86,05
Oklahoma,U.S. House,Al Mcaffrey,DEM,550254,0,0,245,245,05
Oklahoma,State House,Tess Teague,REP,550254,0,0,1024,1024,10
Oklahoma,State House,Cheryl Hessman,DEM,550254,0,0,340,340,10
Oklahoma,President,Donald Trump,REP,550255,0,0,0,0,
Oklahoma,President,Gary Johnson,LIB,550255,0,0,0,0,
Oklahoma,President,Hillary Clinton,DEM,550255,0,0,0,0,
Oklahoma,U.S. Senate,James Lankford,REP,550255,0,0,0,0,
Oklahoma,U.S. Senate,Robert Murphy,LIB,550255,0,0,0,0,
Oklahoma,U.S. Senate,Mike Workman,DEM,550255,0,0,0,0,
Oklahoma,U.S. Senate,Mark Beard,IND,550255,0,0,0,0,
Oklahoma,U.S. Senate,Sean Braddy,IND,550255,0,0,0,0,
Oklahoma,U.S. House,Tom Cole,REP,550255,0,0,0,0,04
Oklahoma,U.S. House,Sevier White,LIB,550255,0,0,0,0,04
Oklahoma,U.S. House,Christina Owen,DEM,550255,0,0,0,0,04
Oklahoma,State House,Roger Ford,REP,550255,0,0,0,0,95
Oklahoma,State House,James Cook,DEM,550255,0,0,0,0,95
Oklahoma,President,Donald Trump,REP,550256,0,0,0,0,
Oklahoma,President,Gary Johnson,LIB,550256,0,0,0,0,
Oklahoma,President,Hillary Clinton,DEM,550256,0,0,0,0,
Oklahoma,U.S. Senate,James Lankford,REP,550256,0,0,0,0,
Oklahoma,U.S. Senate,Robert Murphy,LIB,550256,0,0,0,0,
Oklahoma,U.S. Senate,Mike Workman,DEM,550256,0,0,0,0,
Oklahoma,U.S. Senate,Mark Beard,IND,550256,0,0,0,0,
Oklahoma,U.S. Senate,Sean Braddy,IND,550256,0,0,0,0,
Oklahoma,U.S. House,Steve Russell,REP,550256,0,0,0,0,05
Oklahoma,U.S. House,Zachary Knight,LIB,550256,0,0,0,0,05
Oklahoma,U.S. House,Al Mcaffrey,DEM,550256,0,0,0,0,05
Oklahoma,State House,Jason Murphey,REP,550256,0,0,0,0,31
Oklahoma,State House,John Tiller,DEM,550256,0,0,0,0,31
Oklahoma,President,Donald Trump,REP,550257,0,0,31,31,
Oklahoma,President,Gary Johnson,LIB,550257,0,0,3,3,
Oklahoma,President,Hillary Clinton,DEM,550257,0,0,71,71,
Oklahoma,U.S. Senate,James Lankford,REP,550257,0,0,34,34,
Oklahoma,U.S. Senate,Robert Murphy,LIB,550257,0,0,7,7,
Oklahoma,U.S. Senate,Mike Workman,DEM,550257,0,0,56,56,
Oklahoma,U.S. Senate,Mark Beard,IND,550257,0,0,5,5,
Oklahoma,U.S. Senate,Sean Braddy,IND,550257,0,0,4,4,
Oklahoma,U.S. House,Steve Russell,REP,550257,0,0,32,32,05
Oklahoma,U.S. House,Zachary Knight,LIB,550257,0,0,12,12,05
Oklahoma,U.S. House,Al Mcaffrey,DEM,550257,0,0,62,62,05
Oklahoma,State House,George Young,DEM,550257,0,0,74,74,99
Oklahoma,State House,Marina Mangiaracina,IND,550257,0,0,28,28,99
Oklahoma,President,Donald Trump,REP,559999,17388,8752,3,26143,
Oklahoma,President,Gary Johnson,LIB,559999,2001,884,0,2885,
Oklahoma,President,Hillary Clinton,DEM,559999,11979,10833,0,22812,
Oklahoma,U.S. Senate,James Lankford,REP,559999,20469,9955,3,30427,
Oklahoma,U.S. Senate,Robert Murphy,LIB,559999,861,505,0,1366,
Oklahoma,U.S. Senate,Mike Workman,DEM,559999,9163,9110,0,18273,
Oklahoma,U.S. Senate,Mark Beard,IND,559999,326,247,0,573,
Oklahoma,U.S. Senate,Sean Braddy,IND,559999,779,612,0,1391,
Oklahoma,U.S. House,Tom Cole,REP,559999,1599,453,0,2052,04
Oklahoma,U.S. House,Sevier White,LIB,559999,98,33,0,131,04
Oklahoma,U.S. House,Christina Owen,DEM,559999,725,593,0,1318,04
Oklahoma,U.S. House,Steve Russell,REP,559999,17953,8999,3,26955,05
Oklahoma,U.S. House,Zachary Knight,LIB,559999,1125,710,0,1835,05
Oklahoma,U.S. House,Al Mcaffrey,DEM,559999,9918,9551,0,19469,05
Oklahoma,State Senate,Rob Standridge,REP,559999,151,73,0,224,15
Oklahoma,State Senate,Shawn Sheehan,IND,559999,73,97,0,170,15
Oklahoma,State Senate,Adam Pugh,REP,559999,4396,3073,0,7469,41
Oklahoma,State Senate,Richard Prawdzienski,LIB,559999,185,133,0,318,41
Oklahoma,State Senate,Kevin Mcdonald,DEM,559999,2013,1742,0,3755,41
Oklahoma,State Senate,Greg Treat,REP,559999,3972,1686,0,5658,47
Oklahoma,State Senate,Judy Mullen Hopper,DEM,559999,2320,1529,0,3849,47
Oklahoma,State Senate,Steven Weber,IND,559999,242,157,0,399,47
Oklahoma,State House,Jason Murphey,REP,559999,364,216,0,580,31
Oklahoma,State House,John Tiller,DEM,559999,108,52,0,160,31
Oklahoma,State House,Ryan Martinez,REP,559999,2293,1622,0,3915,39
Oklahoma,State House,Clark Duffe,LIB,559999,514,504,0,1018,39
Oklahoma,State House,Kevin West,REP,559999,65,15,0,80,54
Oklahoma,State House,Mary Newcome-Hatch,DEM,559999,21,13,0,34,54
Oklahoma,State House,Elizabeth Larios,IND,559999,8,3,0,11,54
Oklahoma,State House,Mike Osburn,REP,559999,1452,1225,0,2677,81
Oklahoma,State House,Steve Long,LIB,559999,115,84,0,199,81
Oklahoma,State House,Dan Myers,DEM,559999,680,660,0,1340,81
Oklahoma,State House,Kevin Calvey,REP,559999,2027,1088,0,3115,82
Oklahoma,State House,Misty Warfield,DEM,559999,1097,855,0,1952,82
Oklahoma,State House,Christopher Crawford,IND,559999,85,87,0,172,82
Oklahoma,State House,David Dickerson,IND,559999,64,27,0,91,82
Oklahoma,State House,Tammy West,REP,559999,673,191,0,864,84
Oklahoma,State House,Will Hollander,DEM,559999,437,214,0,651,84
Oklahoma,State House,Matt Jackson,REP,559999,1495,506,0,2001,85
Oklahoma,State House,Cyndi Munson,DEM,559999,1762,831,0,2593,85
Oklahoma,State House,Bruce Lee Smith,REP,559999,615,269,0,884,87
Oklahoma,State House,Elle Collins,LIB,559999,61,30,0,91,87
Oklahoma,State House,Collin Walke,DEM,559999,571,451,0,1022,87
Oklahoma,State House,Joe Griffin,REP,559999,143,80,0,223,92
Oklahoma,State House,Forrest Bennett,DEM,559999,177,181,0,358,92
Oklahoma,State House,Jay Means,REP,559999,304,77,0,381,93
Oklahoma,State House,Mickey Dollens,DEM,559999,330,156,0,486,93
Oklahoma,State House,Jason Sansone,REP,559999,350,152,0,502,94
Oklahoma,State House,Scott Inman,DEM,559999,621,484,0,1105,94
Oklahoma,State House,Roger Ford,REP,559999,681,220,0,901,95
Oklahoma,State House,James Cook,DEM,559999,478,355,0,833,95
Oklahoma,State House,Tonni Canaday,REP,559999,428,225,0,653,97
Oklahoma,State House,Jason Lowe,DEM,559999,734,1689,0,2423,97
Oklahoma,State House,George Young,DEM,559999,574,1272,0,1846,99
Oklahoma,State House,Marina Mangiaracina,IND,559999,144,161,1,306,99
Oklahoma,State House,Elise Hall,REP,559999,1232,439,0,1671,10
Oklahoma,State House,Christina Wright,LIB,559999,79,53,0,132,10
Oklahoma,State House,Donald Wentroth Jr.,DEM,559999,821,504,0,1325,10
Oklahoma,State House,Tess Teague,REP,559999,1036,303,0,1339,10
Oklahoma,State House,Cheryl Hessman,DEM,559999,643,357,0,1000,10
Okmulgee,President,Donald Trump,REP,560001,1,14,50,65,
Okmulgee,President,Gary Johnson,LIB,560001,0,2,9,11,
Okmulgee,President,Hillary Clinton,DEM,560001,3,24,130,157,
Okmulgee,U.S. Senate,James Lankford,REP,560001,1,14,57,72,
Okmulgee,U.S. Senate,Robert Murphy,LIB,560001,0,2,2,4,
Okmulgee,U.S. Senate,Mike Workman,DEM,560001,2,23,121,146,
Okmulgee,U.S. Senate,Mark Beard,IND,560001,0,0,5,5,
Okmulgee,U.S. Senate,Sean Braddy,IND,560001,1,1,3,5,
Okmulgee,U.S. House,Markwayne Mullin,REP,560001,1,13,56,70,02
Okmulgee,U.S. House,Joshua Harris-Till,DEM,560001,3,25,123,151,02
Okmulgee,U.S. House,John Mccarthy,IND,560001,0,2,8,10,02
Okmulgee,State House,Scott Fetgatter,REP,560001,1,13,53,67,16
Okmulgee,State House,Ronnie Kell,DEM,560001,3,27,136,166,16
Okmulgee,President,Donald Trump,REP,560002,1,16,27,44,
Okmulgee,President,Gary Johnson,LIB,560002,0,3,9,12,
Okmulgee,President,Hillary Clinton,DEM,560002,8,71,356,435,
Okmulgee,U.S. Senate,James Lankford,REP,560002,0,12,50,62,
Okmulgee,U.S. Senate,Robert Murphy,LIB,560002,0,1,4,5,
Okmulgee,U.S. Senate,Mike Workman,DEM,560002,8,66,314,388,
Okmulgee,U.S. Senate,Mark Beard,IND,560002,0,5,7,12,
Okmulgee,U.S. Senate,Sean Braddy,IND,560002,1,5,17,23,
Okmulgee,U.S. House,Markwayne Mullin,REP,560002,0,11,38,49,02
Okmulgee,U.S. House,Joshua Harris-Till,DEM,560002,9,75,343,427,02
Okmulgee,U.S. House,John Mccarthy,IND,560002,0,4,9,13,02
Okmulgee,State House,Scott Fetgatter,REP,560002,0,19,44,63,16
Okmulgee,State House,Ronnie Kell,DEM,560002,9,70,344,423,16
Okmulgee,President,Donald Trump,REP,560004,0,7,55,62,
Okmulgee,President,Gary Johnson,LIB,560004,0,0,3,3,
Okmulgee,President,Hillary Clinton,DEM,560004,3,8,39,50,
Okmulgee,U.S. Senate,James Lankford,REP,560004,1,7,58,66,
Okmulgee,U.S. Senate,Robert Murphy,LIB,560004,0,0,0,0,
Okmulgee,U.S. Senate,Mike Workman,DEM,560004,3,7,35,45,
Okmulgee,U.S. Senate,Mark Beard,IND,560004,0,0,1,1,
Okmulgee,U.S. Senate,Sean Braddy,IND,560004,0,1,1,2,
Okmulgee,U.S. House,Markwayne Mullin,REP,560004,2,8,53,63,02
Okmulgee,U.S. House,Joshua Harris-Till,DEM,560004,2,7,36,45,02
Okmulgee,U.S. House,John Mccarthy,IND,560004,0,0,6,6,02
Okmulgee,State House,Scott Fetgatter,REP,560004,1,7,46,54,16
Okmulgee,State House,Ronnie Kell,DEM,560004,3,8,47,58,16
Okmulgee,President,Donald Trump,REP,560005,8,29,224,261,
Okmulgee,President,Gary Johnson,LIB,560005,0,2,19,21,
Okmulgee,President,Hillary Clinton,DEM,560005,3,16,147,166,
Okmulgee,U.S. Senate,James Lankford,REP,560005,8,31,226,265,
Okmulgee,U.S. Senate,Robert Murphy,LIB,560005,0,1,6,7,
Okmulgee,U.S. Senate,Mike Workman,DEM,560005,3,11,129,143,
Okmulgee,U.S. Senate,Mark Beard,IND,560005,0,2,13,15,
Okmulgee,U.S. Senate,Sean Braddy,IND,560005,0,2,9,11,
Okmulgee,U.S. House,Markwayne Mullin,REP,560005,8,29,232,269,02
Okmulgee,U.S. House,Joshua Harris-Till,DEM,560005,2,15,134,151,02
Okmulgee,U.S. House,John Mccarthy,IND,560005,0,3,20,23,02
Okmulgee,State House,Scott Fetgatter,REP,560005,9,31,206,246,16
Okmulgee,State House,Ronnie Kell,DEM,560005,2,16,180,198,16
Okmulgee,President,Donald Trump,REP,560006,8,25,101,134,
Okmulgee,President,Gary Johnson,LIB,560006,0,1,13,14,
Okmulgee,President,Hillary Clinton,DEM,560006,0,14,61,75,
Okmulgee,U.S. Senate,James Lankford,REP,560006,7,24,103,134,
Okmulgee,U.S. Senate,Robert Murphy,LIB,560006,0,0,4,4,
Okmulgee,U.S. Senate,Mike Workman,DEM,560006,0,14,54,68,
Okmulgee,U.S. Senate,Mark Beard,IND,560006,0,0,11,11,
Okmulgee,U.S. Senate,Sean Braddy,IND,560006,1,2,3,6,
Okmulgee,U.S. House,Markwayne Mullin,REP,560006,7,24,106,137,02
Okmulgee,U.S. House,Joshua Harris-Till,DEM,560006,0,15,53,68,02
Okmulgee,U.S. House,John Mccarthy,IND,560006,1,1,16,18,02
Okmulgee,State House,Scott Fetgatter,REP,560006,7,19,96,122,16
Okmulgee,State House,Ronnie Kell,DEM,560006,1,20,79,100,16
Okmulgee,President,Donald Trump,REP,560007,16,62,210,288,
Okmulgee,President,Gary Johnson,LIB,560007,3,0,17,20,
Okmulgee,President,Hillary Clinton,DEM,560007,7,28,147,182,
Okmulgee,U.S. Senate,James Lankford,REP,560007,17,62,216,295,
Okmulgee,U.S. Senate,Robert Murphy,LIB,560007,0,1,10,11,
Okmulgee,U.S. Senate,Mike Workman,DEM,560007,8,21,127,156,
Okmulgee,U.S. Senate,Mark Beard,IND,560007,0,2,7,9,
Okmulgee,U.S. Senate,Sean Braddy,IND,560007,1,4,12,17,
Okmulgee,U.S. House,Markwayne Mullin,REP,560007,17,61,225,303,02
Okmulgee,U.S. House,Joshua Harris-Till,DEM,560007,8,23,123,154,02
Okmulgee,U.S. House,John Mccarthy,IND,560007,1,6,23,30,02
Okmulgee,State House,Scott Fetgatter,REP,560007,16,54,200,270,16
Okmulgee,State House,Ronnie Kell,DEM,560007,9,35,170,214,16
Okmulgee,President,Donald Trump,REP,560008,1,20,143,164,
Okmulgee,President,Gary Johnson,LIB,560008,0,1,14,15,
Okmulgee,President,Hillary Clinton,DEM,560008,6,8,85,99,
Okmulgee,U.S. Senate,James Lankford,REP,560008,1,17,136,154,
Okmulgee,U.S. Senate,Robert Murphy,LIB,560008,0,0,7,7,
Okmulgee,U.S. Senate,Mike Workman,DEM,560008,6,10,86,102,
Okmulgee,U.S. Senate,Mark Beard,IND,560008,0,2,9,11,
Okmulgee,U.S. Senate,Sean Braddy,IND,560008,0,0,5,5,
Okmulgee,U.S. House,Markwayne Mullin,REP,560008,4,14,142,160,02
Okmulgee,U.S. House,Joshua Harris-Till,DEM,560008,3,10,86,99,02
Okmulgee,U.S. House,John Mccarthy,IND,560008,0,5,16,21,02
Okmulgee,State House,Scott Fetgatter,REP,560008,2,19,131,152,16
Okmulgee,State House,Ronnie Kell,DEM,560008,5,10,111,126,16
Okmulgee,President,Donald Trump,REP,560009,7,29,109,145,
Okmulgee,President,Gary Johnson,LIB,560009,0,3,15,18,
Okmulgee,President,Hillary Clinton,DEM,560009,4,29,101,134,
Okmulgee,U.S. Senate,James Lankford,REP,560009,6,34,117,157,
Okmulgee,U.S. Senate,Robert Murphy,LIB,560009,0,1,9,10,
Okmulgee,U.S. Senate,Mike Workman,DEM,560009,4,22,87,113,
Okmulgee,U.S. Senate,Mark Beard,IND,560009,0,0,2,2,
Okmulgee,U.S. Senate,Sean Braddy,IND,560009,0,1,10,11,
Okmulgee,U.S. House,Markwayne Mullin,REP,560009,6,32,112,150,02
Okmulgee,U.S. House,Joshua Harris-Till,DEM,560009,4,25,94,123,02
Okmulgee,U.S. House,John Mccarthy,IND,560009,0,1,20,21,02
Okmulgee,State House,Scott Fetgatter,REP,560009,6,29,112,147,16
Okmulgee,State House,Ronnie Kell,DEM,560009,4,30,110,144,16
Okmulgee,President,Donald Trump,REP,560010,6,16,146,168,
Okmulgee,President,Gary Johnson,LIB,560010,1,0,7,8,
Okmulgee,President,Hillary Clinton,DEM,560010,2,9,44,55,
Okmulgee,U.S. Senate,James Lankford,REP,560010,6,16,142,164,
Okmulgee,U.S. Senate,Robert Murphy,LIB,560010,0,0,2,2,
Okmulgee,U.S. Senate,Mike Workman,DEM,560010,3,8,43,54,
Okmulgee,U.S. Senate,Mark Beard,IND,560010,0,0,4,4,
Okmulgee,U.S. Senate,Sean Braddy,IND,560010,0,0,2,2,
Okmulgee,U.S. House,Markwayne Mullin,REP,560010,7,15,143,165,02
Okmulgee,U.S. House,Joshua Harris-Till,DEM,560010,1,9,41,51,02
Okmulgee,U.S. House,John Mccarthy,IND,560010,1,0,7,8,02
Okmulgee,President,Donald Trump,REP,560011,9,34,198,241,
Okmulgee,President,Gary Johnson,LIB,560011,0,3,21,24,
Okmulgee,President,Hillary Clinton,DEM,560011,11,26,118,155,
Okmulgee,U.S. Senate,James Lankford,REP,560011,10,43,212,265,
Okmulgee,U.S. Senate,Robert Murphy,LIB,560011,0,0,7,7,
Okmulgee,U.S. Senate,Mike Workman,DEM,560011,9,17,104,130,
Okmulgee,U.S. Senate,Mark Beard,IND,560011,1,1,8,10,
Okmulgee,U.S. Senate,Sean Braddy,IND,560011,0,3,6,9,
Okmulgee,U.S. House,Markwayne Mullin,REP,560011,8,41,199,248,02
Okmulgee,U.S. House,Joshua Harris-Till,DEM,560011,10,23,108,141,02
Okmulgee,U.S. House,John Mccarthy,IND,560011,2,0,27,29,02
Okmulgee,State House,Scott Fetgatter,REP,560011,9,34,187,230,16
Okmulgee,State House,Ronnie Kell,DEM,560011,11,32,150,193,16
Okmulgee,President,Donald Trump,REP,560012,25,94,400,519,
Okmulgee,President,Gary Johnson,LIB,560012,3,7,23,33,
Okmulgee,President,Hillary Clinton,DEM,560012,15,69,187,271,
Okmulgee,U.S. Senate,James Lankford,REP,560012,30,102,416,548,
Okmulgee,U.S. Senate,Robert Murphy,LIB,560012,1,2,12,15,
Okmulgee,U.S. Senate,Mike Workman,DEM,560012,12,61,165,238,
Okmulgee,U.S. Senate,Mark Beard,IND,560012,0,2,10,12,
Okmulgee,U.S. Senate,Sean Braddy,IND,560012,1,4,7,12,
Okmulgee,U.S. House,Markwayne Mullin,REP,560012,33,103,413,549,02
Okmulgee,U.S. House,Joshua Harris-Till,DEM,560012,11,62,170,243,02
Okmulgee,U.S. House,John Mccarthy,IND,560012,0,6,28,34,02
Okmulgee,State House,Scott Fetgatter,REP,560012,21,94,333,448,16
Okmulgee,State House,Ronnie Kell,DEM,560012,23,75,275,373,16
Okmulgee,President,Donald Trump,REP,560013,2,10,240,252,
Okmulgee,President,Gary Johnson,LIB,560013,1,1,16,18,
Okmulgee,President,Hillary Clinton,DEM,560013,1,3,93,97,
Okmulgee,U.S. Senate,James Lankford,REP,560013,2,10,201,213,
Okmulgee,U.S. Senate,Robert Murphy,LIB,560013,0,0,7,7,
Okmulgee,U.S. Senate,Mike Workman,DEM,560013,1,4,125,130,
Okmulgee,U.S. Senate,Mark Beard,IND,560013,0,0,6,6,
Okmulgee,U.S. Senate,Sean Braddy,IND,560013,1,0,9,10,
Okmulgee,U.S. House,Markwayne Mullin,REP,560013,2,10,213,225,02
Okmulgee,U.S. House,Joshua Harris-Till,DEM,560013,1,4,112,117,02
Okmulgee,U.S. House,John Mccarthy,IND,560013,1,0,19,20,02
Okmulgee,State House,Scott Fetgatter,REP,560013,3,9,160,172,16
Okmulgee,State House,Ronnie Kell,DEM,560013,1,5,183,189,16
Okmulgee,President,Donald Trump,REP,560014,8,12,136,156,
Okmulgee,President,Gary Johnson,LIB,560014,4,1,21,26,
Okmulgee,President,Hillary Clinton,DEM,560014,4,7,88,99,
Okmulgee,U.S. Senate,James Lankford,REP,560014,7,9,129,145,
Okmulgee,U.S. Senate,Robert Murphy,LIB,560014,3,0,6,9,
Okmulgee,U.S. Senate,Mike Workman,DEM,560014,4,8,90,102,
Okmulgee,U.S. Senate,Mark Beard,IND,560014,0,2,8,10,
Okmulgee,U.S. Senate,Sean Braddy,IND,560014,2,1,11,14,
Okmulgee,U.S. House,Markwayne Mullin,REP,560014,8,11,141,160,02
Okmulgee,U.S. House,Joshua Harris-Till,DEM,560014,5,7,85,97,02
Okmulgee,U.S. House,John Mccarthy,IND,560014,2,2,20,24,02
Okmulgee,State House,Scott Fetgatter,REP,560014,8,7,115,130,16
Okmulgee,State House,Ronnie Kell,DEM,560014,6,13,130,149,16
Okmulgee,President,Donald Trump,REP,560015,29,28,422,479,
Okmulgee,President,Gary Johnson,LIB,560015,1,0,39,40,
Okmulgee,President,Hillary Clinton,DEM,560015,8,18,197,223,
Okmulgee,U.S. Senate,James Lankford,REP,560015,27,29,430,486,
Okmulgee,U.S. Senate,Robert Murphy,LIB,560015,0,1,12,13,
Okmulgee,U.S. Senate,Mike Workman,DEM,560015,8,12,189,209,
Okmulgee,U.S. Senate,Mark Beard,IND,560015,1,1,12,14,
Okmulgee,U.S. Senate,Sean Braddy,IND,560015,2,2,9,13,
Okmulgee,U.S. House,Markwayne Mullin,REP,560015,30,33,436,499,02
Okmulgee,U.S. House,Joshua Harris-Till,DEM,560015,8,14,182,204,02
Okmulgee,U.S. House,John Mccarthy,IND,560015,0,1,34,35,02
Okmulgee,State House,Scott Fetgatter,REP,560015,26,25,367,418,16
Okmulgee,State House,Ronnie Kell,DEM,560015,11,23,284,318,16
Okmulgee,President,Donald Trump,REP,560016,14,15,315,344,
Okmulgee,President,Gary Johnson,LIB,560016,1,0,34,35,
Okmulgee,President,Hillary Clinton,DEM,560016,11,13,130,154,
Okmulgee,U.S. Senate,James Lankford,REP,560016,12,14,314,340,
Okmulgee,U.S. Senate,Robert Murphy,LIB,560016,3,0,11,14,
Okmulgee,U.S. Senate,Mike Workman,DEM,560016,8,13,130,151,
Okmulgee,U.S. Senate,Mark Beard,IND,560016,1,0,10,11,
Okmulgee,U.S. Senate,Sean Braddy,IND,560016,1,1,11,13,
Okmulgee,U.S. House,Markwayne Mullin,REP,560016,12,14,317,343,02
Okmulgee,U.S. House,Joshua Harris-Till,DEM,560016,8,11,126,145,02
Okmulgee,U.S. House,John Mccarthy,IND,560016,3,3,29,35,02
Okmulgee,President,Donald Trump,REP,560018,10,19,231,260,
Okmulgee,President,Gary Johnson,LIB,560018,0,1,12,13,
Okmulgee,President,Hillary Clinton,DEM,560018,12,6,124,142,
Okmulgee,U.S. Senate,James Lankford,REP,560018,10,16,218,244,
Okmulgee,U.S. Senate,Robert Murphy,LIB,560018,0,0,6,6,
Okmulgee,U.S. Senate,Mike Workman,DEM,560018,10,7,121,138,
Okmulgee,U.S. Senate,Mark Beard,IND,560018,0,3,10,13,
Okmulgee,U.S. Senate,Sean Braddy,IND,560018,2,0,5,7,
Okmulgee,U.S. House,Markwayne Mullin,REP,560018,10,18,223,251,02
Okmulgee,U.S. House,Joshua Harris-Till,DEM,560018,10,6,120,136,02
Okmulgee,U.S. House,John Mccarthy,IND,560018,2,1,15,18,02
Okmulgee,State House,Scott Fetgatter,REP,560018,11,15,176,202,16
Okmulgee,State House,Ronnie Kell,DEM,560018,11,10,183,204,16
Okmulgee,President,Donald Trump,REP,560019,10,8,244,262,
Okmulgee,President,Gary Johnson,LIB,560019,0,2,14,16,
Okmulgee,President,Hillary Clinton,DEM,560019,4,2,91,97,
Okmulgee,U.S. Senate,James Lankford,REP,560019,10,7,249,266,
Okmulgee,U.S. Senate,Robert Murphy,LIB,560019,0,1,1,2,
Okmulgee,U.S. Senate,Mike Workman,DEM,560019,3,4,84,91,
Okmulgee,U.S. Senate,Mark Beard,IND,560019,0,0,7,7,
Okmulgee,U.S. Senate,Sean Braddy,IND,560019,0,0,9,9,
Okmulgee,U.S. House,Markwayne Mullin,REP,560019,10,8,255,273,02
Okmulgee,U.S. House,Joshua Harris-Till,DEM,560019,3,2,74,79,02
Okmulgee,U.S. House,John Mccarthy,IND,560019,1,2,19,22,02
Okmulgee,President,Donald Trump,REP,560020,32,73,876,981,
Okmulgee,President,Gary Johnson,LIB,560020,2,0,44,46,
Okmulgee,President,Hillary Clinton,DEM,560020,8,24,329,361,
Okmulgee,U.S. Senate,James Lankford,REP,560020,35,70,868,973,
Okmulgee,U.S. Senate,Robert Murphy,LIB,560020,1,3,18,22,
Okmulgee,U.S. Senate,Mike Workman,DEM,560020,7,24,309,340,
Okmulgee,U.S. Senate,Mark Beard,IND,560020,1,2,26,29,
Okmulgee,U.S. Senate,Sean Braddy,IND,560020,1,1,23,25,
Okmulgee,U.S. House,Markwayne Mullin,REP,560020,35,71,856,962,02
Okmulgee,U.S. House,Joshua Harris-Till,DEM,560020,7,23,330,360,02
Okmulgee,U.S. House,John Mccarthy,IND,560020,3,5,48,56,02
Okmulgee,President,Donald Trump,REP,560021,3,22,150,175,
Okmulgee,President,Gary Johnson,LIB,560021,0,1,9,10,
Okmulgee,President,Hillary Clinton,DEM,560021,1,10,109,120,
Okmulgee,U.S. Senate,James Lankford,REP,560021,3,23,140,166,
Okmulgee,U.S. Senate,Robert Murphy,LIB,560021,0,0,7,7,
Okmulgee,U.S. Senate,Mike Workman,DEM,560021,1,9,112,122,
Okmulgee,U.S. Senate,Mark Beard,IND,560021,0,0,3,3,
Okmulgee,U.S. Senate,Sean Braddy,IND,560021,0,0,5,5,
Okmulgee,U.S. House,Markwayne Mullin,REP,560021,3,22,140,165,02
Okmulgee,U.S. House,Joshua Harris-Till,DEM,560021,1,10,113,124,02
Okmulgee,U.S. House,John Mccarthy,IND,560021,0,0,12,12,02
Okmulgee,State House,Scott Fetgatter,REP,560021,3,7,81,91,16
Okmulgee,State House,Ronnie Kell,DEM,560021,1,25,184,210,16
Okmulgee,President,Donald Trump,REP,560026,16,50,500,566,
Okmulgee,President,Gary Johnson,LIB,560026,0,4,43,47,
Okmulgee,President,Hillary Clinton,DEM,560026,6,9,178,193,
Okmulgee,U.S. Senate,James Lankford,REP,560026,16,51,508,575,
Okmulgee,U.S. Senate,Robert Murphy,LIB,560026,0,1,18,19,
Okmulgee,U.S. Senate,Mike Workman,DEM,560026,3,10,171,184,
Okmulgee,U.S. Senate,Mark Beard,IND,560026,0,0,10,10,
Okmulgee,U.S. Senate,Sean Braddy,IND,560026,3,1,12,16,
Okmulgee,U.S. House,Markwayne Mullin,REP,560026,15,49,525,589,02
Okmulgee,U.S. House,Joshua Harris-Till,DEM,560026,4,12,155,171,02
Okmulgee,U.S. House,John Mccarthy,IND,560026,3,2,42,47,02
Okmulgee,State House,Scott Fetgatter,REP,560026,10,30,300,340,16
Okmulgee,State House,Ronnie Kell,DEM,560026,12,33,418,463,16
Okmulgee,President,Donald Trump,REP,560027,16,26,358,400,
Okmulgee,President,Gary Johnson,LIB,560027,3,2,17,22,
Okmulgee,President,Hillary Clinton,DEM,560027,10,12,103,125,
Okmulgee,U.S. Senate,James Lankford,REP,560027,17,22,363,402,
Okmulgee,U.S. Senate,Robert Murphy,LIB,560027,4,0,6,10,
Okmulgee,U.S. Senate,Mike Workman,DEM,560027,8,13,85,106,
Okmulgee,U.S. Senate,Mark Beard,IND,560027,0,2,11,13,
Okmulgee,U.S. Senate,Sean Braddy,IND,560027,0,3,10,13,
Okmulgee,U.S. House,Markwayne Mullin,REP,560027,17,26,360,403,02
Okmulgee,U.S. House,Joshua Harris-Till,DEM,560027,7,13,94,114,02
Okmulgee,U.S. House,John Mccarthy,IND,560027,5,1,24,30,02
Okmulgee,State House,Scott Fetgatter,REP,560027,17,21,276,314,16
Okmulgee,State House,Ronnie Kell,DEM,560027,12,20,198,230,16
Okmulgee,President,Donald Trump,REP,560029,45,87,922,1054,
Okmulgee,President,Gary Johnson,LIB,560029,4,3,48,55,
Okmulgee,President,Hillary Clinton,DEM,560029,19,22,235,276,
Okmulgee,U.S. Senate,James Lankford,REP,560029,44,87,921,1052,
Okmulgee,U.S. Senate,Robert Murphy,LIB,560029,3,1,34,38,
Okmulgee,U.S. Senate,Mike Workman,DEM,560029,18,19,194,231,
Okmulgee,U.S. Senate,Mark Beard,IND,560029,1,0,26,27,
Okmulgee,U.S. Senate,Sean Braddy,IND,560029,1,5,28,34,
Okmulgee,U.S. House,Markwayne Mullin,REP,560029,44,86,929,1059,02
Okmulgee,U.S. House,Joshua Harris-Till,DEM,560029,19,26,193,238,02
Okmulgee,U.S. House,John Mccarthy,IND,560029,3,0,70,73,02
Okmulgee,President,Donald Trump,REP,560031,5,21,165,191,
Okmulgee,President,Gary Johnson,LIB,560031,0,0,11,11,
Okmulgee,President,Hillary Clinton,DEM,560031,1,5,31,37,
Okmulgee,U.S. Senate,James Lankford,REP,560031,5,19,157,181,
Okmulgee,U.S. Senate,Robert Murphy,LIB,560031,0,1,5,6,
Okmulgee,U.S. Senate,Mike Workman,DEM,560031,0,4,34,38,
Okmulgee,U.S. Senate,Mark Beard,IND,560031,0,0,7,7,
Okmulgee,U.S. Senate,Sean Braddy,IND,560031,0,1,2,3,
Okmulgee,U.S. House,Markwayne Mullin,REP,560031,4,18,165,187,02
Okmulgee,U.S. House,Joshua Harris-Till,DEM,560031,0,6,29,35,02
Okmulgee,U.S. House,John Mccarthy,IND,560031,0,1,10,11,02
Okmulgee,President,Donald Trump,REP,560032,10,27,195,232,
Okmulgee,President,Gary Johnson,LIB,560032,0,2,22,24,
Okmulgee,President,Hillary Clinton,DEM,560032,5,18,126,149,
Okmulgee,U.S. Senate,James Lankford,REP,560032,9,30,197,236,
Okmulgee,U.S. Senate,Robert Murphy,LIB,560032,0,3,10,13,
Okmulgee,U.S. Senate,Mike Workman,DEM,560032,5,12,115,132,
Okmulgee,U.S. Senate,Mark Beard,IND,560032,1,2,11,14,
Okmulgee,U.S. Senate,Sean Braddy,IND,560032,0,0,13,13,
Okmulgee,U.S. House,Markwayne Mullin,REP,560032,9,29,201,239,02
Okmulgee,U.S. House,Joshua Harris-Till,DEM,560032,5,13,118,136,02
Okmulgee,U.S. House,John Mccarthy,IND,560032,1,5,25,31,02
Okmulgee,President,Donald Trump,REP,560033,10,24,206,240,
Okmulgee,President,Gary Johnson,LIB,560033,1,2,19,22,
Okmulgee,President,Hillary Clinton,DEM,560033,4,21,98,123,
Okmulgee,U.S. Senate,James Lankford,REP,560033,11,26,206,243,
Okmulgee,U.S. Senate,Robert Murphy,LIB,560033,1,1,6,8,
Okmulgee,U.S. Senate,Mike Workman,DEM,560033,3,14,93,110,
Okmulgee,U.S. Senate,Mark Beard,IND,560033,0,0,10,10,
Okmulgee,U.S. Senate,Sean Braddy,IND,560033,0,6,7,13,
Okmulgee,U.S. House,Markwayne Mullin,REP,560033,11,29,219,259,02
Okmulgee,U.S. House,Joshua Harris-Till,DEM,560033,3,16,85,104,02
Okmulgee,U.S. House,John Mccarthy,IND,560033,1,2,15,18,02
Okmulgee,President,Donald Trump,REP,560034,13,22,242,277,
Okmulgee,President,Gary Johnson,LIB,560034,2,1,9,12,
Okmulgee,President,Hillary Clinton,DEM,560034,0,4,48,52,
Okmulgee,U.S. Senate,James Lankford,REP,560034,15,23,233,271,
Okmulgee,U.S. Senate,Robert Murphy,LIB,560034,0,0,5,5,
Okmulgee,U.S. Senate,Mike Workman,DEM,560034,0,3,51,54,
Okmulgee,U.S. Senate,Mark Beard,IND,560034,0,0,5,5,
Okmulgee,U.S. Senate,Sean Braddy,IND,560034,0,0,4,4,
Okmulgee,U.S. House,Markwayne Mullin,REP,560034,15,22,243,280,02
Okmulgee,U.S. House,Joshua Harris-Till,DEM,560034,0,3,45,48,02
Okmulgee,U.S. House,John Mccarthy,IND,560034,0,1,10,11,02
Okmulgee,State House,Scott Fetgatter,REP,560034,10,14,119,143,16
Okmulgee,State House,Ronnie Kell,DEM,560034,5,12,179,196,16
Okmulgee,President,Donald Trump,REP,560035,1,12,224,237,
Okmulgee,President,Gary Johnson,LIB,560035,0,0,10,10,
Okmulgee,President,Hillary Clinton,DEM,560035,2,1,90,93,
Okmulgee,U.S. Senate,James Lankford,REP,560035,0,9,203,212,
Okmulgee,U.S. Senate,Robert Murphy,LIB,560035,0,2,7,9,
Okmulgee,U.S. Senate,Mike Workman,DEM,560035,3,1,99,103,
Okmulgee,U.S. Senate,Mark Beard,IND,560035,0,1,8,9,
Okmulgee,U.S. Senate,Sean Braddy,IND,560035,0,0,8,8,
Okmulgee,U.S. House,Markwayne Mullin,REP,560035,1,10,223,234,02
Okmulgee,U.S. House,Joshua Harris-Till,DEM,560035,2,1,88,91,02
Okmulgee,U.S. House,John Mccarthy,IND,560035,0,1,18,19,02
Okmulgee,State House,Scott Fetgatter,REP,560035,0,7,165,172,16
Okmulgee,State House,Ronnie Kell,DEM,560035,3,5,164,172,16
Okmulgee,President,Donald Trump,REP,560036,22,61,435,518,
Okmulgee,President,Gary Johnson,LIB,560036,1,2,21,24,
Okmulgee,President,Hillary Clinton,DEM,560036,3,28,160,191,
Okmulgee,U.S. Senate,James Lankford,REP,560036,21,63,440,524,
Okmulgee,U.S. Senate,Robert Murphy,LIB,560036,2,1,11,14,
Okmulgee,U.S. Senate,Mike Workman,DEM,560036,3,26,138,167,
Okmulgee,U.S. Senate,Mark Beard,IND,560036,0,1,11,12,
Okmulgee,U.S. Senate,Sean Braddy,IND,560036,0,0,11,11,
Okmulgee,U.S. House,Markwayne Mullin,REP,560036,21,67,435,523,02
Okmulgee,U.S. House,Joshua Harris-Till,DEM,560036,4,22,145,171,02
Okmulgee,U.S. House,John Mccarthy,IND,560036,1,1,29,31,02
Okmulgee,State House,Scott Fetgatter,REP,560036,13,49,274,336,16
Okmulgee,State House,Ronnie Kell,DEM,560036,12,42,337,391,16
Okmulgee,President,Donald Trump,REP,560038,2,11,216,229,
Okmulgee,President,Gary Johnson,LIB,560038,0,0,10,10,
Okmulgee,President,Hillary Clinton,DEM,560038,2,5,67,74,
Okmulgee,U.S. Senate,James Lankford,REP,560038,2,12,211,225,
Okmulgee,U.S. Senate,Robert Murphy,LIB,560038,0,0,4,4,
Okmulgee,U.S. Senate,Mike Workman,DEM,560038,2,5,66,73,
Okmulgee,U.S. Senate,Mark Beard,IND,560038,0,1,5,6,
Okmulgee,U.S. Senate,Sean Braddy,IND,560038,0,0,3,3,
Okmulgee,U.S. House,Markwayne Mullin,REP,560038,3,10,213,226,02
Okmulgee,U.S. House,Joshua Harris-Till,DEM,560038,2,7,62,71,02
Okmulgee,U.S. House,John Mccarthy,IND,560038,0,1,12,13,02
Osage,President,Donald Trump,REP,570101,5,7,141,153,
Osage,President,Gary Johnson,LIB,570101,1,0,10,11,
Osage,President,Hillary Clinton,DEM,570101,4,2,22,28,
Osage,U.S. Senate,James Lankford,REP,570101,4,8,132,144,
Osage,U.S. Senate,Robert Murphy,LIB,570101,0,0,2,2,
Osage,U.S. Senate,Mike Workman,DEM,570101,5,0,25,30,
Osage,U.S. Senate,Mark Beard,IND,570101,1,0,6,7,
Osage,U.S. Senate,Sean Braddy,IND,570101,1,1,3,5,
Osage,U.S. House,Frank Lucas,REP,570101,4,8,132,144,03
Osage,U.S. House,Frankie Robbins,DEM,570101,6,1,32,39,03
Osage,State House,Travis Dunlap,REP,570101,2,9,126,137,10
Osage,State House,Eric Epperson,DEM,570101,5,0,40,45,10
Osage,President,Donald Trump,REP,570102,4,16,106,126,
Osage,President,Gary Johnson,LIB,570102,1,0,7,8,
Osage,President,Hillary Clinton,DEM,570102,5,4,22,31,
Osage,U.S. Senate,James Lankford,REP,570102,3,17,105,125,
Osage,U.S. Senate,Robert Murphy,LIB,570102,2,0,0,2,
Osage,U.S. Senate,Mike Workman,DEM,570102,4,3,27,34,
Osage,U.S. Senate,Mark Beard,IND,570102,0,0,2,2,
Osage,U.S. Senate,Sean Braddy,IND,570102,0,0,2,2,
Osage,U.S. House,Frank Lucas,REP,570102,4,14,103,121,03
Osage,U.S. House,Frankie Robbins,DEM,570102,6,5,33,44,03
Osage,State House,Sean Roberts,REP,570102,1,13,91,105,36
Osage,State House,Cathy Ross,DEM,570102,9,7,45,61,36
Osage,President,Donald Trump,REP,570103,6,5,209,220,
Osage,President,Gary Johnson,LIB,570103,1,0,11,12,
Osage,President,Hillary Clinton,DEM,570103,2,3,39,44,
Osage,U.S. Senate,James Lankford,REP,570103,5,6,198,209,
Osage,U.S. Senate,Robert Murphy,LIB,570103,0,0,9,9,
Osage,U.S. Senate,Mike Workman,DEM,570103,3,2,35,40,
Osage,U.S. Senate,Mark Beard,IND,570103,0,0,10,10,
Osage,U.S. Senate,Sean Braddy,IND,570103,0,0,5,5,
Osage,U.S. House,Frank Lucas,REP,570103,4,4,208,216,03
Osage,U.S. House,Frankie Robbins,DEM,570103,4,4,46,54,03
Osage,President,Donald Trump,REP,570105,26,12,575,613,
Osage,President,Gary Johnson,LIB,570105,2,3,33,38,
Osage,President,Hillary Clinton,DEM,570105,9,5,176,190,
Osage,U.S. Senate,James Lankford,REP,570105,26,12,574,612,
Osage,U.S. Senate,Robert Murphy,LIB,570105,0,1,15,16,
Osage,U.S. Senate,Mike Workman,DEM,570105,10,6,154,170,
Osage,U.S. Senate,Mark Beard,IND,570105,0,0,21,21,
Osage,U.S. Senate,Sean Braddy,IND,570105,1,1,17,19,
Osage,U.S. House,Frank Lucas,REP,570105,27,13,585,625,03
Osage,U.S. House,Frankie Robbins,DEM,570105,10,7,191,208,03
Osage,President,Donald Trump,REP,570106,1,0,68,69,
Osage,President,Gary Johnson,LIB,570106,0,0,1,1,
Osage,President,Hillary Clinton,DEM,570106,0,1,6,7,
Osage,U.S. Senate,James Lankford,REP,570106,1,0,57,58,
Osage,U.S. Senate,Robert Murphy,LIB,570106,0,0,1,1,
Osage,U.S. Senate,Mike Workman,DEM,570106,0,1,12,13,
Osage,U.S. Senate,Mark Beard,IND,570106,0,0,1,1,
Osage,U.S. Senate,Sean Braddy,IND,570106,0,0,2,2,
Osage,U.S. House,Frank Lucas,REP,570106,1,0,63,64,03
Osage,U.S. House,Frankie Robbins,DEM,570106,0,1,9,10,03
Osage,President,Donald Trump,REP,570107,35,146,524,705,
Osage,President,Gary Johnson,LIB,570107,3,14,59,76,
Osage,President,Hillary Clinton,DEM,570107,13,78,213,304,
Osage,U.S. Senate,James Lankford,REP,570107,34,160,522,716,
Osage,U.S. Senate,Robert Murphy,LIB,570107,0,6,27,33,
Osage,U.S. Senate,Mike Workman,DEM,570107,13,61,203,277,
Osage,U.S. Senate,Mark Beard,IND,570107,0,6,25,31,
Osage,U.S. Senate,Sean Braddy,IND,570107,2,4,20,26,
Osage,U.S. House,Frank Lucas,REP,570107,36,156,527,719,03
Osage,U.S. House,Frankie Robbins,DEM,570107,12,78,266,356,03
Osage,President,Donald Trump,REP,570108,11,79,316,406,
Osage,President,Gary Johnson,LIB,570108,4,8,31,43,
Osage,President,Hillary Clinton,DEM,570108,10,47,139,196,
Osage,U.S. Senate,James Lankford,REP,570108,11,74,286,371,
Osage,U.S. Senate,Robert Murphy,LIB,570108,2,3,18,23,
Osage,U.S. Senate,Mike Workman,DEM,570108,11,43,145,199,
Osage,U.S. Senate,Mark Beard,IND,570108,0,3,9,12,
Osage,U.S. Senate,Sean Braddy,IND,570108,1,7,22,30,
Osage,U.S. House,Frank Lucas,REP,570108,14,79,300,393,03
Osage,U.S. House,Frankie Robbins,DEM,570108,11,50,178,239,03
Osage,State House,Sean Roberts,REP,570108,4,44,198,246,36
Osage,State House,Cathy Ross,DEM,570108,21,88,282,391,36
Osage,President,Donald Trump,REP,570109,27,35,598,660,
Osage,President,Gary Johnson,LIB,570109,3,0,35,38,
Osage,President,Hillary Clinton,DEM,570109,8,10,113,131,
Osage,U.S. Senate,James Lankford,REP,570109,29,34,604,667,
Osage,U.S. Senate,Robert Murphy,LIB,570109,2,0,16,18,
Osage,U.S. Senate,Mike Workman,DEM,570109,7,10,107,124,
Osage,U.S. Senate,Mark Beard,IND,570109,0,0,13,13,
Osage,U.S. Senate,Sean Braddy,IND,570109,0,1,13,14,
Osage,U.S. House,Frank Lucas,REP,570109,33,34,611,678,03
Osage,U.S. House,Frankie Robbins,DEM,570109,5,10,134,149,03
Osage,State House,Travis Dunlap,REP,570109,30,35,601,666,10
Osage,State House,Eric Epperson,DEM,570109,8,10,146,164,10
Osage,President,Donald Trump,REP,570110,21,29,581,631,
Osage,President,Gary Johnson,LIB,570110,0,0,15,15,
Osage,President,Hillary Clinton,DEM,570110,9,4,89,102,
Osage,U.S. Senate,James Lankford,REP,570110,20,24,545,589,
Osage,U.S. Senate,Robert Murphy,LIB,570110,1,0,16,17,
Osage,U.S. Senate,Mike Workman,DEM,570110,6,6,97,109,
Osage,U.S. Senate,Mark Beard,IND,570110,0,0,7,7,
Osage,U.S. Senate,Sean Braddy,IND,570110,0,2,17,19,
Osage,U.S. House,Frank Lucas,REP,570110,20,26,541,587,03
Osage,U.S. House,Frankie Robbins,DEM,570110,7,7,134,148,03
Osage,State House,Sean Roberts,REP,570110,15,16,438,469,36
Osage,State House,Cathy Ross,DEM,570110,12,17,241,270,36
Osage,President,Donald Trump,REP,570111,5,18,191,214,
Osage,President,Gary Johnson,LIB,570111,3,0,12,15,
Osage,President,Hillary Clinton,DEM,570111,0,2,30,32,
Osage,U.S. Senate,James Lankford,REP,570111,5,15,186,206,
Osage,U.S. Senate,Robert Murphy,LIB,570111,3,0,5,8,
Osage,U.S. Senate,Mike Workman,DEM,570111,0,2,32,34,
Osage,U.S. Senate,Mark Beard,IND,570111,0,1,4,5,
Osage,U.S. Senate,Sean Braddy,IND,570111,0,1,8,9,
Osage,U.S. House,Frank Lucas,REP,570111,5,16,191,212,03
Osage,U.S. House,Frankie Robbins,DEM,570111,3,3,43,49,03
Osage,State House,Sean Roberts,REP,570111,4,11,153,168,36
Osage,State House,Cathy Ross,DEM,570111,4,8,77,89,36
Osage,President,Donald Trump,REP,570112,21,16,330,367,
Osage,President,Gary Johnson,LIB,570112,2,0,15,17,
Osage,President,Hillary Clinton,DEM,570112,8,2,78,88,
Osage,U.S. Senate,James Lankford,REP,570112,23,14,313,350,
Osage,U.S. Senate,Robert Murphy,LIB,570112,0,1,4,5,
Osage,U.S. Senate,Mike Workman,DEM,570112,8,3,75,86,
Osage,U.S. Senate,Mark Beard,IND,570112,0,0,11,11,
Osage,U.S. Senate,Sean Braddy,IND,570112,0,0,13,13,
Osage,U.S. House,Frank Lucas,REP,570112,21,12,311,344,03
Osage,U.S. House,Frankie Robbins,DEM,570112,10,6,99,115,03
Osage,State House,Sean Roberts,REP,570112,18,13,293,324,36
Osage,State House,Cathy Ross,DEM,570112,13,5,118,136,36
Osage,President,Donald Trump,REP,570113,1,0,36,37,
Osage,President,Gary Johnson,LIB,570113,0,0,0,0,
Osage,President,Hillary Clinton,DEM,570113,1,5,11,17,
Osage,U.S. Senate,James Lankford,REP,570113,1,0,32,33,
Osage,U.S. Senate,Robert Murphy,LIB,570113,0,0,2,2,
Osage,U.S. Senate,Mike Workman,DEM,570113,0,5,12,17,
Osage,U.S. Senate,Mark Beard,IND,570113,0,0,1,1,
Osage,U.S. Senate,Sean Braddy,IND,570113,0,0,0,0,
Osage,U.S. House,Frank Lucas,REP,570113,1,0,33,34,03
Osage,U.S. House,Frankie Robbins,DEM,570113,0,5,14,19,03
Osage,President,Donald Trump,REP,570201,75,34,1502,1611,
Osage,President,Gary Johnson,LIB,570201,9,1,95,105,
Osage,President,Hillary Clinton,DEM,570201,25,11,364,400,
Osage,U.S. Senate,James Lankford,REP,570201,81,35,1471,1587,
Osage,U.S. Senate,Robert Murphy,LIB,570201,2,0,64,66,
Osage,U.S. Senate,Mike Workman,DEM,570201,21,9,340,370,
Osage,U.S. Senate,Mark Beard,IND,570201,3,2,38,43,
Osage,U.S. Senate,Sean Braddy,IND,570201,1,0,37,38,
Osage,U.S. House,Frank Lucas,REP,570201,83,34,1479,1596,03
Osage,U.S. House,Frankie Robbins,DEM,570201,23,12,451,486,03
Osage,State House,Sean Roberts,REP,570201,72,31,1420,1523,36
Osage,State House,Cathy Ross,DEM,570201,35,15,508,558,36
Osage,President,Donald Trump,REP,570202,24,14,134,172,
Osage,President,Gary Johnson,LIB,570202,3,2,32,37,
Osage,President,Hillary Clinton,DEM,570202,175,73,991,1239,
Osage,U.S. Senate,James Lankford,REP,570202,35,19,180,234,
Osage,U.S. Senate,Robert Murphy,LIB,570202,1,1,23,25,
Osage,U.S. Senate,Mike Workman,DEM,570202,155,67,876,1098,
Osage,U.S. Senate,Mark Beard,IND,570202,4,0,26,30,
Osage,U.S. Senate,Sean Braddy,IND,570202,6,1,48,55,
Osage,U.S. House,Frank Lucas,REP,570202,29,18,159,206,03
Osage,U.S. House,Frankie Robbins,DEM,570202,172,71,982,1225,03
Osage,State House,Leland Cole,REP,570202,21,15,147,183,73
Osage,State House,Regina Goodwin,DEM,570202,181,74,1007,1262,73
Osage,President,Donald Trump,REP,570203,128,101,1752,1981,
Osage,President,Gary Johnson,LIB,570203,10,5,96,111,
Osage,President,Hillary Clinton,DEM,570203,59,28,350,437,
Osage,U.S. Senate,James Lankford,REP,570203,135,104,1735,1974,
Osage,U.S. Senate,Robert Murphy,LIB,570203,5,1,53,59,
Osage,U.S. Senate,Mike Workman,DEM,570203,54,27,323,404,
Osage,U.S. Senate,Mark Beard,IND,570203,2,1,28,31,
Osage,U.S. Senate,Sean Braddy,IND,570203,1,1,44,46,
Osage,U.S. House,Frank Lucas,REP,570203,138,104,1730,1972,03
Osage,U.S. House,Frankie Robbins,DEM,570203,59,30,441,530,03
Osage,State House,Sean Roberts,REP,570203,123,91,1624,1838,36
Osage,State House,Cathy Ross,DEM,570203,70,43,538,651,36
Osage,President,Donald Trump,REP,570204,21,11,497,529,
Osage,President,Gary Johnson,LIB,570204,3,1,37,41,
Osage,President,Hillary Clinton,DEM,570204,21,2,153,176,
Osage,U.S. Senate,James Lankford,REP,570204,20,11,509,540,
Osage,U.S. Senate,Robert Murphy,LIB,570204,0,1,13,14,
Osage,U.S. Senate,Mike Workman,DEM,570204,23,2,147,172,
Osage,U.S. Senate,Mark Beard,IND,570204,1,0,11,12,
Osage,U.S. Senate,Sean Braddy,IND,570204,1,0,6,7,
Osage,U.S. House,Frank Lucas,REP,570204,23,10,499,532,03
Osage,U.S. House,Frankie Robbins,DEM,570204,22,4,178,204,03
Osage,State House,Sean Roberts,REP,570204,16,10,457,483,36
Osage,State House,Cathy Ross,DEM,570204,27,4,212,243,36
Osage,President,Donald Trump,REP,570205,9,1,131,141,
Osage,President,Gary Johnson,LIB,570205,0,0,6,6,
Osage,President,Hillary Clinton,DEM,570205,5,4,57,66,
Osage,U.S. Senate,James Lankford,REP,570205,8,1,129,138,
Osage,U.S. Senate,Robert Murphy,LIB,570205,1,0,4,5,
Osage,U.S. Senate,Mike Workman,DEM,570205,5,4,56,65,
Osage,U.S. Senate,Mark Beard,IND,570205,0,0,4,4,
Osage,U.S. Senate,Sean Braddy,IND,570205,0,0,2,2,
Osage,U.S. House,Frank Lucas,REP,570205,9,1,125,135,03
Osage,U.S. House,Frankie Robbins,DEM,570205,5,4,69,78,03
Osage,State House,Sean Roberts,REP,570205,9,1,122,132,36
Osage,State House,Cathy Ross,DEM,570205,5,4,70,79,36
Osage,President,Donald Trump,REP,570301,17,9,384,410,
Osage,President,Gary Johnson,LIB,570301,0,1,20,21,
Osage,President,Hillary Clinton,DEM,570301,8,4,151,163,
Osage,U.S. Senate,James Lankford,REP,570301,18,8,355,381,
Osage,U.S. Senate,Robert Murphy,LIB,570301,0,1,10,11,
Osage,U.S. Senate,Mike Workman,DEM,570301,6,5,147,158,
Osage,U.S. Senate,Mark Beard,IND,570301,0,0,18,18,
Osage,U.S. Senate,Sean Braddy,IND,570301,0,0,17,17,
Osage,U.S. House,Frank Lucas,REP,570301,19,9,390,418,03
Osage,U.S. House,Frankie Robbins,DEM,570301,4,5,155,164,03
Osage,State House,Sean Roberts,REP,570301,15,8,309,332,36
Osage,State House,Cathy Ross,DEM,570301,8,6,229,243,36
Osage,President,Donald Trump,REP,570302,4,3,93,100,
Osage,President,Gary Johnson,LIB,570302,3,0,4,7,
Osage,President,Hillary Clinton,DEM,570302,0,0,32,32,
Osage,U.S. Senate,James Lankford,REP,570302,4,3,83,90,
Osage,U.S. Senate,Robert Murphy,LIB,570302,1,0,1,2,
Osage,U.S. Senate,Mike Workman,DEM,570302,0,0,35,35,
Osage,U.S. Senate,Mark Beard,IND,570302,1,0,2,3,
Osage,U.S. Senate,Sean Braddy,IND,570302,2,0,8,10,
Osage,U.S. House,Frank Lucas,REP,570302,6,3,89,98,03
Osage,U.S. House,Frankie Robbins,DEM,570302,2,0,40,42,03
Osage,President,Donald Trump,REP,570303,10,3,283,296,
Osage,President,Gary Johnson,LIB,570303,3,0,16,19,
Osage,President,Hillary Clinton,DEM,570303,6,1,63,70,
Osage,U.S. Senate,James Lankford,REP,570303,13,3,273,289,
Osage,U.S. Senate,Robert Murphy,LIB,570303,1,0,10,11,
Osage,U.S. Senate,Mike Workman,DEM,570303,5,1,60,66,
Osage,U.S. Senate,Mark Beard,IND,570303,0,0,11,11,
Osage,U.S. Senate,Sean Braddy,IND,570303,0,0,6,6,
Osage,U.S. House,Frank Lucas,REP,570303,15,3,283,301,03
Osage,U.S. House,Frankie Robbins,DEM,570303,4,1,77,82,03
Osage,President,Donald Trump,REP,570305,22,11,323,356,
Osage,President,Gary Johnson,LIB,570305,0,0,12,12,
Osage,President,Hillary Clinton,DEM,570305,12,2,86,100,
Osage,U.S. Senate,James Lankford,REP,570305,23,10,315,348,
Osage,U.S. Senate,Robert Murphy,LIB,570305,0,1,6,7,
Osage,U.S. Senate,Mike Workman,DEM,570305,9,2,85,96,
Osage,U.S. Senate,Mark Beard,IND,570305,1,0,13,14,
Osage,U.S. Senate,Sean Braddy,IND,570305,2,0,5,7,
Osage,U.S. House,Frank Lucas,REP,570305,27,11,309,347,03
Osage,U.S. House,Frankie Robbins,DEM,570305,8,2,113,123,03
Osage,President,Donald Trump,REP,570306,17,17,349,383,
Osage,President,Gary Johnson,LIB,570306,0,0,14,14,
Osage,President,Hillary Clinton,DEM,570306,2,3,85,90,
Osage,U.S. Senate,James Lankford,REP,570306,16,17,335,368,
Osage,U.S. Senate,Robert Murphy,LIB,570306,1,0,11,12,
Osage,U.S. Senate,Mike Workman,DEM,570306,2,3,84,89,
Osage,U.S. Senate,Mark Beard,IND,570306,0,0,9,9,
Osage,U.S. Senate,Sean Braddy,IND,570306,1,0,5,6,
Osage,U.S. House,Frank Lucas,REP,570306,18,17,334,369,03
Osage,U.S. House,Frankie Robbins,DEM,570306,2,3,112,117,03
Osage,State House,Sean Roberts,REP,570306,17,16,271,304,36
Osage,State House,Cathy Ross,DEM,570306,3,4,176,183,36
Osage,President,Donald Trump,REP,570307,18,16,383,417,
Osage,President,Gary Johnson,LIB,570307,1,0,24,25,
Osage,President,Hillary Clinton,DEM,570307,5,5,224,234,
Osage,U.S. Senate,James Lankford,REP,570307,19,15,377,411,
Osage,U.S. Senate,Robert Murphy,LIB,570307,0,0,8,8,
Osage,U.S. Senate,Mike Workman,DEM,570307,5,5,196,206,
Osage,U.S. Senate,Mark Beard,IND,570307,0,1,21,22,
Osage,U.S. Senate,Sean Braddy,IND,570307,0,0,29,29,
Osage,U.S. House,Frank Lucas,REP,570307,19,13,388,420,03
Osage,U.S. House,Frankie Robbins,DEM,570307,6,7,240,253,03
Osage,State House,Sean Roberts,REP,570307,18,11,292,321,36
Osage,State House,Cathy Ross,DEM,570307,7,10,338,355,36
Osage,President,Donald Trump,REP,570308,56,18,784,858,
Osage,President,Gary Johnson,LIB,570308,0,0,44,44,
Osage,President,Hillary Clinton,DEM,570308,16,19,243,278,
Osage,U.S. Senate,James Lankford,REP,570308,51,22,778,851,
Osage,U.S. Senate,Robert Murphy,LIB,570308,2,2,31,35,
Osage,U.S. Senate,Mike Workman,DEM,570308,13,13,214,240,
Osage,U.S. Senate,Mark Beard,IND,570308,3,0,27,30,
Osage,U.S. Senate,Sean Braddy,IND,570308,2,0,22,24,
Osage,U.S. House,Frank Lucas,REP,570308,55,22,804,881,03
Osage,U.S. House,Frankie Robbins,DEM,570308,16,15,258,289,03
Osage,State House,Sean Roberts,REP,570308,54,19,744,817,36
Osage,State House,Cathy Ross,DEM,570308,17,18,317,352,36
Osage,President,Donald Trump,REP,570309,41,19,449,509,
Osage,President,Gary Johnson,LIB,570309,3,0,25,28,
Osage,President,Hillary Clinton,DEM,570309,6,3,81,90,
Osage,U.S. Senate,James Lankford,REP,570309,41,19,451,511,
Osage,U.S. Senate,Robert Murphy,LIB,570309,0,0,15,15,
Osage,U.S. Senate,Mike Workman,DEM,570309,5,3,69,77,
Osage,U.S. Senate,Mark Beard,IND,570309,0,0,9,9,
Osage,U.S. Senate,Sean Braddy,IND,570309,4,0,10,14,
Osage,U.S. House,Frank Lucas,REP,570309,45,18,459,522,03
Osage,U.S. House,Frankie Robbins,DEM,570309,5,4,94,103,03
Osage,State House,Sean Roberts,REP,570309,40,17,427,484,36
Osage,State House,Cathy Ross,DEM,570309,9,4,123,136,36
Osage,President,Donald Trump,REP,570310,21,6,74,101,
Osage,President,Gary Johnson,LIB,570310,3,0,16,19,
Osage,President,Hillary Clinton,DEM,570310,100,10,749,859,
Osage,U.S. Senate,James Lankford,REP,570310,20,6,122,148,
Osage,U.S. Senate,Robert Murphy,LIB,570310,0,0,14,14,
Osage,U.S. Senate,Mike Workman,DEM,570310,96,10,664,770,
Osage,U.S. Senate,Mark Beard,IND,570310,5,0,14,19,
Osage,U.S. Senate,Sean Braddy,IND,570310,2,0,23,25,
Osage,U.S. House,Frank Lucas,REP,570310,21,6,101,128,03
Osage,U.S. House,Frankie Robbins,DEM,570310,101,10,732,843,03
Osage,State House,Leland Cole,REP,570310,17,6,79,102,73
Osage,State House,Regina Goodwin,DEM,570310,104,10,755,869,73
Osage,President,Donald Trump,REP,570311,14,4,44,62,
Osage,President,Gary Johnson,LIB,570311,1,0,1,2,
Osage,President,Hillary Clinton,DEM,570311,18,0,29,47,
Osage,U.S. Senate,James Lankford,REP,570311,17,4,47,68,
Osage,U.S. Senate,Robert Murphy,LIB,570311,0,0,0,0,
Osage,U.S. Senate,Mike Workman,DEM,570311,17,0,22,39,
Osage,U.S. Senate,Mark Beard,IND,570311,0,0,1,1,
Osage,U.S. Senate,Sean Braddy,IND,570311,0,0,2,2,
Osage,U.S. House,Frank Lucas,REP,570311,20,4,45,69,03
Osage,U.S. House,Frankie Robbins,DEM,570311,14,0,25,39,03
Osage,State House,Jadine Nollan,REP,570311,19,4,44,67,66
Osage,State House,Dianna Phillips,DEM,570311,15,0,26,41,66
Osage,President,Donald Trump,REP,570312,38,5,407,450,
Osage,President,Gary Johnson,LIB,570312,1,0,26,27,
Osage,President,Hillary Clinton,DEM,570312,13,4,129,146,
Osage,U.S. Senate,James Lankford,REP,570312,34,5,412,451,
Osage,U.S. Senate,Robert Murphy,LIB,570312,1,1,15,17,
Osage,U.S. Senate,Mike Workman,DEM,570312,11,3,110,124,
Osage,U.S. Senate,Mark Beard,IND,570312,5,0,13,18,
Osage,U.S. Senate,Sean Braddy,IND,570312,0,0,11,11,
Osage,U.S. House,Frank Lucas,REP,570312,39,5,437,481,03
Osage,U.S. House,Frankie Robbins,DEM,570312,12,4,120,136,03
Osage,State House,Jadine Nollan,REP,570312,38,6,440,484,66
Osage,State House,Dianna Phillips,DEM,570312,13,3,120,136,66
Ottawa,President,Donald Trump,REP,580002,12,62,305,379,
Ottawa,President,Gary Johnson,LIB,580002,1,0,17,18,
Ottawa,President,Hillary Clinton,DEM,580002,8,27,121,156,
Ottawa,U.S. Senate,James Lankford,REP,580002,12,57,283,352,
Ottawa,U.S. Senate,Robert Murphy,LIB,580002,1,4,9,14,
Ottawa,U.S. Senate,Mike Workman,DEM,580002,8,25,124,157,
Ottawa,U.S. Senate,Mark Beard,IND,580002,0,1,9,10,
Ottawa,U.S. Senate,Sean Braddy,IND,580002,0,1,6,7,
Ottawa,U.S. House,Markwayne Mullin,REP,580002,12,58,286,356,02
Ottawa,U.S. House,Joshua Harris-Till,DEM,580002,8,27,115,150,02
Ottawa,U.S. House,John Mccarthy,IND,580002,1,2,29,32,02
Ottawa,State Senate,Micheal Bergstrom,REP,580002,9,48,265,322,1
Ottawa,State Senate,John Myers,DEM,580002,12,40,168,220,1
Ottawa,State House,Hoguen Apperson,REP,580002,8,25,137,170,7
Ottawa,State House,Ben Loring,DEM,580002,12,62,293,367,7
Ottawa,President,Donald Trump,REP,580003,17,60,398,475,
Ottawa,President,Gary Johnson,LIB,580003,1,4,24,29,
Ottawa,President,Hillary Clinton,DEM,580003,13,63,168,244,
Ottawa,U.S. Senate,James Lankford,REP,580003,20,60,379,459,
Ottawa,U.S. Senate,Robert Murphy,LIB,580003,0,3,8,11,
Ottawa,U.S. Senate,Mike Workman,DEM,580003,9,59,170,238,
Ottawa,U.S. Senate,Mark Beard,IND,580003,2,2,18,22,
Ottawa,U.S. Senate,Sean Braddy,IND,580003,0,1,14,15,
Ottawa,U.S. House,Markwayne Mullin,REP,580003,22,61,382,465,02
Ottawa,U.S. House,Joshua Harris-Till,DEM,580003,7,60,165,232,02
Ottawa,U.S. House,John Mccarthy,IND,580003,2,5,43,50,02
Ottawa,State Senate,Micheal Bergstrom,REP,580003,21,52,342,415,1
Ottawa,State Senate,John Myers,DEM,580003,9,75,247,331,1
Ottawa,State House,Hoguen Apperson,REP,580003,11,30,180,221,7
Ottawa,State House,Ben Loring,DEM,580003,19,98,415,532,7
Ottawa,President,Donald Trump,REP,580004,9,41,186,236,
Ottawa,President,Gary Johnson,LIB,580004,0,2,9,11,
Ottawa,President,Hillary Clinton,DEM,580004,11,28,78,117,
Ottawa,U.S. Senate,James Lankford,REP,580004,12,43,179,234,
Ottawa,U.S. Senate,Robert Murphy,LIB,580004,0,2,6,8,
Ottawa,U.S. Senate,Mike Workman,DEM,580004,10,22,65,97,
Ottawa,U.S. Senate,Mark Beard,IND,580004,0,1,8,9,
Ottawa,U.S. Senate,Sean Braddy,IND,580004,0,2,9,11,
Ottawa,U.S. House,Markwayne Mullin,REP,580004,11,41,171,223,02
Ottawa,U.S. House,Joshua Harris-Till,DEM,580004,11,27,79,117,02
Ottawa,U.S. House,John Mccarthy,IND,580004,0,3,16,19,02
Ottawa,State Senate,Micheal Bergstrom,REP,580004,10,28,151,189,1
Ottawa,State Senate,John Myers,DEM,580004,11,43,113,167,1
Ottawa,State House,Hoguen Apperson,REP,580004,7,16,75,98,7
Ottawa,State House,Ben Loring,DEM,580004,14,54,194,262,7
Ottawa,President,Donald Trump,REP,580005,6,44,231,281,
Ottawa,President,Gary Johnson,LIB,580005,2,3,33,38,
Ottawa,President,Hillary Clinton,DEM,580005,2,17,104,123,
Ottawa,U.S. Senate,James Lankford,REP,580005,7,40,192,239,
Ottawa,U.S. Senate,Robert Murphy,LIB,580005,0,1,22,23,
Ottawa,U.S. Senate,Mike Workman,DEM,580005,3,17,111,131,
Ottawa,U.S. Senate,Mark Beard,IND,580005,0,1,18,19,
Ottawa,U.S. Senate,Sean Braddy,IND,580005,0,3,17,20,
Ottawa,U.S. House,Markwayne Mullin,REP,580005,7,42,197,246,02
Ottawa,U.S. House,Joshua Harris-Till,DEM,580005,3,16,109,128,02
Ottawa,U.S. House,John Mccarthy,IND,580005,0,5,52,57,02
Ottawa,State Senate,Micheal Bergstrom,REP,580005,6,38,192,236,1
Ottawa,State Senate,John Myers,DEM,580005,4,23,167,194,1
Ottawa,State House,Hoguen Apperson,REP,580005,5,28,131,164,7
Ottawa,State House,Ben Loring,DEM,580005,5,34,225,264,7
Ottawa,President,Donald Trump,REP,580007,20,99,601,720,
Ottawa,President,Gary Johnson,LIB,580007,2,5,34,41,
Ottawa,President,Hillary Clinton,DEM,580007,7,31,205,243,
Ottawa,U.S. Senate,James Lankford,REP,580007,22,99,566,687,
Ottawa,U.S. Senate,Robert Murphy,LIB,580007,0,2,28,30,
Ottawa,U.S. Senate,Mike Workman,DEM,580007,7,31,206,244,
Ottawa,U.S. Senate,Mark Beard,IND,580007,0,3,15,18,
Ottawa,U.S. Senate,Sean Braddy,IND,580007,0,3,14,17,
Ottawa,U.S. House,Markwayne Mullin,REP,580007,22,99,560,681,02
Ottawa,U.S. House,Joshua Harris-Till,DEM,580007,6,34,205,245,02
Ottawa,U.S. House,John Mccarthy,IND,580007,1,6,63,70,02
Ottawa,State Senate,Micheal Bergstrom,REP,580007,14,85,463,562,1
Ottawa,State Senate,John Myers,DEM,580007,14,54,365,433,1
Ottawa,State House,Hoguen Apperson,REP,580007,10,46,270,326,7
Ottawa,State House,Ben Loring,DEM,580007,20,92,569,681,7
Ottawa,President,Donald Trump,REP,580008,3,17,165,185,
Ottawa,President,Gary Johnson,LIB,580008,0,2,13,15,
Ottawa,President,Hillary Clinton,DEM,580008,0,10,59,69,
Ottawa,U.S. Senate,James Lankford,REP,580008,3,17,144,164,
Ottawa,U.S. Senate,Robert Murphy,LIB,580008,0,0,11,11,
Ottawa,U.S. Senate,Mike Workman,DEM,580008,0,10,63,73,
Ottawa,U.S. Senate,Mark Beard,IND,580008,0,1,2,3,
Ottawa,U.S. Senate,Sean Braddy,IND,580008,0,1,10,11,
Ottawa,U.S. House,Markwayne Mullin,REP,580008,3,18,144,165,02
Ottawa,U.S. House,Joshua Harris-Till,DEM,580008,0,10,62,72,02
Ottawa,U.S. House,John Mccarthy,IND,580008,0,1,22,23,02
Ottawa,State Senate,Micheal Bergstrom,REP,580008,2,15,123,140,1
Ottawa,State Senate,John Myers,DEM,580008,1,14,106,121,1
Ottawa,State House,Hoguen Apperson,REP,580008,1,5,76,82,7
Ottawa,State House,Ben Loring,DEM,580008,2,24,157,183,7
Ottawa,President,Donald Trump,REP,580009,7,35,219,261,
Ottawa,President,Gary Johnson,LIB,580009,0,1,17,18,
Ottawa,President,Hillary Clinton,DEM,580009,9,13,88,110,
Ottawa,U.S. Senate,James Lankford,REP,580009,8,28,188,224,
Ottawa,U.S. Senate,Robert Murphy,LIB,580009,0,1,14,15,
Ottawa,U.S. Senate,Mike Workman,DEM,580009,8,18,109,135,
Ottawa,U.S. Senate,Mark Beard,IND,580009,0,0,4,4,
Ottawa,U.S. Senate,Sean Braddy,IND,580009,0,0,7,7,
Ottawa,U.S. House,Markwayne Mullin,REP,580009,4,26,194,224,02
Ottawa,U.S. House,Joshua Harris-Till,DEM,580009,10,18,99,127,02
Ottawa,U.S. House,John Mccarthy,IND,580009,1,3,25,29,02
Ottawa,State Senate,Micheal Bergstrom,REP,580009,8,26,173,207,1
Ottawa,State Senate,John Myers,DEM,580009,8,21,146,175,1
Ottawa,State House,Hoguen Apperson,REP,580009,5,18,117,140,7
Ottawa,State House,Ben Loring,DEM,580009,11,30,207,248,7
Ottawa,President,Donald Trump,REP,580011,14,56,298,368,
Ottawa,President,Gary Johnson,LIB,580011,1,0,40,41,
Ottawa,President,Hillary Clinton,DEM,580011,9,20,141,170,
Ottawa,U.S. Senate,James Lankford,REP,580011,16,50,253,319,
Ottawa,U.S. Senate,Robert Murphy,LIB,580011,1,5,16,22,
Ottawa,U.S. Senate,Mike Workman,DEM,580011,7,20,158,185,
Ottawa,U.S. Senate,Mark Beard,IND,580011,0,0,19,19,
Ottawa,U.S. Senate,Sean Braddy,IND,580011,0,1,17,18,
Ottawa,U.S. House,Markwayne Mullin,REP,580011,16,47,263,326,02
Ottawa,U.S. House,Joshua Harris-Till,DEM,580011,7,25,150,182,02
Ottawa,U.S. House,John Mccarthy,IND,580011,1,4,49,54,02
Ottawa,State Senate,Micheal Bergstrom,REP,580011,14,43,264,321,1
Ottawa,State Senate,John Myers,DEM,580011,9,33,203,245,1
Ottawa,State House,Hoguen Apperson,REP,580011,13,33,165,211,7
Ottawa,State House,Ben Loring,DEM,580011,11,43,298,352,7
Ottawa,President,Donald Trump,REP,580012,4,36,267,307,
Ottawa,President,Gary Johnson,LIB,580012,0,0,26,26,
Ottawa,President,Hillary Clinton,DEM,580012,4,17,88,109,
Ottawa,U.S. Senate,James Lankford,REP,580012,4,29,245,278,
Ottawa,U.S. Senate,Robert Murphy,LIB,580012,0,0,12,12,
Ottawa,U.S. Senate,Mike Workman,DEM,580012,4,21,91,116,
Ottawa,U.S. Senate,Mark Beard,IND,580012,0,1,11,12,
Ottawa,U.S. Senate,Sean Braddy,IND,580012,1,1,18,20,
Ottawa,U.S. House,Markwayne Mullin,REP,580012,3,31,237,271,02
Ottawa,U.S. House,Joshua Harris-Till,DEM,580012,5,19,90,114,02
Ottawa,U.S. House,John Mccarthy,IND,580012,1,2,51,54,02
Ottawa,State Senate,Micheal Bergstrom,REP,580012,2,30,232,264,1
Ottawa,State Senate,John Myers,DEM,580012,7,22,146,175,1
Ottawa,State House,Hoguen Apperson,REP,580012,1,20,134,155,7
Ottawa,State House,Ben Loring,DEM,580012,8,32,243,283,7
Ottawa,President,Donald Trump,REP,580014,11,48,561,620,
Ottawa,President,Gary Johnson,LIB,580014,0,4,34,38,
Ottawa,President,Hillary Clinton,DEM,580014,7,21,205,233,
Ottawa,U.S. Senate,James Lankford,REP,580014,11,47,494,552,
Ottawa,U.S. Senate,Robert Murphy,LIB,580014,1,0,19,20,
Ottawa,U.S. Senate,Mike Workman,DEM,580014,5,24,230,259,
Ottawa,U.S. Senate,Mark Beard,IND,580014,0,0,22,22,
Ottawa,U.S. Senate,Sean Braddy,IND,580014,0,2,32,34,
Ottawa,U.S. House,Markwayne Mullin,REP,580014,12,46,495,553,02
Ottawa,U.S. House,Joshua Harris-Till,DEM,580014,4,25,230,259,02
Ottawa,U.S. House,John Mccarthy,IND,580014,1,1,69,71,02
Ottawa,State Senate,Micheal Bergstrom,REP,580014,7,38,423,468,1
Ottawa,State Senate,John Myers,DEM,580014,10,35,373,418,1
Ottawa,State House,Hoguen Apperson,REP,580014,8,28,283,319,7
Ottawa,State House,Ben Loring,DEM,580014,10,45,515,570,7
Ottawa,President,Donald Trump,REP,580023,4,29,385,418,
Ottawa,President,Gary Johnson,LIB,580023,2,3,18,23,
Ottawa,President,Hillary Clinton,DEM,580023,2,0,160,162,
Ottawa,U.S. Senate,James Lankford,REP,580023,4,25,319,348,
Ottawa,U.S. Senate,Robert Murphy,LIB,580023,2,4,13,19,
Ottawa,U.S. Senate,Mike Workman,DEM,580023,2,1,192,195,
Ottawa,U.S. Senate,Mark Beard,IND,580023,0,2,17,19,
Ottawa,U.S. Senate,Sean Braddy,IND,580023,0,0,14,14,
Ottawa,U.S. House,Markwayne Mullin,REP,580023,4,26,323,353,02
Ottawa,U.S. House,Joshua Harris-Till,DEM,580023,3,1,192,196,02
Ottawa,U.S. House,John Mccarthy,IND,580023,1,5,39,45,02
Ottawa,State Senate,Micheal Bergstrom,REP,580023,5,25,302,332,1
Ottawa,State Senate,John Myers,DEM,580023,3,7,256,266,1
Ottawa,State House,Hoguen Apperson,REP,580023,4,18,209,231,7
Ottawa,State House,Ben Loring,DEM,580023,4,14,351,369,7
Ottawa,President,Donald Trump,REP,580024,10,17,225,252,
Ottawa,President,Gary Johnson,LIB,580024,0,0,13,13,
Ottawa,President,Hillary Clinton,DEM,580024,1,7,40,48,
Ottawa,U.S. Senate,James Lankford,REP,580024,9,12,206,227,
Ottawa,U.S. Senate,Robert Murphy,LIB,580024,0,1,9,10,
Ottawa,U.S. Senate,Mike Workman,DEM,580024,1,10,58,69,
Ottawa,U.S. Senate,Mark Beard,IND,580024,0,1,2,3,
Ottawa,U.S. Senate,Sean Braddy,IND,580024,1,0,3,4,
Ottawa,U.S. House,Markwayne Mullin,REP,580024,9,15,207,231,02
Ottawa,U.S. House,Joshua Harris-Till,DEM,580024,2,8,52,62,02
Ottawa,U.S. House,John Mccarthy,IND,580024,0,1,18,19,02
Ottawa,State Senate,Micheal Bergstrom,REP,580024,10,14,195,219,1
Ottawa,State Senate,John Myers,DEM,580024,1,10,83,94,1
Ottawa,State House,Hoguen Apperson,REP,580024,8,9,171,188,7
Ottawa,State House,Ben Loring,DEM,580024,3,15,106,124,7
Ottawa,President,Donald Trump,REP,580025,15,27,417,459,
Ottawa,President,Gary Johnson,LIB,580025,1,5,16,22,
Ottawa,President,Hillary Clinton,DEM,580025,3,11,94,108,
Ottawa,U.S. Senate,James Lankford,REP,580025,16,27,379,422,
Ottawa,U.S. Senate,Robert Murphy,LIB,580025,0,0,14,14,
Ottawa,U.S. Senate,Mike Workman,DEM,580025,4,12,114,130,
Ottawa,U.S. Senate,Mark Beard,IND,580025,0,4,4,8,
Ottawa,U.S. Senate,Sean Braddy,IND,580025,0,0,9,9,
Ottawa,U.S. House,Markwayne Mullin,REP,580025,16,27,376,419,02
Ottawa,U.S. House,Joshua Harris-Till,DEM,580025,3,11,112,126,02
Ottawa,U.S. House,John Mccarthy,IND,580025,1,5,34,40,02
Ottawa,State Senate,Micheal Bergstrom,REP,580025,16,28,362,406,1
Ottawa,State Senate,John Myers,DEM,580025,4,15,158,177,1
Ottawa,State House,Hoguen Apperson,REP,580025,11,23,260,294,7
Ottawa,State House,Ben Loring,DEM,580025,9,19,258,286,7
Ottawa,President,Donald Trump,REP,580026,24,32,624,680,
Ottawa,President,Gary Johnson,LIB,580026,1,1,30,32,
Ottawa,President,Hillary Clinton,DEM,580026,6,15,147,168,
Ottawa,U.S. Senate,James Lankford,REP,580026,24,30,578,632,
Ottawa,U.S. Senate,Robert Murphy,LIB,580026,0,2,19,21,
Ottawa,U.S. Senate,Mike Workman,DEM,580026,6,16,158,180,
Ottawa,U.S. Senate,Mark Beard,IND,580026,0,0,18,18,
Ottawa,U.S. Senate,Sean Braddy,IND,580026,0,1,17,18,
Ottawa,U.S. House,Markwayne Mullin,REP,580026,24,30,567,621,02
Ottawa,U.S. House,Joshua Harris-Till,DEM,580026,5,16,168,189,02
Ottawa,U.S. House,John Mccarthy,IND,580026,2,1,55,58,02
Ottawa,State Senate,Micheal Bergstrom,REP,580026,21,30,551,602,1
Ottawa,State Senate,John Myers,DEM,580026,8,17,239,264,1
Ottawa,State House,Hoguen Apperson,REP,580026,20,26,449,495,7
Ottawa,State House,Ben Loring,DEM,580026,11,20,337,368,7
Ottawa,President,Donald Trump,REP,580028,19,76,766,861,
Ottawa,President,Gary Johnson,LIB,580028,1,3,50,54,
Ottawa,President,Hillary Clinton,DEM,580028,7,24,187,218,
Ottawa,U.S. Senate,James Lankford,REP,580028,20,74,705,799,
Ottawa,U.S. Senate,Robert Murphy,LIB,580028,0,0,27,27,
Ottawa,U.S. Senate,Mike Workman,DEM,580028,7,26,210,243,
Ottawa,U.S. Senate,Mark Beard,IND,580028,0,4,28,32,
Ottawa,U.S. Senate,Sean Braddy,IND,580028,1,0,28,29,
Ottawa,U.S. House,Markwayne Mullin,REP,580028,20,74,694,788,02
Ottawa,U.S. House,Joshua Harris-Till,DEM,580028,8,25,219,252,02
Ottawa,U.S. House,John Mccarthy,IND,580028,0,5,79,84,02
Ottawa,State Senate,Micheal Bergstrom,REP,580028,15,60,632,707,1
Ottawa,State Senate,John Myers,DEM,580028,13,45,363,421,1
Ottawa,State House,Hoguen Apperson,REP,580028,13,45,462,520,7
Ottawa,State House,Ben Loring,DEM,580028,15,59,528,602,7
Ottawa,President,Donald Trump,REP,580031,20,81,566,667,
Ottawa,President,Gary Johnson,LIB,580031,2,6,29,37,
Ottawa,President,Hillary Clinton,DEM,580031,4,36,168,208,
Ottawa,U.S. Senate,James Lankford,REP,580031,19,80,534,633,
Ottawa,U.S. Senate,Robert Murphy,LIB,580031,1,1,10,12,
Ottawa,U.S. Senate,Mike Workman,DEM,580031,5,35,183,223,
Ottawa,U.S. Senate,Mark Beard,IND,580031,1,4,15,20,
Ottawa,U.S. Senate,Sean Braddy,IND,580031,0,1,15,16,
Ottawa,U.S. House,Markwayne Mullin,REP,580031,18,83,537,638,02
Ottawa,U.S. House,Joshua Harris-Till,DEM,580031,4,31,173,208,02
Ottawa,U.S. House,John Mccarthy,IND,580031,4,8,47,59,02
Ottawa,State Senate,Micheal Bergstrom,REP,580031,20,70,480,570,1
Ottawa,State Senate,John Myers,DEM,580031,6,49,274,329,1
Ottawa,State House,Hoguen Apperson,REP,580031,13,39,299,351,7
Ottawa,State House,Ben Loring,DEM,580031,13,81,461,555,7
Ottawa,President,Donald Trump,REP,580034,11,40,411,462,
Ottawa,President,Gary Johnson,LIB,580034,2,0,17,19,
Ottawa,President,Hillary Clinton,DEM,580034,4,10,84,98,
Ottawa,U.S. Senate,James Lankford,REP,580034,13,36,352,401,
Ottawa,U.S. Senate,Robert Murphy,LIB,580034,0,1,18,19,
Ottawa,U.S. Senate,Mike Workman,DEM,580034,4,10,103,117,
Ottawa,U.S. Senate,Mark Beard,IND,580034,0,1,17,18,
Ottawa,U.S. Senate,Sean Braddy,IND,580034,0,0,15,15,
Ottawa,U.S. House,Markwayne Mullin,REP,580034,13,40,371,424,02
Ottawa,U.S. House,Joshua Harris-Till,DEM,580034,4,8,93,105,02
Ottawa,U.S. House,John Mccarthy,IND,580034,0,0,41,41,02
Ottawa,State Senate,Micheal Bergstrom,REP,580034,10,33,330,373,1
Ottawa,State Senate,John Myers,DEM,580034,7,17,175,199,1
Ottawa,State House,Hoguen Apperson,REP,580034,11,28,263,302,7
Ottawa,State House,Ben Loring,DEM,580034,6,22,239,267,7
Pawnee,President,Donald Trump,REP,590104,11,94,399,504,
Pawnee,President,Gary Johnson,LIB,590104,0,1,19,20,
Pawnee,President,Hillary Clinton,DEM,590104,9,36,81,126,
Pawnee,U.S. Senate,James Lankford,REP,590104,12,96,383,491,
Pawnee,U.S. Senate,Robert Murphy,LIB,590104,0,2,8,10,
Pawnee,U.S. Senate,Mike Workman,DEM,590104,9,33,83,125,
Pawnee,U.S. Senate,Mark Beard,IND,590104,0,2,12,14,
Pawnee,U.S. Senate,Sean Braddy,IND,590104,0,0,7,7,
Pawnee,U.S. House,Frank Lucas,REP,590104,9,98,388,495,03
Pawnee,U.S. House,Frankie Robbins,DEM,590104,12,33,100,145,03
Pawnee,President,Donald Trump,REP,590111,4,10,246,260,
Pawnee,President,Gary Johnson,LIB,590111,1,0,8,9,
Pawnee,President,Hillary Clinton,DEM,590111,3,3,65,71,
Pawnee,U.S. Senate,James Lankford,REP,590111,5,12,233,250,
Pawnee,U.S. Senate,Robert Murphy,LIB,590111,0,0,10,10,
Pawnee,U.S. Senate,Mike Workman,DEM,590111,3,1,59,63,
Pawnee,U.S. Senate,Mark Beard,IND,590111,0,0,10,10,
Pawnee,U.S. Senate,Sean Braddy,IND,590111,0,0,4,4,
Pawnee,U.S. House,Frank Lucas,REP,590111,5,11,239,255,03
Pawnee,U.S. House,Frankie Robbins,DEM,590111,3,2,72,77,03
Pawnee,President,Donald Trump,REP,590112,7,6,202,215,
Pawnee,President,Gary Johnson,LIB,590112,0,0,8,8,
Pawnee,President,Hillary Clinton,DEM,590112,2,0,33,35,
Pawnee,U.S. Senate,James Lankford,REP,590112,5,6,178,189,
Pawnee,U.S. Senate,Robert Murphy,LIB,590112,1,0,5,6,
Pawnee,U.S. Senate,Mike Workman,DEM,590112,3,0,41,44,
Pawnee,U.S. Senate,Mark Beard,IND,590112,0,0,8,8,
Pawnee,U.S. Senate,Sean Braddy,IND,590112,0,0,2,2,
Pawnee,U.S. House,Frank Lucas,REP,590112,6,6,180,192,03
Pawnee,U.S. House,Frankie Robbins,DEM,590112,3,0,49,52,03
Pawnee,President,Donald Trump,REP,590118,26,36,629,691,
Pawnee,President,Gary Johnson,LIB,590118,0,1,36,37,
Pawnee,President,Hillary Clinton,DEM,590118,10,15,164,189,
Pawnee,U.S. Senate,James Lankford,REP,590118,28,39,622,689,
Pawnee,U.S. Senate,Robert Murphy,LIB,590118,0,1,21,22,
Pawnee,U.S. Senate,Mike Workman,DEM,590118,7,8,153,168,
Pawnee,U.S. Senate,Mark Beard,IND,590118,0,1,12,13,
Pawnee,U.S. Senate,Sean Braddy,IND,590118,1,2,15,18,
Pawnee,U.S. House,Frank Lucas,REP,590118,30,38,615,683,03
Pawnee,U.S. House,Frankie Robbins,DEM,590118,6,11,200,217,03
Pawnee,President,Donald Trump,REP,590202,26,174,559,759,
Pawnee,President,Gary Johnson,LIB,590202,3,11,46,60,
Pawnee,President,Hillary Clinton,DEM,590202,9,91,245,345,
Pawnee,U.S. Senate,James Lankford,REP,590202,24,168,574,766,
Pawnee,U.S. Senate,Robert Murphy,LIB,590202,0,5,24,29,
Pawnee,U.S. Senate,Mike Workman,DEM,590202,14,93,206,313,
Pawnee,U.S. Senate,Mark Beard,IND,590202,0,5,19,24,
Pawnee,U.S. Senate,Sean Braddy,IND,590202,1,5,29,35,
Pawnee,U.S. House,Frank Lucas,REP,590202,26,178,593,797,03
Pawnee,U.S. House,Frankie Robbins,DEM,590202,13,96,252,361,03
Pawnee,President,Donald Trump,REP,590215,4,3,100,107,
Pawnee,President,Gary Johnson,LIB,590215,0,0,3,3,
Pawnee,President,Hillary Clinton,DEM,590215,0,6,39,45,
Pawnee,U.S. Senate,James Lankford,REP,590215,3,4,105,112,
Pawnee,U.S. Senate,Robert Murphy,LIB,590215,0,0,2,2,
Pawnee,U.S. Senate,Mike Workman,DEM,590215,0,4,32,36,
Pawnee,U.S. Senate,Mark Beard,IND,590215,0,1,1,2,
Pawnee,U.S. Senate,Sean Braddy,IND,590215,0,0,4,4,
Pawnee,U.S. House,Frank Lucas,REP,590215,3,3,101,107,03
Pawnee,U.S. House,Frankie Robbins,DEM,590215,0,6,42,48,03
Pawnee,President,Donald Trump,REP,590217,9,29,502,540,
Pawnee,President,Gary Johnson,LIB,590217,0,1,43,44,
Pawnee,President,Hillary Clinton,DEM,590217,9,7,119,135,
Pawnee,U.S. Senate,James Lankford,REP,590217,12,29,503,544,
Pawnee,U.S. Senate,Robert Murphy,LIB,590217,0,0,25,25,
Pawnee,U.S. Senate,Mike Workman,DEM,590217,7,8,110,125,
Pawnee,U.S. Senate,Mark Beard,IND,590217,0,0,13,13,
Pawnee,U.S. Senate,Sean Braddy,IND,590217,0,0,12,12,
Pawnee,U.S. House,Frank Lucas,REP,590217,13,30,515,558,03
Pawnee,U.S. House,Frankie Robbins,DEM,590217,6,7,140,153,03
Pawnee,President,Donald Trump,REP,590307,31,33,811,875,
Pawnee,President,Gary Johnson,LIB,590307,4,2,41,47,
Pawnee,President,Hillary Clinton,DEM,590307,13,33,169,215,
Pawnee,U.S. Senate,James Lankford,REP,590307,34,31,797,862,
Pawnee,U.S. Senate,Robert Murphy,LIB,590307,3,3,21,27,
Pawnee,U.S. Senate,Mike Workman,DEM,590307,11,28,150,189,
Pawnee,U.S. Senate,Mark Beard,IND,590307,1,3,28,32,
Pawnee,U.S. Senate,Sean Braddy,IND,590307,0,0,17,17,
Pawnee,U.S. House,Frank Lucas,REP,590307,37,32,811,880,03
Pawnee,U.S. House,Frankie Robbins,DEM,590307,11,32,185,228,03
Pawnee,President,Donald Trump,REP,590309,7,4,207,218,
Pawnee,President,Gary Johnson,LIB,590309,0,0,16,16,
Pawnee,President,Hillary Clinton,DEM,590309,2,1,38,41,
Pawnee,U.S. Senate,James Lankford,REP,590309,6,4,200,210,
Pawnee,U.S. Senate,Robert Murphy,LIB,590309,1,0,14,15,
Pawnee,U.S. Senate,Mike Workman,DEM,590309,2,1,43,46,
Pawnee,U.S. Senate,Mark Beard,IND,590309,0,0,3,3,
Pawnee,U.S. Senate,Sean Braddy,IND,590309,0,0,5,5,
Pawnee,U.S. House,Frank Lucas,REP,590309,7,4,205,216,03
Pawnee,U.S. House,Frankie Robbins,DEM,590309,2,1,55,58,03
Pawnee,President,Donald Trump,REP,590314,17,21,522,560,
Pawnee,President,Gary Johnson,LIB,590314,1,0,46,47,
Pawnee,President,Hillary Clinton,DEM,590314,11,3,128,142,
Pawnee,U.S. Senate,James Lankford,REP,590314,16,21,511,548,
Pawnee,U.S. Senate,Robert Murphy,LIB,590314,2,1,32,35,
Pawnee,U.S. Senate,Mike Workman,DEM,590314,10,2,121,133,
Pawnee,U.S. Senate,Mark Beard,IND,590314,1,0,18,19,
Pawnee,U.S. Senate,Sean Braddy,IND,590314,0,0,10,10,
Pawnee,U.S. House,Frank Lucas,REP,590314,18,22,517,557,03
Pawnee,U.S. House,Frankie Robbins,DEM,590314,11,2,157,170,03
Payne,President,Donald Trump,REP,600001,8,16,152,176,
Payne,President,Gary Johnson,LIB,600001,1,5,32,38,
Payne,President,Hillary Clinton,DEM,600001,9,15,119,143,
Payne,U.S. Senate,James Lankford,REP,600001,7,19,167,193,
Payne,U.S. Senate,Robert Murphy,LIB,600001,1,1,21,23,
Payne,U.S. Senate,Mike Workman,DEM,600001,8,13,87,108,
Payne,U.S. Senate,Mark Beard,IND,600001,0,0,8,8,
Payne,U.S. Senate,Sean Braddy,IND,600001,2,4,20,26,
Payne,U.S. House,Frank Lucas,REP,600001,11,20,177,208,03
Payne,U.S. House,Frankie Robbins,DEM,600001,7,17,126,150,03
Payne,President,Donald Trump,REP,600002,15,58,395,468,
Payne,President,Gary Johnson,LIB,600002,5,11,118,134,
Payne,President,Hillary Clinton,DEM,600002,15,61,274,350,
Payne,U.S. Senate,James Lankford,REP,600002,16,67,439,522,
Payne,U.S. Senate,Robert Murphy,LIB,600002,5,8,54,67,
Payne,U.S. Senate,Mike Workman,DEM,600002,9,46,230,285,
Payne,U.S. Senate,Mark Beard,IND,600002,0,2,27,29,
Payne,U.S. Senate,Sean Braddy,IND,600002,4,8,31,43,
Payne,U.S. House,Frank Lucas,REP,600002,20,76,489,585,03
Payne,U.S. House,Frankie Robbins,DEM,600002,14,54,290,358,03
Payne,President,Donald Trump,REP,600003,9,35,197,241,
Payne,President,Gary Johnson,LIB,600003,0,8,41,49,
Payne,President,Hillary Clinton,DEM,600003,7,31,138,176,
Payne,U.S. Senate,James Lankford,REP,600003,8,38,218,264,
Payne,U.S. Senate,Robert Murphy,LIB,600003,0,2,24,26,
Payne,U.S. Senate,Mike Workman,DEM,600003,5,27,111,143,
Payne,U.S. Senate,Mark Beard,IND,600003,0,1,11,12,
Payne,U.S. Senate,Sean Braddy,IND,600003,2,7,16,25,
Payne,U.S. House,Frank Lucas,REP,600003,7,39,244,290,03
Payne,U.S. House,Frankie Robbins,DEM,600003,7,34,133,174,03
Payne,State House,Greg Babinec,REP,600003,3,16,138,157,33
Payne,State House,Erin Adams,LIB,600003,0,11,38,49,33
Payne,State House,Caryl Talley,DEM,600003,11,48,203,262,33
Payne,President,Donald Trump,REP,600004,27,121,469,617,
Payne,President,Gary Johnson,LIB,600004,9,25,86,120,
Payne,President,Hillary Clinton,DEM,600004,34,153,317,504,
Payne,U.S. Senate,James Lankford,REP,600004,46,144,556,746,
Payne,U.S. Senate,Robert Murphy,LIB,600004,4,12,39,55,
Payne,U.S. Senate,Mike Workman,DEM,600004,23,128,247,398,
Payne,U.S. Senate,Mark Beard,IND,600004,0,7,23,30,
Payne,U.S. Senate,Sean Braddy,IND,600004,3,6,18,27,
Payne,U.S. House,Frank Lucas,REP,600004,49,152,575,776,03
Payne,U.S. House,Frankie Robbins,DEM,600004,27,147,302,476,03
Payne,President,Donald Trump,REP,600005,12,27,123,162,
Payne,President,Gary Johnson,LIB,600005,0,1,16,17,
Payne,President,Hillary Clinton,DEM,600005,0,28,50,78,
Payne,U.S. Senate,James Lankford,REP,600005,11,31,135,177,
Payne,U.S. Senate,Robert Murphy,LIB,600005,1,3,13,17,
Payne,U.S. Senate,Mike Workman,DEM,600005,0,21,37,58,
Payne,U.S. Senate,Mark Beard,IND,600005,0,1,2,3,
Payne,U.S. Senate,Sean Braddy,IND,600005,0,1,6,7,
Payne,U.S. House,Frank Lucas,REP,600005,10,31,143,184,03
Payne,U.S. House,Frankie Robbins,DEM,600005,2,26,48,76,03
Payne,President,Donald Trump,REP,600006,22,142,548,712,
Payne,President,Gary Johnson,LIB,600006,5,15,120,140,
Payne,President,Hillary Clinton,DEM,600006,33,149,396,578,
Payne,U.S. Senate,James Lankford,REP,600006,33,166,599,798,
Payne,U.S. Senate,Robert Murphy,LIB,600006,4,10,69,83,
Payne,U.S. Senate,Mike Workman,DEM,600006,18,124,334,476,
Payne,U.S. Senate,Mark Beard,IND,600006,1,5,25,31,
Payne,U.S. Senate,Sean Braddy,IND,600006,2,3,42,47,
Payne,U.S. House,Frank Lucas,REP,600006,37,170,646,853,03
Payne,U.S. House,Frankie Robbins,DEM,600006,22,133,419,574,03
Payne,President,Donald Trump,REP,600007,6,18,178,202,
Payne,President,Gary Johnson,LIB,600007,2,16,82,100,
Payne,President,Hillary Clinton,DEM,600007,13,40,224,277,
Payne,U.S. Senate,James Lankford,REP,600007,8,16,202,226,
Payne,U.S. Senate,Robert Murphy,LIB,600007,3,11,45,59,
Payne,U.S. Senate,Mike Workman,DEM,600007,10,44,193,247,
Payne,U.S. Senate,Mark Beard,IND,600007,0,2,18,20,
Payne,U.S. Senate,Sean Braddy,IND,600007,2,1,32,35,
Payne,U.S. House,Frank Lucas,REP,600007,8,25,234,267,03
Payne,U.S. House,Frankie Robbins,DEM,600007,14,50,248,312,03
Payne,President,Donald Trump,REP,600008,17,62,228,307,
Payne,President,Gary Johnson,LIB,600008,2,14,66,82,
Payne,President,Hillary Clinton,DEM,600008,32,84,272,388,
Payne,U.S. Senate,James Lankford,REP,600008,20,65,265,350,
Payne,U.S. Senate,Robert Murphy,LIB,600008,3,13,39,55,
Payne,U.S. Senate,Mike Workman,DEM,600008,26,66,210,302,
Payne,U.S. Senate,Mark Beard,IND,600008,0,6,13,19,
Payne,U.S. Senate,Sean Braddy,IND,600008,2,9,37,48,
Payne,U.S. House,Frank Lucas,REP,600008,24,68,291,383,03
Payne,U.S. House,Frankie Robbins,DEM,600008,27,90,271,388,03
Payne,President,Donald Trump,REP,600009,39,169,520,728,
Payne,President,Gary Johnson,LIB,600009,8,13,103,124,
Payne,President,Hillary Clinton,DEM,600009,51,169,340,560,
Payne,U.S. Senate,James Lankford,REP,600009,51,199,622,872,
Payne,U.S. Senate,Robert Murphy,LIB,600009,3,2,55,60,
Payne,U.S. Senate,Mike Workman,DEM,600009,36,136,269,441,
Payne,U.S. Senate,Mark Beard,IND,600009,2,6,9,17,
Payne,U.S. Senate,Sean Braddy,IND,600009,4,6,14,24,
Payne,U.S. House,Frank Lucas,REP,600009,57,205,654,916,03
Payne,U.S. House,Frankie Robbins,DEM,600009,40,143,309,492,03
Payne,State House,Greg Babinec,REP,600009,36,113,363,512,33
Payne,State House,Erin Adams,LIB,600009,1,10,51,62,33
Payne,State House,Caryl Talley,DEM,600009,60,226,555,841,33
Payne,President,Donald Trump,REP,600010,13,25,234,272,
Payne,President,Gary Johnson,LIB,600010,4,7,68,79,
Payne,President,Hillary Clinton,DEM,600010,25,53,285,363,
Payne,U.S. Senate,James Lankford,REP,600010,14,32,288,334,
Payne,U.S. Senate,Robert Murphy,LIB,600010,4,2,32,38,
Payne,U.S. Senate,Mike Workman,DEM,600010,19,46,212,277,
Payne,U.S. Senate,Mark Beard,IND,600010,0,0,26,26,
Payne,U.S. Senate,Sean Braddy,IND,600010,4,2,31,37,
Payne,U.S. House,Frank Lucas,REP,600010,14,33,324,371,03
Payne,U.S. House,Frankie Robbins,DEM,600010,25,48,262,335,03
Payne,President,Donald Trump,REP,600011,12,35,160,207,
Payne,President,Gary Johnson,LIB,600011,5,4,34,43,
Payne,President,Hillary Clinton,DEM,600011,18,33,113,164,
Payne,U.S. Senate,James Lankford,REP,600011,16,46,189,251,
Payne,U.S. Senate,Robert Murphy,LIB,600011,2,3,16,21,
Payne,U.S. Senate,Mike Workman,DEM,600011,13,21,88,122,
Payne,U.S. Senate,Mark Beard,IND,600011,2,1,3,6,
Payne,U.S. Senate,Sean Braddy,IND,600011,0,2,6,8,
Payne,U.S. House,Frank Lucas,REP,600011,19,47,197,263,03
Payne,U.S. House,Frankie Robbins,DEM,600011,14,27,99,140,03
Payne,President,Donald Trump,REP,600012,4,27,161,192,
Payne,President,Gary Johnson,LIB,600012,4,4,63,71,
Payne,President,Hillary Clinton,DEM,600012,13,33,206,252,
Payne,U.S. Senate,James Lankford,REP,600012,10,32,208,250,
Payne,U.S. Senate,Robert Murphy,LIB,600012,1,2,39,42,
Payne,U.S. Senate,Mike Workman,DEM,600012,7,27,138,172,
Payne,U.S. Senate,Mark Beard,IND,600012,0,0,15,15,
Payne,U.S. Senate,Sean Braddy,IND,600012,2,2,29,33,
Payne,U.S. House,Frank Lucas,REP,600012,14,37,230,281,03
Payne,U.S. House,Frankie Robbins,DEM,600012,6,27,195,228,03
Payne,President,Donald Trump,REP,600013,40,136,587,763,
Payne,President,Gary Johnson,LIB,600013,12,24,97,133,
Payne,President,Hillary Clinton,DEM,600013,32,139,371,542,
Payne,U.S. Senate,James Lankford,REP,600013,45,156,663,864,
Payne,U.S. Senate,Robert Murphy,LIB,600013,3,15,62,80,
Payne,U.S. Senate,Mike Workman,DEM,600013,30,116,283,429,
Payne,U.S. Senate,Mark Beard,IND,600013,0,1,18,19,
Payne,U.S. Senate,Sean Braddy,IND,600013,4,9,33,46,
Payne,U.S. House,Frank Lucas,REP,600013,47,171,707,925,03
Payne,U.S. House,Frankie Robbins,DEM,600013,36,126,350,512,03
Payne,President,Donald Trump,REP,600014,0,2,23,25,
Payne,President,Gary Johnson,LIB,600014,0,0,3,3,
Payne,President,Hillary Clinton,DEM,600014,4,2,27,33,
Payne,U.S. Senate,James Lankford,REP,600014,0,2,21,23,
Payne,U.S. Senate,Robert Murphy,LIB,600014,1,0,3,4,
Payne,U.S. Senate,Mike Workman,DEM,600014,3,2,24,29,
Payne,U.S. Senate,Mark Beard,IND,600014,0,0,1,1,
Payne,U.S. Senate,Sean Braddy,IND,600014,0,0,2,2,
Payne,U.S. House,Frank Lucas,REP,600014,0,2,25,27,03
Payne,U.S. House,Frankie Robbins,DEM,600014,4,2,26,32,03
Payne,State House,Greg Babinec,REP,600014,0,1,19,20,33
Payne,State House,Erin Adams,LIB,600014,1,0,5,6,33
Payne,State House,Caryl Talley,DEM,600014,3,3,26,32,33
Payne,President,Donald Trump,REP,600015,13,62,260,335,
Payne,President,Gary Johnson,LIB,600015,2,14,76,92,
Payne,President,Hillary Clinton,DEM,600015,28,75,310,413,
Payne,U.S. Senate,James Lankford,REP,600015,13,74,317,404,
Payne,U.S. Senate,Robert Murphy,LIB,600015,0,4,54,58,
Payne,U.S. Senate,Mike Workman,DEM,600015,25,66,230,321,
Payne,U.S. Senate,Mark Beard,IND,600015,1,3,17,21,
Payne,U.S. Senate,Sean Braddy,IND,600015,3,3,22,28,
Payne,U.S. House,Frank Lucas,REP,600015,15,83,352,450,03
Payne,U.S. House,Frankie Robbins,DEM,600015,27,66,283,376,03
Payne,President,Donald Trump,REP,600016,78,375,774,1227,
Payne,President,Gary Johnson,LIB,600016,17,44,125,186,
Payne,President,Hillary Clinton,DEM,600016,106,290,462,858,
Payne,U.S. Senate,James Lankford,REP,600016,109,435,906,1450,
Payne,U.S. Senate,Robert Murphy,LIB,600016,8,19,65,92,
Payne,U.S. Senate,Mike Workman,DEM,600016,73,247,343,663,
Payne,U.S. Senate,Mark Beard,IND,600016,2,4,19,25,
Payne,U.S. Senate,Sean Braddy,IND,600016,7,11,48,66,
Payne,U.S. House,Frank Lucas,REP,600016,128,461,949,1538,03
Payne,U.S. House,Frankie Robbins,DEM,600016,74,249,422,745,03
Payne,President,Donald Trump,REP,600101,25,32,612,669,
Payne,President,Gary Johnson,LIB,600101,5,4,49,58,
Payne,President,Hillary Clinton,DEM,600101,9,18,158,185,
Payne,U.S. Senate,James Lankford,REP,600101,24,34,612,670,
Payne,U.S. Senate,Robert Murphy,LIB,600101,0,3,35,38,
Payne,U.S. Senate,Mike Workman,DEM,600101,10,16,131,157,
Payne,U.S. Senate,Mark Beard,IND,600101,1,0,20,21,
Payne,U.S. Senate,Sean Braddy,IND,600101,4,0,22,26,
Payne,U.S. House,Frank Lucas,REP,600101,24,36,631,691,03
Payne,U.S. House,Frankie Robbins,DEM,600101,15,18,183,216,03
Payne,State House,Greg Babinec,REP,600101,22,28,555,605,33
Payne,State House,Erin Adams,LIB,600101,4,2,48,54,33
Payne,State House,Caryl Talley,DEM,600101,12,25,215,252,33
Payne,President,Donald Trump,REP,600102,26,25,612,663,
Payne,President,Gary Johnson,LIB,600102,3,1,57,61,
Payne,President,Hillary Clinton,DEM,600102,15,10,151,176,
Payne,U.S. Senate,James Lankford,REP,600102,27,26,624,677,
Payne,U.S. Senate,Robert Murphy,LIB,600102,3,0,34,37,
Payne,U.S. Senate,Mike Workman,DEM,600102,14,11,121,146,
Payne,U.S. Senate,Mark Beard,IND,600102,0,1,15,16,
Payne,U.S. Senate,Sean Braddy,IND,600102,0,0,24,24,
Payne,U.S. House,Frank Lucas,REP,600102,27,27,638,692,03
Payne,U.S. House,Frankie Robbins,DEM,600102,17,10,177,204,03
Payne,State House,Greg Babinec,REP,600102,28,24,558,610,33
Payne,State House,Erin Adams,LIB,600102,1,0,43,44,33
Payne,State House,Caryl Talley,DEM,600102,15,14,220,249,33
Payne,President,Donald Trump,REP,600103,22,27,604,653,
Payne,President,Gary Johnson,LIB,600103,2,0,49,51,
Payne,President,Hillary Clinton,DEM,600103,17,7,159,183,
Payne,U.S. Senate,James Lankford,REP,600103,28,25,623,676,
Payne,U.S. Senate,Robert Murphy,LIB,600103,0,2,38,40,
Payne,U.S. Senate,Mike Workman,DEM,600103,12,7,116,135,
Payne,U.S. Senate,Mark Beard,IND,600103,0,0,19,19,
Payne,U.S. Senate,Sean Braddy,IND,600103,2,0,15,17,
Payne,U.S. House,Frank Lucas,REP,600103,30,27,643,700,03
Payne,U.S. House,Frankie Robbins,DEM,600103,12,7,157,176,03
Payne,State House,Greg Babinec,REP,600103,25,22,559,606,33
Payne,State House,Erin Adams,LIB,600103,0,3,43,46,33
Payne,State House,Caryl Talley,DEM,600103,17,8,212,237,33
Payne,President,Donald Trump,REP,600104,17,19,721,757,
Payne,President,Gary Johnson,LIB,600104,2,1,36,39,
Payne,President,Hillary Clinton,DEM,600104,14,7,118,139,
Payne,U.S. Senate,James Lankford,REP,600104,21,19,741,781,
Payne,U.S. Senate,Robert Murphy,LIB,600104,0,0,16,16,
Payne,U.S. Senate,Mike Workman,DEM,600104,13,7,98,118,
Payne,U.S. Senate,Mark Beard,IND,600104,0,1,10,11,
Payne,U.S. Senate,Sean Braddy,IND,600104,0,0,7,7,
Payne,U.S. House,Frank Lucas,REP,600104,21,19,737,777,03
Payne,U.S. House,Frankie Robbins,DEM,600104,13,8,132,153,03
Payne,State House,Greg Babinec,REP,600104,23,19,667,709,33
Payne,State House,Erin Adams,LIB,600104,1,1,28,30,33
Payne,State House,Caryl Talley,DEM,600104,10,7,181,198,33
Payne,President,Donald Trump,REP,600201,27,27,669,723,
Payne,President,Gary Johnson,LIB,600201,2,0,39,41,
Payne,President,Hillary Clinton,DEM,600201,11,10,158,179,
Payne,U.S. Senate,James Lankford,REP,600201,28,25,650,703,
Payne,U.S. Senate,Robert Murphy,LIB,600201,0,1,34,35,
Payne,U.S. Senate,Mike Workman,DEM,600201,8,11,136,155,
Payne,U.S. Senate,Mark Beard,IND,600201,0,0,16,16,
Payne,U.S. Senate,Sean Braddy,IND,600201,2,0,24,26,
Payne,U.S. House,Frank Lucas,REP,600201,29,27,663,719,03
Payne,U.S. House,Frankie Robbins,DEM,600201,11,10,192,213,03
Payne,State House,Greg Babinec,REP,600201,25,24,503,552,33
Payne,State House,Erin Adams,LIB,600201,0,0,40,40,33
Payne,State House,Caryl Talley,DEM,600201,14,13,318,345,33
Payne,President,Donald Trump,REP,600301,59,144,1276,1479,
Payne,President,Gary Johnson,LIB,600301,10,16,107,133,
Payne,President,Hillary Clinton,DEM,600301,23,52,311,386,
Payne,U.S. Senate,James Lankford,REP,600301,67,149,1320,1536,
Payne,U.S. Senate,Robert Murphy,LIB,600301,3,10,55,68,
Payne,U.S. Senate,Mike Workman,DEM,600301,20,47,253,320,
Payne,U.S. Senate,Mark Beard,IND,600301,1,2,33,36,
Payne,U.S. Senate,Sean Braddy,IND,600301,1,4,32,37,
Payne,U.S. House,Frank Lucas,REP,600301,69,158,1363,1590,03
Payne,U.S. House,Frankie Robbins,DEM,600301,22,53,324,399,03
Payne,State House,Greg Babinec,REP,600301,52,106,841,999,33
Payne,State House,Erin Adams,LIB,600301,5,6,78,89,33
Payne,State House,Caryl Talley,DEM,600301,31,102,769,902,33
Payne,President,Donald Trump,REP,600401,70,245,858,1173,
Payne,President,Gary Johnson,LIB,600401,8,27,120,155,
Payne,President,Hillary Clinton,DEM,600401,70,180,405,655,
Payne,U.S. Senate,James Lankford,REP,600401,84,294,974,1352,
Payne,U.S. Senate,Robert Murphy,LIB,600401,4,14,57,75,
Payne,U.S. Senate,Mike Workman,DEM,600401,53,128,312,493,
Payne,U.S. Senate,Mark Beard,IND,600401,2,3,24,29,
Payne,U.S. Senate,Sean Braddy,IND,600401,4,18,27,49,
Payne,U.S. House,Frank Lucas,REP,600401,86,309,1016,1411,03
Payne,U.S. House,Frankie Robbins,DEM,600401,61,143,370,574,03
Payne,State House,Greg Babinec,REP,600401,56,180,575,811,33
Payne,State House,Erin Adams,LIB,600401,3,12,83,98,33
Payne,State House,Caryl Talley,DEM,600401,86,263,727,1076,33
Payne,President,Donald Trump,REP,600402,29,83,359,471,
Payne,President,Gary Johnson,LIB,600402,0,17,43,60,
Payne,President,Hillary Clinton,DEM,600402,24,58,136,218,
Payne,U.S. Senate,James Lankford,REP,600402,31,105,393,529,
Payne,U.S. Senate,Robert Murphy,LIB,600402,1,5,28,34,
Payne,U.S. Senate,Mike Workman,DEM,600402,22,45,107,174,
Payne,U.S. Senate,Mark Beard,IND,600402,0,2,9,11,
Payne,U.S. Senate,Sean Braddy,IND,600402,0,3,13,16,
Payne,U.S. House,Frank Lucas,REP,600402,34,111,421,566,03
Payne,U.S. House,Frankie Robbins,DEM,600402,20,49,129,198,03
Payne,State House,Greg Babinec,REP,600402,22,50,221,293,33
Payne,State House,Erin Adams,LIB,600402,1,5,32,38,33
Payne,State House,Caryl Talley,DEM,600402,30,106,296,432,33
Payne,President,Donald Trump,REP,600403,10,75,386,471,
Payne,President,Gary Johnson,LIB,600403,3,10,40,53,
Payne,President,Hillary Clinton,DEM,600403,14,41,104,159,
Payne,U.S. Senate,James Lankford,REP,600403,13,85,419,517,
Payne,U.S. Senate,Robert Murphy,LIB,600403,0,3,17,20,
Payne,U.S. Senate,Mike Workman,DEM,600403,12,35,83,130,
Payne,U.S. Senate,Mark Beard,IND,600403,1,0,8,9,
Payne,U.S. Senate,Sean Braddy,IND,600403,1,2,12,15,
Payne,U.S. House,Frank Lucas,REP,600403,13,90,439,542,03
Payne,U.S. House,Frankie Robbins,DEM,600403,14,35,97,146,03
Payne,President,Donald Trump,REP,600404,3,19,83,105,
Payne,President,Gary Johnson,LIB,600404,0,5,15,20,
Payne,President,Hillary Clinton,DEM,600404,1,10,33,44,
Payne,U.S. Senate,James Lankford,REP,600404,3,21,92,116,
Payne,U.S. Senate,Robert Murphy,LIB,600404,0,2,12,14,
Payne,U.S. Senate,Mike Workman,DEM,600404,1,9,18,28,
Payne,U.S. Senate,Mark Beard,IND,600404,1,1,2,4,
Payne,U.S. Senate,Sean Braddy,IND,600404,0,2,7,9,
Payne,U.S. House,Frank Lucas,REP,600404,2,25,101,128,03
Payne,U.S. House,Frankie Robbins,DEM,600404,3,9,29,41,03
Payne,President,Donald Trump,REP,600405,23,107,634,764,
Payne,President,Gary Johnson,LIB,600405,6,12,47,65,
Payne,President,Hillary Clinton,DEM,600405,24,51,153,228,
Payne,U.S. Senate,James Lankford,REP,600405,31,119,669,819,
Payne,U.S. Senate,Robert Murphy,LIB,600405,2,8,22,32,
Payne,U.S. Senate,Mike Workman,DEM,600405,19,35,116,170,
Payne,U.S. Senate,Mark Beard,IND,600405,0,5,9,14,
Payne,U.S. Senate,Sean Braddy,IND,600405,0,0,17,17,
Payne,U.S. House,Frank Lucas,REP,600405,32,128,671,831,03
Payne,U.S. House,Frankie Robbins,DEM,600405,20,40,159,219,03
Payne,State House,Greg Babinec,REP,600405,18,69,410,497,33
Payne,State House,Erin Adams,LIB,600405,1,10,35,46,33
Payne,State House,Caryl Talley,DEM,600405,32,88,388,508,33
Payne,President,Donald Trump,REP,600406,27,48,543,618,
Payne,President,Gary Johnson,LIB,600406,1,5,27,33,
Payne,President,Hillary Clinton,DEM,600406,12,19,110,141,
Payne,U.S. Senate,James Lankford,REP,600406,27,56,535,618,
Payne,U.S. Senate,Robert Murphy,LIB,600406,0,2,21,23,
Payne,U.S. Senate,Mike Workman,DEM,600406,13,14,88,115,
Payne,U.S. Senate,Mark Beard,IND,600406,0,1,9,10,
Payne,U.S. Senate,Sean Braddy,IND,600406,0,0,16,16,
Payne,U.S. House,Frank Lucas,REP,600406,28,57,552,637,03
Payne,U.S. House,Frankie Robbins,DEM,600406,12,14,113,139,03
Payne,President,Donald Trump,REP,600407,21,103,532,656,
Payne,President,Gary Johnson,LIB,600407,2,3,55,60,
Payne,President,Hillary Clinton,DEM,600407,8,42,154,204,
Payne,U.S. Senate,James Lankford,REP,600407,20,120,566,706,
Payne,U.S. Senate,Robert Murphy,LIB,600407,1,1,29,31,
Payne,U.S. Senate,Mike Workman,DEM,600407,8,26,116,150,
Payne,U.S. Senate,Mark Beard,IND,600407,0,2,13,15,
Payne,U.S. Senate,Sean Braddy,IND,600407,0,2,19,21,
Payne,U.S. House,Frank Lucas,REP,600407,22,118,585,725,03
Payne,U.S. House,Frankie Robbins,DEM,600407,7,33,150,190,03
Payne,State House,Greg Babinec,REP,600407,19,75,397,491,33
Payne,State House,Erin Adams,LIB,600407,1,1,50,52,33
Payne,State House,Caryl Talley,DEM,600407,9,73,297,379,33
Payne,President,Donald Trump,REP,600408,0,18,172,190,
Payne,President,Gary Johnson,LIB,600408,1,0,27,28,
Payne,President,Hillary Clinton,DEM,600408,1,7,60,68,
Payne,U.S. Senate,James Lankford,REP,600408,1,18,196,215,
Payne,U.S. Senate,Robert Murphy,LIB,600408,0,1,10,11,
Payne,U.S. Senate,Mike Workman,DEM,600408,0,5,47,52,
Payne,U.S. Senate,Mark Beard,IND,600408,1,0,3,4,
Payne,U.S. Senate,Sean Braddy,IND,600408,0,1,3,4,
Payne,U.S. House,Frank Lucas,REP,600408,1,20,199,220,03
Payne,U.S. House,Frankie Robbins,DEM,600408,1,5,57,63,03
Payne,State House,Greg Babinec,REP,600408,1,14,124,139,33
Payne,State House,Erin Adams,LIB,600408,0,2,16,18,33
Payne,State House,Caryl Talley,DEM,600408,1,9,118,128,33
Payne,President,Donald Trump,REP,600409,23,82,520,625,
Payne,President,Gary Johnson,LIB,600409,4,6,43,53,
Payne,President,Hillary Clinton,DEM,600409,2,27,115,144,
Payne,U.S. Senate,James Lankford,REP,600409,26,80,530,636,
Payne,U.S. Senate,Robert Murphy,LIB,600409,1,2,35,38,
Payne,U.S. Senate,Mike Workman,DEM,600409,1,28,89,118,
Payne,U.S. Senate,Mark Beard,IND,600409,1,0,12,13,
Payne,U.S. Senate,Sean Braddy,IND,600409,0,4,14,18,
Payne,U.S. House,Frank Lucas,REP,600409,26,82,530,638,03
Payne,U.S. House,Frankie Robbins,DEM,600409,3,32,138,173,03
Payne,State House,Greg Babinec,REP,600409,20,67,407,494,33
Payne,State House,Erin Adams,LIB,600409,4,3,41,48,33
Payne,State House,Caryl Talley,DEM,600409,4,45,226,275,33
Pittsburg,President,Donald Trump,REP,610001,2,2,37,41,
Pittsburg,President,Gary Johnson,LIB,610001,0,0,4,4,
Pittsburg,President,Hillary Clinton,DEM,610001,1,3,52,56,
Pittsburg,U.S. Senate,James Lankford,REP,610001,2,2,33,37,
Pittsburg,U.S. Senate,Robert Murphy,LIB,610001,0,0,3,3,
Pittsburg,U.S. Senate,Mike Workman,DEM,610001,1,3,46,50,
Pittsburg,U.S. Senate,Mark Beard,IND,610001,0,0,3,3,
Pittsburg,U.S. Senate,Sean Braddy,IND,610001,0,0,5,5,
Pittsburg,U.S. House,Markwayne Mullin,REP,610001,2,2,31,35,02
Pittsburg,U.S. House,Joshua Harris-Till,DEM,610001,1,3,47,51,02
Pittsburg,U.S. House,John Mccarthy,IND,610001,0,0,13,13,02
Pittsburg,State Senate,Larry Boggs,REP,610001,2,2,28,32,7
Pittsburg,State Senate,Joel Kerns,DEM,610001,1,3,65,69,7
Pittsburg,State House,Paul Marean,REP,610001,2,2,25,29,17
Pittsburg,State House,Brian Renegar,DEM,610001,1,3,65,69,17
Pittsburg,President,Donald Trump,REP,610003,13,54,349,416,
Pittsburg,President,Gary Johnson,LIB,610003,2,3,33,38,
Pittsburg,President,Hillary Clinton,DEM,610003,12,30,159,201,
Pittsburg,U.S. Senate,James Lankford,REP,610003,16,52,319,387,
Pittsburg,U.S. Senate,Robert Murphy,LIB,610003,1,1,12,14,
Pittsburg,U.S. Senate,Mike Workman,DEM,610003,8,27,169,204,
Pittsburg,U.S. Senate,Mark Beard,IND,610003,1,1,20,22,
Pittsburg,U.S. Senate,Sean Braddy,IND,610003,0,3,14,17,
Pittsburg,U.S. House,Markwayne Mullin,REP,610003,15,54,329,398,02
Pittsburg,U.S. House,Joshua Harris-Till,DEM,610003,8,23,162,193,02
Pittsburg,U.S. House,John Mccarthy,IND,610003,2,7,42,51,02
Pittsburg,State Senate,Larry Boggs,REP,610003,14,44,241,299,7
Pittsburg,State Senate,Joel Kerns,DEM,610003,12,42,300,354,7
Pittsburg,State House,Paul Marean,REP,610003,14,37,195,246,17
Pittsburg,State House,Brian Renegar,DEM,610003,12,48,340,400,17
Pittsburg,President,Donald Trump,REP,610004,33,100,549,682,
Pittsburg,President,Gary Johnson,LIB,610004,3,12,43,58,
Pittsburg,President,Hillary Clinton,DEM,610004,9,53,185,247,
Pittsburg,U.S. Senate,James Lankford,REP,610004,34,107,527,668,
Pittsburg,U.S. Senate,Robert Murphy,LIB,610004,0,3,21,24,
Pittsburg,U.S. Senate,Mike Workman,DEM,610004,7,51,187,245,
Pittsburg,U.S. Senate,Mark Beard,IND,610004,1,1,16,18,
Pittsburg,U.S. Senate,Sean Braddy,IND,610004,0,3,21,24,
Pittsburg,U.S. House,Markwayne Mullin,REP,610004,32,104,545,681,02
Pittsburg,U.S. House,Joshua Harris-Till,DEM,610004,8,56,184,248,02
Pittsburg,U.S. House,John Mccarthy,IND,610004,3,6,44,53,02
Pittsburg,State Senate,Larry Boggs,REP,610004,28,79,396,503,7
Pittsburg,State Senate,Joel Kerns,DEM,610004,15,86,380,481,7
Pittsburg,President,Donald Trump,REP,610005,14,40,264,318,
Pittsburg,President,Gary Johnson,LIB,610005,3,1,28,32,
Pittsburg,President,Hillary Clinton,DEM,610005,3,25,108,136,
Pittsburg,U.S. Senate,James Lankford,REP,610005,15,33,250,298,
Pittsburg,U.S. Senate,Robert Murphy,LIB,610005,1,2,20,23,
Pittsburg,U.S. Senate,Mike Workman,DEM,610005,2,25,105,132,
Pittsburg,U.S. Senate,Mark Beard,IND,610005,1,3,15,19,
Pittsburg,U.S. Senate,Sean Braddy,IND,610005,1,2,12,15,
Pittsburg,U.S. House,Markwayne Mullin,REP,610005,14,38,254,306,02
Pittsburg,U.S. House,Joshua Harris-Till,DEM,610005,3,20,110,133,02
Pittsburg,U.S. House,John Mccarthy,IND,610005,2,8,39,49,02
Pittsburg,State Senate,Larry Boggs,REP,610005,15,28,192,235,7
Pittsburg,State Senate,Joel Kerns,DEM,610005,5,38,211,254,7
Pittsburg,President,Donald Trump,REP,610006,19,49,284,352,
Pittsburg,President,Gary Johnson,LIB,610006,1,0,16,17,
Pittsburg,President,Hillary Clinton,DEM,610006,16,20,95,131,
Pittsburg,U.S. Senate,James Lankford,REP,610006,20,48,273,341,
Pittsburg,U.S. Senate,Robert Murphy,LIB,610006,2,2,9,13,
Pittsburg,U.S. Senate,Mike Workman,DEM,610006,10,19,89,118,
Pittsburg,U.S. Senate,Mark Beard,IND,610006,1,0,6,7,
Pittsburg,U.S. Senate,Sean Braddy,IND,610006,0,1,12,13,
Pittsburg,U.S. House,Markwayne Mullin,REP,610006,16,53,268,337,02
Pittsburg,U.S. House,Joshua Harris-Till,DEM,610006,15,16,90,121,02
Pittsburg,U.S. House,John Mccarthy,IND,610006,2,1,30,33,02
Pittsburg,State Senate,Larry Boggs,REP,610006,16,32,190,238,7
Pittsburg,State Senate,Joel Kerns,DEM,610006,17,38,202,257,7
Pittsburg,President,Donald Trump,REP,610007,16,41,298,355,
Pittsburg,President,Gary Johnson,LIB,610007,1,6,19,26,
Pittsburg,President,Hillary Clinton,DEM,610007,13,28,93,134,
Pittsburg,U.S. Senate,James Lankford,REP,610007,15,42,291,348,
Pittsburg,U.S. Senate,Robert Murphy,LIB,610007,1,2,5,8,
Pittsburg,U.S. Senate,Mike Workman,DEM,610007,12,28,98,138,
Pittsburg,U.S. Senate,Mark Beard,IND,610007,1,1,9,11,
Pittsburg,U.S. Senate,Sean Braddy,IND,610007,0,0,5,5,
Pittsburg,U.S. House,Markwayne Mullin,REP,610007,16,44,295,355,02
Pittsburg,U.S. House,Joshua Harris-Till,DEM,610007,12,25,92,129,02
Pittsburg,U.S. House,John Mccarthy,IND,610007,1,4,18,23,02
Pittsburg,State Senate,Larry Boggs,REP,610007,14,30,192,236,7
Pittsburg,State Senate,Joel Kerns,DEM,610007,15,42,221,278,7
Pittsburg,State House,Paul Marean,REP,610007,9,20,133,162,17
Pittsburg,State House,Brian Renegar,DEM,610007,20,52,277,349,17
Pittsburg,President,Donald Trump,REP,610008,15,24,286,325,
Pittsburg,President,Gary Johnson,LIB,610008,0,6,30,36,
Pittsburg,President,Hillary Clinton,DEM,610008,1,22,121,144,
Pittsburg,U.S. Senate,James Lankford,REP,610008,12,26,262,300,
Pittsburg,U.S. Senate,Robert Murphy,LIB,610008,0,2,17,19,
Pittsburg,U.S. Senate,Mike Workman,DEM,610008,3,20,127,150,
Pittsburg,U.S. Senate,Mark Beard,IND,610008,1,2,11,14,
Pittsburg,U.S. Senate,Sean Braddy,IND,610008,0,2,18,20,
Pittsburg,U.S. House,Markwayne Mullin,REP,610008,13,23,272,308,02
Pittsburg,U.S. House,Joshua Harris-Till,DEM,610008,3,24,118,145,02
Pittsburg,U.S. House,John Mccarthy,IND,610008,0,5,41,46,02
Pittsburg,State Senate,Larry Boggs,REP,610008,9,20,192,221,7
Pittsburg,State Senate,Joel Kerns,DEM,610008,7,31,246,284,7
Pittsburg,President,Donald Trump,REP,610011,17,94,557,668,
Pittsburg,President,Gary Johnson,LIB,610011,1,4,48,53,
Pittsburg,President,Hillary Clinton,DEM,610011,16,24,163,203,
Pittsburg,U.S. Senate,James Lankford,REP,610011,16,83,482,581,
Pittsburg,U.S. Senate,Robert Murphy,LIB,610011,2,4,28,34,
Pittsburg,U.S. Senate,Mike Workman,DEM,610011,14,29,197,240,
Pittsburg,U.S. Senate,Mark Beard,IND,610011,2,2,22,26,
Pittsburg,U.S. Senate,Sean Braddy,IND,610011,0,4,25,29,
Pittsburg,U.S. House,Markwayne Mullin,REP,610011,21,83,502,606,02
Pittsburg,U.S. House,Joshua Harris-Till,DEM,610011,13,29,178,220,02
Pittsburg,U.S. House,John Mccarthy,IND,610011,0,9,75,84,02
Pittsburg,State Senate,Larry Boggs,REP,610011,16,67,328,411,7
Pittsburg,State Senate,Joel Kerns,DEM,610011,18,53,436,507,7
Pittsburg,President,Donald Trump,REP,610014,21,71,488,580,
Pittsburg,President,Gary Johnson,LIB,610014,3,3,36,42,
Pittsburg,President,Hillary Clinton,DEM,610014,11,46,138,195,
Pittsburg,U.S. Senate,James Lankford,REP,610014,20,70,442,532,
Pittsburg,U.S. Senate,Robert Murphy,LIB,610014,0,2,11,13,
Pittsburg,U.S. Senate,Mike Workman,DEM,610014,10,47,177,234,
Pittsburg,U.S. Senate,Mark Beard,IND,610014,2,0,14,16,
Pittsburg,U.S. Senate,Sean Braddy,IND,610014,2,0,18,20,
Pittsburg,U.S. House,Markwayne Mullin,REP,610014,19,70,468,557,02
Pittsburg,U.S. House,Joshua Harris-Till,DEM,610014,12,47,161,220,02
Pittsburg,U.S. House,John Mccarthy,IND,610014,4,2,32,38,02
Pittsburg,State Senate,Larry Boggs,REP,610014,20,50,324,394,7
Pittsburg,State Senate,Joel Kerns,DEM,610014,15,69,342,426,7
Pittsburg,State House,Paul Marean,REP,610014,17,34,279,330,17
Pittsburg,State House,Brian Renegar,DEM,610014,18,85,385,488,17
Pittsburg,President,Donald Trump,REP,610015,0,12,74,86,
Pittsburg,President,Gary Johnson,LIB,610015,0,2,6,8,
Pittsburg,President,Hillary Clinton,DEM,610015,2,19,79,100,
Pittsburg,U.S. Senate,James Lankford,REP,610015,0,13,62,75,
Pittsburg,U.S. Senate,Robert Murphy,LIB,610015,0,1,3,4,
Pittsburg,U.S. Senate,Mike Workman,DEM,610015,2,18,75,95,
Pittsburg,U.S. Senate,Mark Beard,IND,610015,0,1,4,5,
Pittsburg,U.S. Senate,Sean Braddy,IND,610015,0,0,10,10,
Pittsburg,U.S. House,Markwayne Mullin,REP,610015,0,10,66,76,02
Pittsburg,U.S. House,Joshua Harris-Till,DEM,610015,2,20,76,98,02
Pittsburg,U.S. House,John Mccarthy,IND,610015,0,3,12,15,02
Pittsburg,State Senate,Larry Boggs,REP,610015,0,12,54,66,7
Pittsburg,State Senate,Joel Kerns,DEM,610015,2,21,103,126,7
Pittsburg,President,Donald Trump,REP,610019,10,9,167,186,
Pittsburg,President,Gary Johnson,LIB,610019,0,1,9,10,
Pittsburg,President,Hillary Clinton,DEM,610019,0,3,39,42,
Pittsburg,U.S. Senate,James Lankford,REP,610019,10,7,148,165,
Pittsburg,U.S. Senate,Robert Murphy,LIB,610019,0,1,6,7,
Pittsburg,U.S. Senate,Mike Workman,DEM,610019,0,5,46,51,
Pittsburg,U.S. Senate,Mark Beard,IND,610019,0,0,9,9,
Pittsburg,U.S. Senate,Sean Braddy,IND,610019,0,0,2,2,
Pittsburg,U.S. House,Markwayne Mullin,REP,610019,7,9,151,167,02
Pittsburg,U.S. House,Joshua Harris-Till,DEM,610019,2,3,39,44,02
Pittsburg,U.S. House,John Mccarthy,IND,610019,1,1,21,23,02
Pittsburg,State Senate,Larry Boggs,REP,610019,8,5,118,131,7
Pittsburg,State Senate,Joel Kerns,DEM,610019,2,8,97,107,7
Pittsburg,State House,Paul Marean,REP,610019,7,5,94,106,17
Pittsburg,State House,Brian Renegar,DEM,610019,3,8,115,126,17
Pittsburg,President,Donald Trump,REP,610020,10,13,79,102,
Pittsburg,President,Gary Johnson,LIB,610020,0,0,2,2,
Pittsburg,President,Hillary Clinton,DEM,610020,0,1,17,18,
Pittsburg,U.S. Senate,James Lankford,REP,610020,10,10,65,85,
Pittsburg,U.S. Senate,Robert Murphy,LIB,610020,0,1,2,3,
Pittsburg,U.S. Senate,Mike Workman,DEM,610020,0,3,24,27,
Pittsburg,U.S. Senate,Mark Beard,IND,610020,0,0,1,1,
Pittsburg,U.S. Senate,Sean Braddy,IND,610020,0,0,4,4,
Pittsburg,U.S. House,Markwayne Mullin,REP,610020,10,9,73,92,02
Pittsburg,U.S. House,Joshua Harris-Till,DEM,610020,0,3,21,24,02
Pittsburg,U.S. House,John Mccarthy,IND,610020,0,2,3,5,02
Pittsburg,State Senate,Larry Boggs,REP,610020,10,6,47,63,7
Pittsburg,State Senate,Joel Kerns,DEM,610020,0,8,50,58,7
Pittsburg,State House,Paul Marean,REP,610020,9,8,30,47,17
Pittsburg,State House,Brian Renegar,DEM,610020,1,6,67,74,17
Pittsburg,President,Donald Trump,REP,610021,13,56,441,510,
Pittsburg,President,Gary Johnson,LIB,610021,0,2,22,24,
Pittsburg,President,Hillary Clinton,DEM,610021,3,16,69,88,
Pittsburg,U.S. Senate,James Lankford,REP,610021,12,50,409,471,
Pittsburg,U.S. Senate,Robert Murphy,LIB,610021,0,4,3,7,
Pittsburg,U.S. Senate,Mike Workman,DEM,610021,4,21,97,122,
Pittsburg,U.S. Senate,Mark Beard,IND,610021,0,1,11,12,
Pittsburg,U.S. Senate,Sean Braddy,IND,610021,0,2,12,14,
Pittsburg,U.S. House,Markwayne Mullin,REP,610021,11,51,411,473,02
Pittsburg,U.S. House,Joshua Harris-Till,DEM,610021,5,20,86,111,02
Pittsburg,U.S. House,John Mccarthy,IND,610021,0,7,32,39,02
Pittsburg,State Senate,Larry Boggs,REP,610021,11,46,252,309,7
Pittsburg,State Senate,Joel Kerns,DEM,610021,5,29,282,316,7
Pittsburg,President,Donald Trump,REP,610023,1,7,102,110,
Pittsburg,President,Gary Johnson,LIB,610023,0,0,7,7,
Pittsburg,President,Hillary Clinton,DEM,610023,0,3,15,18,
Pittsburg,U.S. Senate,James Lankford,REP,610023,1,6,99,106,
Pittsburg,U.S. Senate,Robert Murphy,LIB,610023,0,0,1,1,
Pittsburg,U.S. Senate,Mike Workman,DEM,610023,0,4,17,21,
Pittsburg,U.S. Senate,Mark Beard,IND,610023,0,0,2,2,
Pittsburg,U.S. Senate,Sean Braddy,IND,610023,0,0,2,2,
Pittsburg,U.S. House,Markwayne Mullin,REP,610023,1,7,93,101,02
Pittsburg,U.S. House,Joshua Harris-Till,DEM,610023,0,3,21,24,02
Pittsburg,U.S. House,John Mccarthy,IND,610023,0,0,6,6,02
Pittsburg,State Senate,Larry Boggs,REP,610023,1,4,73,78,7
Pittsburg,State Senate,Joel Kerns,DEM,610023,0,6,52,58,7
Pittsburg,President,Donald Trump,REP,610026,9,23,274,306,
Pittsburg,President,Gary Johnson,LIB,610026,3,0,14,17,
Pittsburg,President,Hillary Clinton,DEM,610026,2,3,59,64,
Pittsburg,U.S. Senate,James Lankford,REP,610026,9,23,254,286,
Pittsburg,U.S. Senate,Robert Murphy,LIB,610026,2,0,8,10,
Pittsburg,U.S. Senate,Mike Workman,DEM,610026,2,4,65,71,
Pittsburg,U.S. Senate,Mark Beard,IND,610026,1,0,9,10,
Pittsburg,U.S. Senate,Sean Braddy,IND,610026,0,1,8,9,
Pittsburg,U.S. House,Markwayne Mullin,REP,610026,11,25,266,302,02
Pittsburg,U.S. House,Joshua Harris-Till,DEM,610026,2,3,56,61,02
Pittsburg,U.S. House,John Mccarthy,IND,610026,1,0,19,20,02
Pittsburg,State Senate,Larry Boggs,REP,610026,6,21,221,248,7
Pittsburg,State Senate,Joel Kerns,DEM,610026,8,7,123,138,7
Pittsburg,State House,Paul Marean,REP,610026,5,18,156,179,17
Pittsburg,State House,Brian Renegar,DEM,610026,9,9,188,206,17
Pittsburg,President,Donald Trump,REP,610027,40,47,692,779,
Pittsburg,President,Gary Johnson,LIB,610027,2,5,30,37,
Pittsburg,President,Hillary Clinton,DEM,610027,11,10,165,186,
Pittsburg,U.S. Senate,James Lankford,REP,610027,38,49,689,776,
Pittsburg,U.S. Senate,Robert Murphy,LIB,610027,2,2,12,16,
Pittsburg,U.S. Senate,Mike Workman,DEM,610027,10,6,160,176,
Pittsburg,U.S. Senate,Mark Beard,IND,610027,0,3,13,16,
Pittsburg,U.S. Senate,Sean Braddy,IND,610027,3,2,14,19,
Pittsburg,U.S. House,Markwayne Mullin,REP,610027,39,49,683,771,02
Pittsburg,U.S. House,Joshua Harris-Till,DEM,610027,10,7,163,180,02
Pittsburg,U.S. House,John Mccarthy,IND,610027,4,6,41,51,02
Pittsburg,State Senate,Larry Boggs,REP,610027,39,41,607,687,7
Pittsburg,State Senate,Joel Kerns,DEM,610027,13,20,278,311,7
Pittsburg,State House,Don Herrold,REP,610027,36,39,508,583,15
Pittsburg,State House,Ed Cannaday,DEM,610027,15,22,366,403,15
Pittsburg,President,Donald Trump,REP,610028,3,6,148,157,
Pittsburg,President,Gary Johnson,LIB,610028,0,0,9,9,
Pittsburg,President,Hillary Clinton,DEM,610028,2,4,48,54,
Pittsburg,U.S. Senate,James Lankford,REP,610028,3,5,147,155,
Pittsburg,U.S. Senate,Robert Murphy,LIB,610028,0,0,4,4,
Pittsburg,U.S. Senate,Mike Workman,DEM,610028,2,5,40,47,
Pittsburg,U.S. Senate,Mark Beard,IND,610028,0,0,4,4,
Pittsburg,U.S. Senate,Sean Braddy,IND,610028,0,0,6,6,
Pittsburg,U.S. House,Markwayne Mullin,REP,610028,3,4,140,147,02
Pittsburg,U.S. House,Joshua Harris-Till,DEM,610028,2,5,41,48,02
Pittsburg,U.S. House,John Mccarthy,IND,610028,0,1,17,18,02
Pittsburg,State Senate,Larry Boggs,REP,610028,4,3,112,119,7
Pittsburg,State Senate,Joel Kerns,DEM,610028,1,7,93,101,7
Pittsburg,President,Donald Trump,REP,610029,6,14,188,208,
Pittsburg,President,Gary Johnson,LIB,610029,2,1,5,8,
Pittsburg,President,Hillary Clinton,DEM,610029,3,3,45,51,
Pittsburg,U.S. Senate,James Lankford,REP,610029,8,13,166,187,
Pittsburg,U.S. Senate,Robert Murphy,LIB,610029,1,0,8,9,
Pittsburg,U.S. Senate,Mike Workman,DEM,610029,2,5,56,63,
Pittsburg,U.S. Senate,Mark Beard,IND,610029,0,0,3,3,
Pittsburg,U.S. Senate,Sean Braddy,IND,610029,0,0,7,7,
Pittsburg,U.S. House,Markwayne Mullin,REP,610029,6,13,179,198,02
Pittsburg,U.S. House,Joshua Harris-Till,DEM,610029,4,5,48,57,02
Pittsburg,U.S. House,John Mccarthy,IND,610029,1,0,12,13,02
Pittsburg,State Senate,Larry Boggs,REP,610029,7,10,139,156,7
Pittsburg,State Senate,Joel Kerns,DEM,610029,4,8,102,114,7
Pittsburg,State House,Paul Marean,REP,610029,4,4,116,124,17
Pittsburg,State House,Brian Renegar,DEM,610029,7,13,124,144,17
Pittsburg,President,Donald Trump,REP,610030,6,4,182,192,
Pittsburg,President,Gary Johnson,LIB,610030,0,0,10,10,
Pittsburg,President,Hillary Clinton,DEM,610030,1,2,37,40,
Pittsburg,U.S. Senate,James Lankford,REP,610030,6,4,170,180,
Pittsburg,U.S. Senate,Robert Murphy,LIB,610030,0,0,2,2,
Pittsburg,U.S. Senate,Mike Workman,DEM,610030,1,2,46,49,
Pittsburg,U.S. Senate,Mark Beard,IND,610030,0,0,2,2,
Pittsburg,U.S. Senate,Sean Braddy,IND,610030,0,0,6,6,
Pittsburg,U.S. House,Markwayne Mullin,REP,610030,5,4,165,174,02
Pittsburg,U.S. House,Joshua Harris-Till,DEM,610030,2,2,46,50,02
Pittsburg,U.S. House,John Mccarthy,IND,610030,0,0,14,14,02
Pittsburg,State Senate,Larry Boggs,REP,610030,6,3,135,144,7
Pittsburg,State Senate,Joel Kerns,DEM,610030,1,3,96,100,7
Pittsburg,State House,Paul Marean,REP,610030,5,3,101,109,17
Pittsburg,State House,Brian Renegar,DEM,610030,2,3,122,127,17
Pittsburg,President,Donald Trump,REP,610031,9,21,296,326,
Pittsburg,President,Gary Johnson,LIB,610031,1,0,20,21,
Pittsburg,President,Hillary Clinton,DEM,610031,4,5,61,70,
Pittsburg,U.S. Senate,James Lankford,REP,610031,11,20,294,325,
Pittsburg,U.S. Senate,Robert Murphy,LIB,610031,0,0,5,5,
Pittsburg,U.S. Senate,Mike Workman,DEM,610031,3,6,69,78,
Pittsburg,U.S. Senate,Mark Beard,IND,610031,0,0,4,4,
Pittsburg,U.S. Senate,Sean Braddy,IND,610031,0,1,5,6,
Pittsburg,U.S. House,Markwayne Mullin,REP,610031,11,21,293,325,02
Pittsburg,U.S. House,Joshua Harris-Till,DEM,610031,3,5,65,73,02
Pittsburg,U.S. House,John Mccarthy,IND,610031,0,1,19,20,02
Pittsburg,State Senate,Larry Boggs,REP,610031,7,19,242,268,7
Pittsburg,State Senate,Joel Kerns,DEM,610031,7,8,134,149,7
Pittsburg,State House,Paul Marean,REP,610031,8,16,223,247,17
Pittsburg,State House,Brian Renegar,DEM,610031,6,11,151,168,17
Pittsburg,President,Donald Trump,REP,610032,37,118,584,739,
Pittsburg,President,Gary Johnson,LIB,610032,3,8,40,51,
Pittsburg,President,Hillary Clinton,DEM,610032,12,50,124,186,
Pittsburg,U.S. Senate,James Lankford,REP,610032,45,127,572,744,
Pittsburg,U.S. Senate,Robert Murphy,LIB,610032,0,3,13,16,
Pittsburg,U.S. Senate,Mike Workman,DEM,610032,7,48,131,186,
Pittsburg,U.S. Senate,Mark Beard,IND,610032,0,0,11,11,
Pittsburg,U.S. Senate,Sean Braddy,IND,610032,0,1,10,11,
Pittsburg,U.S. House,Markwayne Mullin,REP,610032,44,125,569,738,02
Pittsburg,U.S. House,Joshua Harris-Till,DEM,610032,7,51,128,186,02
Pittsburg,U.S. House,John Mccarthy,IND,610032,1,4,39,44,02
Pittsburg,State Senate,Larry Boggs,REP,610032,32,88,380,500,7
Pittsburg,State Senate,Joel Kerns,DEM,610032,19,91,369,479,7
Pittsburg,State House,Paul Marean,REP,610032,22,62,274,358,17
Pittsburg,State House,Brian Renegar,DEM,610032,28,117,470,615,17
Pittsburg,President,Donald Trump,REP,610033,9,15,241,265,
Pittsburg,President,Gary Johnson,LIB,610033,0,0,12,12,
Pittsburg,President,Hillary Clinton,DEM,610033,7,6,68,81,
Pittsburg,U.S. Senate,James Lankford,REP,610033,8,15,222,245,
Pittsburg,U.S. Senate,Robert Murphy,LIB,610033,2,0,8,10,
Pittsburg,U.S. Senate,Mike Workman,DEM,610033,6,6,71,83,
Pittsburg,U.S. Senate,Mark Beard,IND,610033,0,0,5,5,
Pittsburg,U.S. Senate,Sean Braddy,IND,610033,0,0,15,15,
Pittsburg,U.S. House,Markwayne Mullin,REP,610033,9,15,228,252,02
Pittsburg,U.S. House,Joshua Harris-Till,DEM,610033,6,6,64,76,02
Pittsburg,U.S. House,John Mccarthy,IND,610033,1,0,30,31,02
Pittsburg,State Senate,Larry Boggs,REP,610033,6,15,167,188,7
Pittsburg,State Senate,Joel Kerns,DEM,610033,10,6,156,172,7
Pittsburg,State House,Paul Marean,REP,610033,8,11,135,154,17
Pittsburg,State House,Brian Renegar,DEM,610033,7,10,184,201,17
Pittsburg,President,Donald Trump,REP,610034,9,24,401,434,
Pittsburg,President,Gary Johnson,LIB,610034,0,0,29,29,
Pittsburg,President,Hillary Clinton,DEM,610034,2,8,153,163,
Pittsburg,U.S. Senate,James Lankford,REP,610034,8,17,360,385,
Pittsburg,U.S. Senate,Robert Murphy,LIB,610034,0,1,8,9,
Pittsburg,U.S. Senate,Mike Workman,DEM,610034,3,11,188,202,
Pittsburg,U.S. Senate,Mark Beard,IND,610034,0,1,11,12,
Pittsburg,U.S. Senate,Sean Braddy,IND,610034,0,1,15,16,
Pittsburg,U.S. House,Markwayne Mullin,REP,610034,7,20,391,418,02
Pittsburg,U.S. House,Joshua Harris-Till,DEM,610034,4,9,161,174,02
Pittsburg,U.S. House,John Mccarthy,IND,610034,0,1,30,31,02
Pittsburg,State Senate,Larry Boggs,REP,610034,6,16,292,314,7
Pittsburg,State Senate,Joel Kerns,DEM,610034,5,15,295,315,7
Pittsburg,State House,Paul Marean,REP,610034,5,11,254,270,17
Pittsburg,State House,Brian Renegar,DEM,610034,6,20,326,352,17
Pittsburg,President,Donald Trump,REP,610035,8,8,289,305,
Pittsburg,President,Gary Johnson,LIB,610035,2,0,11,13,
Pittsburg,President,Hillary Clinton,DEM,610035,7,6,117,130,
Pittsburg,U.S. Senate,James Lankford,REP,610035,8,7,259,274,
Pittsburg,U.S. Senate,Robert Murphy,LIB,610035,1,0,4,5,
Pittsburg,U.S. Senate,Mike Workman,DEM,610035,7,7,120,134,
Pittsburg,U.S. Senate,Mark Beard,IND,610035,0,0,12,12,
Pittsburg,U.S. Senate,Sean Braddy,IND,610035,0,0,15,15,
Pittsburg,U.S. House,Markwayne Mullin,REP,610035,7,7,268,282,02
Pittsburg,U.S. House,Joshua Harris-Till,DEM,610035,6,7,120,133,02
Pittsburg,U.S. House,John Mccarthy,IND,610035,1,0,24,25,02
Pittsburg,State Senate,Larry Boggs,REP,610035,5,6,191,202,7
Pittsburg,State Senate,Joel Kerns,DEM,610035,11,8,222,241,7
Pittsburg,State House,Paul Marean,REP,610035,5,5,163,173,17
Pittsburg,State House,Brian Renegar,DEM,610035,10,9,247,266,17
Pittsburg,President,Donald Trump,REP,610036,2,16,108,126,
Pittsburg,President,Gary Johnson,LIB,610036,0,1,16,17,
Pittsburg,President,Hillary Clinton,DEM,610036,5,4,25,34,
Pittsburg,U.S. Senate,James Lankford,REP,610036,2,17,115,134,
Pittsburg,U.S. Senate,Robert Murphy,LIB,610036,0,0,3,3,
Pittsburg,U.S. Senate,Mike Workman,DEM,610036,5,5,26,36,
Pittsburg,U.S. Senate,Mark Beard,IND,610036,0,0,3,3,
Pittsburg,U.S. Senate,Sean Braddy,IND,610036,0,0,2,2,
Pittsburg,U.S. House,Markwayne Mullin,REP,610036,2,19,115,136,02
Pittsburg,U.S. House,Joshua Harris-Till,DEM,610036,4,4,23,31,02
Pittsburg,U.S. House,John Mccarthy,IND,610036,0,0,11,11,02
Pittsburg,State Senate,Larry Boggs,REP,610036,1,11,82,94,7
Pittsburg,State Senate,Joel Kerns,DEM,610036,6,12,71,89,7
Pittsburg,President,Donald Trump,REP,610037,17,43,518,578,
Pittsburg,President,Gary Johnson,LIB,610037,0,2,16,18,
Pittsburg,President,Hillary Clinton,DEM,610037,4,3,105,112,
Pittsburg,U.S. Senate,James Lankford,REP,610037,18,40,474,532,
Pittsburg,U.S. Senate,Robert Murphy,LIB,610037,0,0,11,11,
Pittsburg,U.S. Senate,Mike Workman,DEM,610037,2,6,131,139,
Pittsburg,U.S. Senate,Mark Beard,IND,610037,0,1,7,8,
Pittsburg,U.S. Senate,Sean Braddy,IND,610037,0,2,12,14,
Pittsburg,U.S. House,Markwayne Mullin,REP,610037,18,42,484,544,02
Pittsburg,U.S. House,Joshua Harris-Till,DEM,610037,2,5,111,118,02
Pittsburg,U.S. House,John Mccarthy,IND,610037,0,1,35,36,02
Pittsburg,State Senate,Larry Boggs,REP,610037,14,22,340,376,7
Pittsburg,State Senate,Joel Kerns,DEM,610037,7,26,301,334,7
Pittsburg,President,Donald Trump,REP,610038,0,9,33,42,
Pittsburg,President,Gary Johnson,LIB,610038,0,0,0,0,
Pittsburg,President,Hillary Clinton,DEM,610038,2,0,3,5,
Pittsburg,U.S. Senate,James Lankford,REP,610038,0,9,28,37,
Pittsburg,U.S. Senate,Robert Murphy,LIB,610038,0,0,2,2,
Pittsburg,U.S. Senate,Mike Workman,DEM,610038,2,0,5,7,
Pittsburg,U.S. Senate,Mark Beard,IND,610038,0,0,0,0,
Pittsburg,U.S. Senate,Sean Braddy,IND,610038,0,0,1,1,
Pittsburg,U.S. House,Markwayne Mullin,REP,610038,0,9,29,38,02
Pittsburg,U.S. House,Joshua Harris-Till,DEM,610038,2,0,6,8,02
Pittsburg,U.S. House,John Mccarthy,IND,610038,0,0,0,0,02
Pittsburg,State Senate,Larry Boggs,REP,610038,0,6,25,31,7
Pittsburg,State Senate,Joel Kerns,DEM,610038,2,3,11,16,7
Pittsburg,State House,Paul Marean,REP,610038,0,6,21,27,17
Pittsburg,State House,Brian Renegar,DEM,610038,2,3,15,20,17
Pittsburg,President,Donald Trump,REP,610039,7,10,347,364,
Pittsburg,President,Gary Johnson,LIB,610039,1,0,22,23,
Pittsburg,President,Hillary Clinton,DEM,610039,2,4,65,71,
Pittsburg,U.S. Senate,James Lankford,REP,610039,7,10,317,334,
Pittsburg,U.S. Senate,Robert Murphy,LIB,610039,1,0,10,11,
Pittsburg,U.S. Senate,Mike Workman,DEM,610039,2,4,88,94,
Pittsburg,U.S. Senate,Mark Beard,IND,610039,0,0,7,7,
Pittsburg,U.S. Senate,Sean Braddy,IND,610039,0,0,7,7,
Pittsburg,U.S. House,Markwayne Mullin,REP,610039,8,10,327,345,02
Pittsburg,U.S. House,Joshua Harris-Till,DEM,610039,2,4,74,80,02
Pittsburg,U.S. House,John Mccarthy,IND,610039,0,0,27,27,02
Pittsburg,State Senate,Larry Boggs,REP,610039,4,7,223,234,7
Pittsburg,State Senate,Joel Kerns,DEM,610039,6,7,211,224,7
Pittsburg,President,Donald Trump,REP,610040,11,33,245,289,
Pittsburg,President,Gary Johnson,LIB,610040,2,1,18,21,
Pittsburg,President,Hillary Clinton,DEM,610040,3,4,48,55,
Pittsburg,U.S. Senate,James Lankford,REP,610040,12,32,231,275,
Pittsburg,U.S. Senate,Robert Murphy,LIB,610040,0,1,7,8,
Pittsburg,U.S. Senate,Mike Workman,DEM,610040,3,3,60,66,
Pittsburg,U.S. Senate,Mark Beard,IND,610040,0,0,2,2,
Pittsburg,U.S. Senate,Sean Braddy,IND,610040,1,2,8,11,
Pittsburg,U.S. House,Markwayne Mullin,REP,610040,13,34,233,280,02
Pittsburg,U.S. House,Joshua Harris-Till,DEM,610040,3,2,56,61,02
Pittsburg,U.S. House,John Mccarthy,IND,610040,0,2,16,18,02
Pittsburg,State Senate,Larry Boggs,REP,610040,4,21,172,197,7
Pittsburg,State Senate,Joel Kerns,DEM,610040,12,17,139,168,7
Pittsburg,State House,Paul Marean,REP,610040,5,28,103,136,17
Pittsburg,State House,Brian Renegar,DEM,610040,11,10,205,226,17
Pittsburg,President,Donald Trump,REP,610041,9,47,498,554,
Pittsburg,President,Gary Johnson,LIB,610041,2,2,51,55,
Pittsburg,President,Hillary Clinton,DEM,610041,5,13,141,159,
Pittsburg,U.S. Senate,James Lankford,REP,610041,11,49,452,512,
Pittsburg,U.S. Senate,Robert Murphy,LIB,610041,0,2,18,20,
Pittsburg,U.S. Senate,Mike Workman,DEM,610041,4,11,175,190,
Pittsburg,U.S. Senate,Mark Beard,IND,610041,2,0,17,19,
Pittsburg,U.S. Senate,Sean Braddy,IND,610041,0,0,23,23,
Pittsburg,U.S. House,Markwayne Mullin,REP,610041,11,47,462,520,02
Pittsburg,U.S. House,Joshua Harris-Till,DEM,610041,3,11,163,177,02
Pittsburg,U.S. House,John Mccarthy,IND,610041,3,4,56,63,02
Pittsburg,State Senate,Larry Boggs,REP,610041,9,31,323,363,7
Pittsburg,State Senate,Joel Kerns,DEM,610041,7,31,367,405,7
Pittsburg,State House,Paul Marean,REP,610041,9,23,251,283,17
Pittsburg,State House,Brian Renegar,DEM,610041,8,39,434,481,17
Pittsburg,President,Donald Trump,REP,610042,6,82,319,407,
Pittsburg,President,Gary Johnson,LIB,610042,2,5,12,19,
Pittsburg,President,Hillary Clinton,DEM,610042,9,31,69,109,
Pittsburg,U.S. Senate,James Lankford,REP,610042,10,75,282,367,
Pittsburg,U.S. Senate,Robert Murphy,LIB,610042,1,0,7,8,
Pittsburg,U.S. Senate,Mike Workman,DEM,610042,8,36,88,132,
Pittsburg,U.S. Senate,Mark Beard,IND,610042,0,3,10,13,
Pittsburg,U.S. Senate,Sean Braddy,IND,610042,0,1,7,8,
Pittsburg,U.S. House,Markwayne Mullin,REP,610042,9,79,301,389,02
Pittsburg,U.S. House,Joshua Harris-Till,DEM,610042,9,32,71,112,02
Pittsburg,U.S. House,John Mccarthy,IND,610042,1,5,22,28,02
Pittsburg,State Senate,Larry Boggs,REP,610042,10,54,191,255,7
Pittsburg,State Senate,Joel Kerns,DEM,610042,9,64,208,281,7
Pittsburg,State House,Paul Marean,REP,610042,6,44,159,209,17
Pittsburg,State House,Brian Renegar,DEM,610042,13,75,239,327,17
Pittsburg,President,Donald Trump,REP,610043,2,8,254,264,
Pittsburg,President,Gary Johnson,LIB,610043,0,0,12,12,
Pittsburg,President,Hillary Clinton,DEM,610043,2,3,54,59,
Pittsburg,U.S. Senate,James Lankford,REP,610043,3,8,208,219,
Pittsburg,U.S. Senate,Robert Murphy,LIB,610043,0,0,10,10,
Pittsburg,U.S. Senate,Mike Workman,DEM,610043,1,2,78,81,
Pittsburg,U.S. Senate,Mark Beard,IND,610043,0,0,7,7,
Pittsburg,U.S. Senate,Sean Braddy,IND,610043,0,1,10,11,
Pittsburg,U.S. House,Markwayne Mullin,REP,610043,3,8,240,251,02
Pittsburg,U.S. House,Joshua Harris-Till,DEM,610043,1,3,54,58,02
Pittsburg,U.S. House,John Mccarthy,IND,610043,0,0,24,24,02
Pittsburg,State Senate,Larry Boggs,REP,610043,3,2,179,184,7
Pittsburg,State Senate,Joel Kerns,DEM,610043,1,9,140,150,7
Pittsburg,State House,Paul Marean,REP,610043,2,4,138,144,17
Pittsburg,State House,Brian Renegar,DEM,610043,2,7,175,184,17
Pittsburg,President,Donald Trump,REP,610044,12,5,353,370,
Pittsburg,President,Gary Johnson,LIB,610044,0,0,17,17,
Pittsburg,President,Hillary Clinton,DEM,610044,9,1,93,103,
Pittsburg,U.S. Senate,James Lankford,REP,610044,11,4,325,340,
Pittsburg,U.S. Senate,Robert Murphy,LIB,610044,1,0,5,6,
Pittsburg,U.S. Senate,Mike Workman,DEM,610044,9,1,117,127,
Pittsburg,U.S. Senate,Mark Beard,IND,610044,0,0,7,7,
Pittsburg,U.S. Senate,Sean Braddy,IND,610044,0,1,9,10,
Pittsburg,U.S. House,Markwayne Mullin,REP,610044,12,3,328,343,02
Pittsburg,U.S. House,Joshua Harris-Till,DEM,610044,9,2,104,115,02
Pittsburg,U.S. House,John Mccarthy,IND,610044,0,1,31,32,02
Pittsburg,State Senate,Larry Boggs,REP,610044,11,2,226,239,7
Pittsburg,State Senate,Joel Kerns,DEM,610044,10,4,239,253,7
Pittsburg,State House,Paul Marean,REP,610044,7,1,215,223,17
Pittsburg,State House,Brian Renegar,DEM,610044,14,5,246,265,17
Pittsburg,President,Donald Trump,REP,610045,0,3,4,7,
Pittsburg,President,Gary Johnson,LIB,610045,0,0,0,0,
Pittsburg,President,Hillary Clinton,DEM,610045,0,0,2,2,
Pittsburg,U.S. Senate,James Lankford,REP,610045,0,3,3,6,
Pittsburg,U.S. Senate,Robert Murphy,LIB,610045,0,0,0,0,
Pittsburg,U.S. Senate,Mike Workman,DEM,610045,0,0,3,3,
Pittsburg,U.S. Senate,Mark Beard,IND,610045,0,0,0,0,
Pittsburg,U.S. Senate,Sean Braddy,IND,610045,0,0,0,0,
Pittsburg,U.S. House,Markwayne Mullin,REP,610045,0,3,4,7,02
Pittsburg,U.S. House,Joshua Harris-Till,DEM,610045,0,0,2,2,02
Pittsburg,U.S. House,John Mccarthy,IND,610045,0,0,0,0,02
Pittsburg,State Senate,Larry Boggs,REP,610045,0,0,0,0,7
Pittsburg,State Senate,Joel Kerns,DEM,610045,0,3,6,9,7
Pittsburg,State House,Paul Marean,REP,610045,0,1,2,3,17
Pittsburg,State House,Brian Renegar,DEM,610045,0,2,4,6,17
Pittsburg,President,Donald Trump,REP,610046,7,26,184,217,
Pittsburg,President,Gary Johnson,LIB,610046,0,0,11,11,
Pittsburg,President,Hillary Clinton,DEM,610046,0,8,24,32,
Pittsburg,U.S. Senate,James Lankford,REP,610046,7,23,168,198,
Pittsburg,U.S. Senate,Robert Murphy,LIB,610046,0,0,5,5,
Pittsburg,U.S. Senate,Mike Workman,DEM,610046,0,10,35,45,
Pittsburg,U.S. Senate,Mark Beard,IND,610046,0,1,3,4,
Pittsburg,U.S. Senate,Sean Braddy,IND,610046,0,0,5,5,
Pittsburg,U.S. House,Markwayne Mullin,REP,610046,7,26,168,201,02
Pittsburg,U.S. House,Joshua Harris-Till,DEM,610046,0,8,36,44,02
Pittsburg,U.S. House,John Mccarthy,IND,610046,0,0,12,12,02
Pittsburg,State Senate,Larry Boggs,REP,610046,5,22,120,147,7
Pittsburg,State Senate,Joel Kerns,DEM,610046,2,12,99,113,7
Pittsburg,President,Donald Trump,REP,610047,10,17,324,351,
Pittsburg,President,Gary Johnson,LIB,610047,0,1,13,14,
Pittsburg,President,Hillary Clinton,DEM,610047,3,4,77,84,
Pittsburg,U.S. Senate,James Lankford,REP,610047,9,14,292,315,
Pittsburg,U.S. Senate,Robert Murphy,LIB,610047,0,2,4,6,
Pittsburg,U.S. Senate,Mike Workman,DEM,610047,4,4,104,112,
Pittsburg,U.S. Senate,Mark Beard,IND,610047,0,0,3,3,
Pittsburg,U.S. Senate,Sean Braddy,IND,610047,0,2,7,9,
Pittsburg,U.S. House,Markwayne Mullin,REP,610047,10,16,293,319,02
Pittsburg,U.S. House,Joshua Harris-Till,DEM,610047,3,4,95,102,02
Pittsburg,U.S. House,John Mccarthy,IND,610047,0,2,17,19,02
Pittsburg,State Senate,Larry Boggs,REP,610047,4,10,201,215,7
Pittsburg,State Senate,Joel Kerns,DEM,610047,9,12,214,235,7
Pittsburg,State House,Paul Marean,REP,610047,2,5,144,151,17
Pittsburg,State House,Brian Renegar,DEM,610047,11,17,269,297,17
Pittsburg,President,Donald Trump,REP,610048,2,5,88,95,
Pittsburg,President,Gary Johnson,LIB,610048,0,0,1,1,
Pittsburg,President,Hillary Clinton,DEM,610048,0,2,20,22,
Pittsburg,U.S. Senate,James Lankford,REP,610048,2,4,72,78,
Pittsburg,U.S. Senate,Robert Murphy,LIB,610048,0,0,2,2,
Pittsburg,U.S. Senate,Mike Workman,DEM,610048,0,3,26,29,
Pittsburg,U.S. Senate,Mark Beard,IND,610048,0,0,4,4,
Pittsburg,U.S. Senate,Sean Braddy,IND,610048,0,0,4,4,
Pittsburg,U.S. House,Markwayne Mullin,REP,610048,2,4,79,85,02
Pittsburg,U.S. House,Joshua Harris-Till,DEM,610048,0,3,23,26,02
Pittsburg,U.S. House,John Mccarthy,IND,610048,0,0,8,8,02
Pittsburg,State Senate,Larry Boggs,REP,610048,1,3,60,64,7
Pittsburg,State Senate,Joel Kerns,DEM,610048,1,4,50,55,7
Pittsburg,President,Donald Trump,REP,610049,17,31,347,395,
Pittsburg,President,Gary Johnson,LIB,610049,1,0,21,22,
Pittsburg,President,Hillary Clinton,DEM,610049,5,8,57,70,
Pittsburg,U.S. Senate,James Lankford,REP,610049,19,30,317,366,
Pittsburg,U.S. Senate,Robert Murphy,LIB,610049,0,0,7,7,
Pittsburg,U.S. Senate,Mike Workman,DEM,610049,3,10,78,91,
Pittsburg,U.S. Senate,Mark Beard,IND,610049,0,0,5,5,
Pittsburg,U.S. Senate,Sean Braddy,IND,610049,1,1,10,12,
Pittsburg,U.S. House,Markwayne Mullin,REP,610049,16,29,323,368,02
Pittsburg,U.S. House,Joshua Harris-Till,DEM,610049,4,10,72,86,02
Pittsburg,U.S. House,John Mccarthy,IND,610049,3,1,20,24,02
Pittsburg,State Senate,Larry Boggs,REP,610049,16,18,213,247,7
Pittsburg,State Senate,Joel Kerns,DEM,610049,7,23,208,238,7
Pittsburg,President,Donald Trump,REP,610051,4,8,156,168,
Pittsburg,President,Gary Johnson,LIB,610051,0,0,9,9,
Pittsburg,President,Hillary Clinton,DEM,610051,4,2,33,39,
Pittsburg,U.S. Senate,James Lankford,REP,610051,2,8,140,150,
Pittsburg,U.S. Senate,Robert Murphy,LIB,610051,0,0,4,4,
Pittsburg,U.S. Senate,Mike Workman,DEM,610051,4,2,38,44,
Pittsburg,U.S. Senate,Mark Beard,IND,610051,1,0,7,8,
Pittsburg,U.S. Senate,Sean Braddy,IND,610051,1,0,6,7,
Pittsburg,U.S. House,Markwayne Mullin,REP,610051,3,7,148,158,02
Pittsburg,U.S. House,Joshua Harris-Till,DEM,610051,4,3,37,44,02
Pittsburg,U.S. House,John Mccarthy,IND,610051,1,0,12,13,02
Pittsburg,State Senate,Larry Boggs,REP,610051,3,8,106,117,7
Pittsburg,State Senate,Joel Kerns,DEM,610051,5,2,92,99,7
Pittsburg,State House,Paul Marean,REP,610051,3,4,88,95,17
Pittsburg,State House,Brian Renegar,DEM,610051,5,6,106,117,17
Pittsburg,President,Donald Trump,REP,610052,0,0,19,19,
Pittsburg,President,Gary Johnson,LIB,610052,0,0,0,0,
Pittsburg,President,Hillary Clinton,DEM,610052,0,0,2,2,
Pittsburg,U.S. Senate,James Lankford,REP,610052,0,0,20,20,
Pittsburg,U.S. Senate,Robert Murphy,LIB,610052,0,0,0,0,
Pittsburg,U.S. Senate,Mike Workman,DEM,610052,0,0,1,1,
Pittsburg,U.S. Senate,Mark Beard,IND,610052,0,0,0,0,
Pittsburg,U.S. Senate,Sean Braddy,IND,610052,0,0,0,0,
Pittsburg,U.S. House,Markwayne Mullin,REP,610052,0,0,20,20,02
Pittsburg,U.S. House,Joshua Harris-Till,DEM,610052,0,0,1,1,02
Pittsburg,U.S. House,John Mccarthy,IND,610052,0,0,0,0,02
Pittsburg,State Senate,Larry Boggs,REP,610052,0,0,11,11,7
Pittsburg,State Senate,Joel Kerns,DEM,610052,0,0,10,10,7
Pittsburg,State House,Don Herrold,REP,610052,0,0,14,14,15
Pittsburg,State House,Ed Cannaday,DEM,610052,0,0,7,7,15
Pittsburg,President,Donald Trump,REP,610053,0,3,62,65,
Pittsburg,President,Gary Johnson,LIB,610053,0,0,4,4,
Pittsburg,President,Hillary Clinton,DEM,610053,0,2,13,15,
Pittsburg,U.S. Senate,James Lankford,REP,610053,0,1,53,54,
Pittsburg,U.S. Senate,Robert Murphy,LIB,610053,0,0,3,3,
Pittsburg,U.S. Senate,Mike Workman,DEM,610053,0,4,21,25,
Pittsburg,U.S. Senate,Mark Beard,IND,610053,0,0,1,1,
Pittsburg,U.S. Senate,Sean Braddy,IND,610053,0,0,0,0,
Pittsburg,U.S. House,Markwayne Mullin,REP,610053,0,3,58,61,02
Pittsburg,U.S. House,Joshua Harris-Till,DEM,610053,0,1,20,21,02
Pittsburg,U.S. House,John Mccarthy,IND,610053,0,1,1,2,02
Pittsburg,State Senate,Larry Boggs,REP,610053,0,2,42,44,7
Pittsburg,State Senate,Joel Kerns,DEM,610053,0,3,38,41,7
Pontotoc,President,Donald Trump,REP,620013,32,159,488,679,
Pontotoc,President,Gary Johnson,LIB,620013,0,18,37,55,
Pontotoc,President,Hillary Clinton,DEM,620013,16,95,233,344,
Pontotoc,U.S. Senate,James Lankford,REP,620013,34,170,490,694,
Pontotoc,U.S. Senate,Robert Murphy,LIB,620013,0,12,33,45,
Pontotoc,U.S. Senate,Mike Workman,DEM,620013,11,84,207,302,
Pontotoc,U.S. Senate,Mark Beard,IND,620013,1,1,8,10,
Pontotoc,U.S. Senate,Sean Braddy,IND,620013,2,5,17,24,
Pontotoc,U.S. House,Tom Cole,REP,620013,38,186,525,749,04
Pontotoc,U.S. House,Sevier White,LIB,620013,0,5,25,30,04
Pontotoc,U.S. House,Christina Owen,DEM,620013,10,80,203,293,04
Pontotoc,State Senate,Greg Mccortney,REP,620013,29,145,391,565,13
Pontotoc,State Senate,Eric Hall,DEM,620013,18,129,368,515,13
Pontotoc,State House,Todd Thomsen,REP,620013,35,161,478,674,25
Pontotoc,State House,David Weir,DEM,620013,12,109,277,398,25
Pontotoc,President,Donald Trump,REP,620016,53,263,638,954,
Pontotoc,President,Gary Johnson,LIB,620016,5,18,52,75,
Pontotoc,President,Hillary Clinton,DEM,620016,27,102,246,375,
Pontotoc,U.S. Senate,James Lankford,REP,620016,54,283,657,994,
Pontotoc,U.S. Senate,Robert Murphy,LIB,620016,1,9,17,27,
Pontotoc,U.S. Senate,Mike Workman,DEM,620016,27,89,229,345,
Pontotoc,U.S. Senate,Mark Beard,IND,620016,1,3,8,12,
Pontotoc,U.S. Senate,Sean Braddy,IND,620016,2,5,24,31,
Pontotoc,U.S. House,Tom Cole,REP,620016,59,297,704,1060,04
Pontotoc,U.S. House,Sevier White,LIB,620016,3,10,28,41,04
Pontotoc,U.S. House,Christina Owen,DEM,620016,26,82,205,313,04
Pontotoc,State Senate,Greg Mccortney,REP,620016,51,231,523,805,13
Pontotoc,State Senate,Eric Hall,DEM,620016,35,157,409,601,13
Pontotoc,State House,Todd Thomsen,REP,620016,52,271,634,957,25
Pontotoc,State House,David Weir,DEM,620016,32,112,290,434,25
Pontotoc,President,Donald Trump,REP,620022,15,97,409,521,
Pontotoc,President,Gary Johnson,LIB,620022,2,7,61,70,
Pontotoc,President,Hillary Clinton,DEM,620022,25,59,221,305,
Pontotoc,U.S. Senate,James Lankford,REP,620022,21,97,411,529,
Pontotoc,U.S. Senate,Robert Murphy,LIB,620022,2,3,22,27,
Pontotoc,U.S. Senate,Mike Workman,DEM,620022,16,57,201,274,
Pontotoc,U.S. Senate,Mark Beard,IND,620022,0,1,17,18,
Pontotoc,U.S. Senate,Sean Braddy,IND,620022,4,3,33,40,
Pontotoc,U.S. House,Tom Cole,REP,620022,24,108,460,592,04
Pontotoc,U.S. House,Sevier White,LIB,620022,1,3,28,32,04
Pontotoc,U.S. House,Christina Owen,DEM,620022,18,49,198,265,04
Pontotoc,State Senate,Greg Mccortney,REP,620022,24,81,365,470,13
Pontotoc,State Senate,Eric Hall,DEM,620022,19,79,323,421,13
Pontotoc,State House,Todd Thomsen,REP,620022,26,96,412,534,25
Pontotoc,State House,David Weir,DEM,620022,17,61,272,350,25
Pontotoc,President,Donald Trump,REP,620025,37,217,657,911,
Pontotoc,President,Gary Johnson,LIB,620025,4,8,51,63,
Pontotoc,President,Hillary Clinton,DEM,620025,16,83,217,316,
Pontotoc,U.S. Senate,James Lankford,REP,620025,41,223,651,915,
Pontotoc,U.S. Senate,Robert Murphy,LIB,620025,4,6,24,34,
Pontotoc,U.S. Senate,Mike Workman,DEM,620025,12,73,217,302,
Pontotoc,U.S. Senate,Mark Beard,IND,620025,0,2,13,15,
Pontotoc,U.S. Senate,Sean Braddy,IND,620025,0,2,27,29,
Pontotoc,U.S. House,Tom Cole,REP,620025,44,232,717,993,04
Pontotoc,U.S. House,Sevier White,LIB,620025,1,9,24,34,04
Pontotoc,U.S. House,Christina Owen,DEM,620025,12,68,192,272,04
Pontotoc,State Senate,Greg Mccortney,REP,620025,33,184,554,771,13
Pontotoc,State Senate,Eric Hall,DEM,620025,24,123,377,524,13
Pontotoc,State House,Todd Thomsen,REP,620025,39,220,657,916,25
Pontotoc,State House,David Weir,DEM,620025,18,87,267,372,25
Pontotoc,President,Donald Trump,REP,620031,32,160,520,712,
Pontotoc,President,Gary Johnson,LIB,620031,7,13,82,102,
Pontotoc,President,Hillary Clinton,DEM,620031,16,120,344,480,
Pontotoc,U.S. Senate,James Lankford,REP,620031,31,142,499,672,
Pontotoc,U.S. Senate,Robert Murphy,LIB,620031,2,10,40,52,
Pontotoc,U.S. Senate,Mike Workman,DEM,620031,19,115,312,446,
Pontotoc,U.S. Senate,Mark Beard,IND,620031,2,9,35,46,
Pontotoc,U.S. Senate,Sean Braddy,IND,620031,0,12,49,61,
Pontotoc,U.S. House,Tom Cole,REP,620031,34,160,573,767,04
Pontotoc,U.S. House,Sevier White,LIB,620031,2,12,39,53,04
Pontotoc,U.S. House,Christina Owen,DEM,620031,18,116,322,456,04
Pontotoc,State Senate,Greg Mccortney,REP,620031,31,139,448,618,13
Pontotoc,State Senate,Eric Hall,DEM,620031,23,148,490,661,13
Pontotoc,State House,Todd Thomsen,REP,620031,33,156,536,725,25
Pontotoc,State House,David Weir,DEM,620031,21,132,394,547,25
Pontotoc,President,Donald Trump,REP,620051,7,13,300,320,
Pontotoc,President,Gary Johnson,LIB,620051,1,0,10,11,
Pontotoc,President,Hillary Clinton,DEM,620051,0,6,61,67,
Pontotoc,U.S. Senate,James Lankford,REP,620051,7,12,274,293,
Pontotoc,U.S. Senate,Robert Murphy,LIB,620051,0,0,8,8,
Pontotoc,U.S. Senate,Mike Workman,DEM,620051,1,6,77,84,
Pontotoc,U.S. Senate,Mark Beard,IND,620051,0,0,6,6,
Pontotoc,U.S. Senate,Sean Braddy,IND,620051,0,0,10,10,
Pontotoc,U.S. House,Tom Cole,REP,620051,8,12,289,309,04
Pontotoc,U.S. House,Sevier White,LIB,620051,0,0,13,13,04
Pontotoc,U.S. House,Christina Owen,DEM,620051,0,6,71,77,04
Pontotoc,State Senate,Greg Mccortney,REP,620051,8,10,261,279,13
Pontotoc,State Senate,Eric Hall,DEM,620051,0,7,109,116,13
Pontotoc,State House,Todd Thomsen,REP,620051,8,11,275,294,25
Pontotoc,State House,David Weir,DEM,620051,0,7,93,100,25
Pontotoc,President,Donald Trump,REP,620052,13,67,262,342,
Pontotoc,President,Gary Johnson,LIB,620052,1,3,22,26,
Pontotoc,President,Hillary Clinton,DEM,620052,6,40,143,189,
Pontotoc,U.S. Senate,James Lankford,REP,620052,14,67,256,337,
Pontotoc,U.S. Senate,Robert Murphy,LIB,620052,0,4,9,13,
Pontotoc,U.S. Senate,Mike Workman,DEM,620052,5,36,142,183,
Pontotoc,U.S. Senate,Mark Beard,IND,620052,0,0,5,5,
Pontotoc,U.S. Senate,Sean Braddy,IND,620052,1,2,12,15,
Pontotoc,U.S. House,Tom Cole,REP,620052,13,71,273,357,04
Pontotoc,U.S. House,Sevier White,LIB,620052,2,2,12,16,04
Pontotoc,U.S. House,Christina Owen,DEM,620052,5,36,138,179,04
Pontotoc,State Senate,Greg Mccortney,REP,620052,14,51,210,275,13
Pontotoc,State Senate,Eric Hall,DEM,620052,6,59,212,277,13
Pontotoc,State House,Todd Thomsen,REP,620052,14,58,251,323,25
Pontotoc,State House,David Weir,DEM,620052,6,52,170,228,25
Pontotoc,President,Donald Trump,REP,620053,46,285,573,904,
Pontotoc,President,Gary Johnson,LIB,620053,5,25,39,69,
Pontotoc,President,Hillary Clinton,DEM,620053,32,122,186,340,
Pontotoc,U.S. Senate,James Lankford,REP,620053,47,296,571,914,
Pontotoc,U.S. Senate,Robert Murphy,LIB,620053,0,8,18,26,
Pontotoc,U.S. Senate,Mike Workman,DEM,620053,25,110,178,313,
Pontotoc,U.S. Senate,Mark Beard,IND,620053,3,7,10,20,
Pontotoc,U.S. Senate,Sean Braddy,IND,620053,7,9,19,35,
Pontotoc,U.S. House,Tom Cole,REP,620053,56,309,614,979,04
Pontotoc,U.S. House,Sevier White,LIB,620053,2,12,24,38,04
Pontotoc,U.S. House,Christina Owen,DEM,620053,25,108,161,294,04
Pontotoc,State Senate,Greg Mccortney,REP,620053,45,255,455,755,13
Pontotoc,State Senate,Eric Hall,DEM,620053,37,176,342,555,13
Pontotoc,State House,Todd Thomsen,REP,620053,50,273,551,874,25
Pontotoc,State House,David Weir,DEM,620053,32,156,249,437,25
Pontotoc,President,Donald Trump,REP,620054,5,17,126,148,
Pontotoc,President,Gary Johnson,LIB,620054,0,0,12,12,
Pontotoc,President,Hillary Clinton,DEM,620054,3,3,13,19,
Pontotoc,U.S. Senate,James Lankford,REP,620054,5,14,115,134,
Pontotoc,U.S. Senate,Robert Murphy,LIB,620054,0,0,4,4,
Pontotoc,U.S. Senate,Mike Workman,DEM,620054,2,5,27,34,
Pontotoc,U.S. Senate,Mark Beard,IND,620054,0,1,4,5,
Pontotoc,U.S. Senate,Sean Braddy,IND,620054,0,0,0,0,
Pontotoc,U.S. House,Tom Cole,REP,620054,3,15,123,141,04
Pontotoc,U.S. House,Sevier White,LIB,620054,2,1,9,12,04
Pontotoc,U.S. House,Christina Owen,DEM,620054,2,4,18,24,04
Pontotoc,State Senate,Greg Mccortney,REP,620054,3,11,97,111,13
Pontotoc,State Senate,Eric Hall,DEM,620054,4,9,52,65,13
Pontotoc,State House,Todd Thomsen,REP,620054,5,15,110,130,25
Pontotoc,State House,David Weir,DEM,620054,2,4,39,45,25
Pontotoc,President,Donald Trump,REP,620055,4,22,175,201,
Pontotoc,President,Gary Johnson,LIB,620055,1,1,10,12,
Pontotoc,President,Hillary Clinton,DEM,620055,6,7,19,32,
Pontotoc,U.S. Senate,James Lankford,REP,620055,4,22,165,191,
Pontotoc,U.S. Senate,Robert Murphy,LIB,620055,1,0,4,5,
Pontotoc,U.S. Senate,Mike Workman,DEM,620055,5,7,27,39,
Pontotoc,U.S. Senate,Mark Beard,IND,620055,0,0,0,0,
Pontotoc,U.S. Senate,Sean Braddy,IND,620055,0,0,6,6,
Pontotoc,U.S. House,Tom Cole,REP,620055,7,24,176,207,04
Pontotoc,U.S. House,Sevier White,LIB,620055,0,0,3,3,04
Pontotoc,U.S. House,Christina Owen,DEM,620055,3,5,23,31,04
Pontotoc,State Senate,Greg Mccortney,REP,620055,5,13,131,149,13
Pontotoc,State Senate,Eric Hall,DEM,620055,5,16,70,91,13
Pontotoc,State House,Todd Thomsen,REP,620055,7,20,157,184,25
Pontotoc,State House,David Weir,DEM,620055,2,9,40,51,25
Pontotoc,President,Donald Trump,REP,620056,5,24,202,231,
Pontotoc,President,Gary Johnson,LIB,620056,0,0,13,13,
Pontotoc,President,Hillary Clinton,DEM,620056,2,2,48,52,
Pontotoc,U.S. Senate,James Lankford,REP,620056,6,22,175,203,
Pontotoc,U.S. Senate,Robert Murphy,LIB,620056,0,0,11,11,
Pontotoc,U.S. Senate,Mike Workman,DEM,620056,1,4,58,63,
Pontotoc,U.S. Senate,Mark Beard,IND,620056,0,0,6,6,
Pontotoc,U.S. Senate,Sean Braddy,IND,620056,0,0,9,9,
Pontotoc,U.S. House,Tom Cole,REP,620056,6,24,203,233,04
Pontotoc,U.S. House,Sevier White,LIB,620056,0,0,7,7,04
Pontotoc,U.S. House,Christina Owen,DEM,620056,1,2,51,54,04
Pontotoc,State Senate,Greg Mccortney,REP,620056,4,17,157,178,13
Pontotoc,State Senate,Eric Hall,DEM,620056,3,9,104,116,13
Pontotoc,State House,Todd Thomsen,REP,620056,6,21,178,205,25
Pontotoc,State House,David Weir,DEM,620056,1,5,77,83,25
Pontotoc,President,Donald Trump,REP,620058,21,94,538,653,
Pontotoc,President,Gary Johnson,LIB,620058,1,7,44,52,
Pontotoc,President,Hillary Clinton,DEM,620058,7,37,144,188,
Pontotoc,U.S. Senate,James Lankford,REP,620058,23,99,541,663,
Pontotoc,U.S. Senate,Robert Murphy,LIB,620058,1,1,19,21,
Pontotoc,U.S. Senate,Mike Workman,DEM,620058,5,35,141,181,
Pontotoc,U.S. Senate,Mark Beard,IND,620058,0,1,13,14,
Pontotoc,U.S. Senate,Sean Braddy,IND,620058,0,3,10,13,
Pontotoc,U.S. House,Tom Cole,REP,620058,23,107,586,716,04
Pontotoc,U.S. House,Sevier White,LIB,620058,1,2,14,17,04
Pontotoc,U.S. House,Christina Owen,DEM,620058,5,29,127,161,04
Pontotoc,State Senate,Greg Mccortney,REP,620058,23,78,447,548,13
Pontotoc,State Senate,Eric Hall,DEM,620058,6,59,280,345,13
Pontotoc,State House,Todd Thomsen,REP,620058,22,91,512,625,25
Pontotoc,State House,David Weir,DEM,620058,6,47,207,260,25
Pontotoc,President,Donald Trump,REP,620059,15,69,386,470,
Pontotoc,President,Gary Johnson,LIB,620059,0,1,27,28,
Pontotoc,President,Hillary Clinton,DEM,620059,2,15,87,104,
Pontotoc,U.S. Senate,James Lankford,REP,620059,12,63,362,437,
Pontotoc,U.S. Senate,Robert Murphy,LIB,620059,2,1,14,17,
Pontotoc,U.S. Senate,Mike Workman,DEM,620059,2,17,101,120,
Pontotoc,U.S. Senate,Mark Beard,IND,620059,0,0,9,9,
Pontotoc,U.S. Senate,Sean Braddy,IND,620059,1,3,11,15,
Pontotoc,U.S. House,Tom Cole,REP,620059,13,69,391,473,04
Pontotoc,U.S. House,Sevier White,LIB,620059,2,1,14,17,04
Pontotoc,U.S. House,Christina Owen,DEM,620059,2,15,93,110,04
Pontotoc,State Senate,Greg Mccortney,REP,620059,14,53,317,384,13
Pontotoc,State Senate,Eric Hall,DEM,620059,3,31,178,212,13
Pontotoc,State House,Todd Thomsen,REP,620059,14,56,349,419,25
Pontotoc,State House,David Weir,DEM,620059,3,28,141,172,25
Pontotoc,President,Donald Trump,REP,620060,7,80,556,643,
Pontotoc,President,Gary Johnson,LIB,620060,1,4,35,40,
Pontotoc,President,Hillary Clinton,DEM,620060,8,20,165,193,
Pontotoc,U.S. Senate,James Lankford,REP,620060,6,71,530,607,
Pontotoc,U.S. Senate,Robert Murphy,LIB,620060,1,4,20,25,
Pontotoc,U.S. Senate,Mike Workman,DEM,620060,8,21,166,195,
Pontotoc,U.S. Senate,Mark Beard,IND,620060,1,2,15,18,
Pontotoc,U.S. Senate,Sean Braddy,IND,620060,0,5,25,30,
Pontotoc,U.S. House,Tom Cole,REP,620060,7,78,577,662,04
Pontotoc,U.S. House,Sevier White,LIB,620060,1,4,22,27,04
Pontotoc,U.S. House,Christina Owen,DEM,620060,8,21,157,186,04
Pontotoc,State Senate,Greg Mccortney,REP,620060,9,57,447,513,13
Pontotoc,State Senate,Eric Hall,DEM,620060,7,46,311,364,13
Pontotoc,State House,Todd Thomsen,REP,620060,6,76,521,603,25
Pontotoc,State House,David Weir,DEM,620060,10,26,233,269,25
Pontotoc,President,Donald Trump,REP,620061,4,38,174,216,
Pontotoc,President,Gary Johnson,LIB,620061,0,5,5,10,
Pontotoc,President,Hillary Clinton,DEM,620061,0,7,41,48,
Pontotoc,U.S. Senate,James Lankford,REP,620061,3,43,163,209,
Pontotoc,U.S. Senate,Robert Murphy,LIB,620061,0,1,7,8,
Pontotoc,U.S. Senate,Mike Workman,DEM,620061,0,5,39,44,
Pontotoc,U.S. Senate,Mark Beard,IND,620061,0,0,0,0,
Pontotoc,U.S. Senate,Sean Braddy,IND,620061,0,1,4,5,
Pontotoc,U.S. House,Tom Cole,REP,620061,3,46,175,224,04
Pontotoc,U.S. House,Sevier White,LIB,620061,0,1,7,8,04
Pontotoc,U.S. House,Christina Owen,DEM,620061,0,3,33,36,04
Pontotoc,State Senate,Greg Mccortney,REP,620061,2,34,132,168,13
Pontotoc,State Senate,Eric Hall,DEM,620061,1,16,84,101,13
Pontotoc,State House,Todd Thomsen,REP,620061,3,43,165,211,25
Pontotoc,State House,David Weir,DEM,620061,0,6,52,58,25
Pontotoc,President,Donald Trump,REP,620062,13,85,431,529,
Pontotoc,President,Gary Johnson,LIB,620062,0,8,24,32,
Pontotoc,President,Hillary Clinton,DEM,620062,5,17,108,130,
Pontotoc,U.S. Senate,James Lankford,REP,620062,15,79,416,510,
Pontotoc,U.S. Senate,Robert Murphy,LIB,620062,1,2,15,18,
Pontotoc,U.S. Senate,Mike Workman,DEM,620062,1,27,103,131,
Pontotoc,U.S. Senate,Mark Beard,IND,620062,0,0,7,7,
Pontotoc,U.S. Senate,Sean Braddy,IND,620062,0,1,12,13,
Pontotoc,U.S. House,Tom Cole,REP,620062,15,88,439,542,04
Pontotoc,U.S. House,Sevier White,LIB,620062,0,2,10,12,04
Pontotoc,U.S. House,Christina Owen,DEM,620062,2,19,106,127,04
Pontotoc,State Senate,Greg Mccortney,REP,620062,15,67,367,449,13
Pontotoc,State Senate,Eric Hall,DEM,620062,3,43,188,234,13
Pontotoc,State House,Todd Thomsen,REP,620062,15,79,398,492,25
Pontotoc,State House,David Weir,DEM,620062,3,30,150,183,25
Pontotoc,President,Donald Trump,REP,620063,11,12,300,323,
Pontotoc,President,Gary Johnson,LIB,620063,0,0,26,26,
Pontotoc,President,Hillary Clinton,DEM,620063,3,8,70,81,
Pontotoc,U.S. Senate,James Lankford,REP,620063,12,13,284,309,
Pontotoc,U.S. Senate,Robert Murphy,LIB,620063,0,0,16,16,
Pontotoc,U.S. Senate,Mike Workman,DEM,620063,2,8,75,85,
Pontotoc,U.S. Senate,Mark Beard,IND,620063,0,0,5,5,
Pontotoc,U.S. Senate,Sean Braddy,IND,620063,0,0,14,14,
Pontotoc,U.S. House,Tom Cole,REP,620063,14,13,305,332,04
Pontotoc,U.S. House,Sevier White,LIB,620063,0,0,18,18,04
Pontotoc,U.S. House,Christina Owen,DEM,620063,0,8,68,76,04
Pontotoc,State Senate,Greg Mccortney,REP,620063,12,12,262,286,13
Pontotoc,State Senate,Eric Hall,DEM,620063,2,9,127,138,13
Pontotoc,State House,Todd Thomsen,REP,620063,14,12,268,294,25
Pontotoc,State House,David Weir,DEM,620063,0,9,112,121,25
Pontotoc,President,Donald Trump,REP,620064,12,46,397,455,
Pontotoc,President,Gary Johnson,LIB,620064,2,0,21,23,
Pontotoc,President,Hillary Clinton,DEM,620064,2,9,88,99,
Pontotoc,U.S. Senate,James Lankford,REP,620064,13,45,367,425,
Pontotoc,U.S. Senate,Robert Murphy,LIB,620064,0,0,13,13,
Pontotoc,U.S. Senate,Mike Workman,DEM,620064,4,10,105,119,
Pontotoc,U.S. Senate,Mark Beard,IND,620064,0,0,13,13,
Pontotoc,U.S. Senate,Sean Braddy,IND,620064,0,0,7,7,
Pontotoc,U.S. House,Tom Cole,REP,620064,14,43,399,456,04
Pontotoc,U.S. House,Sevier White,LIB,620064,0,0,22,22,04
Pontotoc,U.S. House,Christina Owen,DEM,620064,3,12,85,100,04
Pontotoc,State Senate,Greg Mccortney,REP,620064,7,36,316,359,13
Pontotoc,State Senate,Eric Hall,DEM,620064,10,19,190,219,13
Pontotoc,State House,Todd Thomsen,REP,620064,12,37,359,408,25
Pontotoc,State House,David Weir,DEM,620064,5,18,147,170,25
Pontotoc,President,Donald Trump,REP,620065,12,38,371,421,
Pontotoc,President,Gary Johnson,LIB,620065,0,1,14,15,
Pontotoc,President,Hillary Clinton,DEM,620065,3,13,82,98,
Pontotoc,U.S. Senate,James Lankford,REP,620065,14,38,329,381,
Pontotoc,U.S. Senate,Robert Murphy,LIB,620065,0,0,14,14,
Pontotoc,U.S. Senate,Mike Workman,DEM,620065,1,13,98,112,
Pontotoc,U.S. Senate,Mark Beard,IND,620065,0,0,5,5,
Pontotoc,U.S. Senate,Sean Braddy,IND,620065,0,1,21,22,
Pontotoc,U.S. House,Tom Cole,REP,620065,12,37,365,414,04
Pontotoc,U.S. House,Sevier White,LIB,620065,1,0,17,18,04
Pontotoc,U.S. House,Christina Owen,DEM,620065,2,14,86,102,04
Pontotoc,State Senate,Greg Mccortney,REP,620065,9,30,302,341,13
Pontotoc,State Senate,Eric Hall,DEM,620065,6,22,164,192,13
Pontotoc,State House,Todd Thomsen,REP,620065,12,40,336,388,25
Pontotoc,State House,David Weir,DEM,620065,3,11,123,137,25
Pontotoc,President,Donald Trump,REP,620066,9,87,363,459,
Pontotoc,President,Gary Johnson,LIB,620066,0,4,11,15,
Pontotoc,President,Hillary Clinton,DEM,620066,3,24,103,130,
Pontotoc,U.S. Senate,James Lankford,REP,620066,10,89,334,433,
Pontotoc,U.S. Senate,Robert Murphy,LIB,620066,0,2,13,15,
Pontotoc,U.S. Senate,Mike Workman,DEM,620066,3,19,111,133,
Pontotoc,U.S. Senate,Mark Beard,IND,620066,0,2,6,8,
Pontotoc,U.S. Senate,Sean Braddy,IND,620066,0,2,6,8,
Pontotoc,U.S. House,Tom Cole,REP,620066,10,90,367,467,04
Pontotoc,U.S. House,Sevier White,LIB,620066,0,2,10,12,04
Pontotoc,U.S. House,Christina Owen,DEM,620066,3,21,96,120,04
Pontotoc,State Senate,Greg Mccortney,REP,620066,7,67,278,352,13
Pontotoc,State Senate,Eric Hall,DEM,620066,5,45,192,242,13
Pontotoc,State House,Todd Thomsen,REP,620066,10,87,356,453,25
Pontotoc,State House,David Weir,DEM,620066,2,27,112,141,25
Pontotoc,President,Donald Trump,REP,620067,10,29,300,339,
Pontotoc,President,Gary Johnson,LIB,620067,0,4,10,14,
Pontotoc,President,Hillary Clinton,DEM,620067,2,5,40,47,
Pontotoc,U.S. Senate,James Lankford,REP,620067,10,29,284,323,
Pontotoc,U.S. Senate,Robert Murphy,LIB,620067,0,1,14,15,
Pontotoc,U.S. Senate,Mike Workman,DEM,620067,3,7,34,44,
Pontotoc,U.S. Senate,Mark Beard,IND,620067,0,0,7,7,
Pontotoc,U.S. Senate,Sean Braddy,IND,620067,0,1,4,5,
Pontotoc,U.S. House,Tom Cole,REP,620067,9,27,291,327,04
Pontotoc,U.S. House,Sevier White,LIB,620067,0,4,14,18,04
Pontotoc,U.S. House,Christina Owen,DEM,620067,4,7,43,54,04
Pontotoc,State Senate,Greg Mccortney,REP,620067,9,24,257,290,13
Pontotoc,State Senate,Eric Hall,DEM,620067,4,13,88,105,13
Pontotoc,State House,Todd Thomsen,REP,620067,11,23,283,317,25
Pontotoc,State House,David Weir,DEM,620067,2,14,64,80,25
Pottawatomie,President,Donald Trump,REP,630001,13,35,317,365,
Pottawatomie,President,Gary Johnson,LIB,630001,2,1,24,27,
Pottawatomie,President,Hillary Clinton,DEM,630001,6,10,83,99,
Pottawatomie,U.S. Senate,James Lankford,REP,630001,17,34,350,401,
Pottawatomie,U.S. Senate,Robert Murphy,LIB,630001,0,1,5,6,
Pottawatomie,U.S. Senate,Mike Workman,DEM,630001,4,10,61,75,
Pottawatomie,U.S. Senate,Mark Beard,IND,630001,0,0,3,3,
Pottawatomie,U.S. Senate,Sean Braddy,IND,630001,0,1,5,6,
Pottawatomie,U.S. House,Steve Russell,REP,630001,13,31,315,359,05
Pottawatomie,U.S. House,Zachary Knight,LIB,630001,2,2,14,18,05
Pottawatomie,U.S. House,Al Mcaffrey,DEM,630001,6,13,89,108,05
Pottawatomie,State House,Dell Kerbs,REP,630001,16,32,261,309,26
Pottawatomie,State House,Nick Atwood,DEM,630001,5,14,161,180,26
Pottawatomie,President,Donald Trump,REP,630002,12,33,321,366,
Pottawatomie,President,Gary Johnson,LIB,630002,1,2,41,44,
Pottawatomie,President,Hillary Clinton,DEM,630002,8,13,164,185,
Pottawatomie,U.S. Senate,James Lankford,REP,630002,10,37,352,399,
Pottawatomie,U.S. Senate,Robert Murphy,LIB,630002,1,0,19,20,
Pottawatomie,U.S. Senate,Mike Workman,DEM,630002,10,8,120,138,
Pottawatomie,U.S. Senate,Mark Beard,IND,630002,0,1,16,17,
Pottawatomie,U.S. Senate,Sean Braddy,IND,630002,1,3,14,18,
Pottawatomie,U.S. House,Steve Russell,REP,630002,10,32,318,360,05
Pottawatomie,U.S. House,Zachary Knight,LIB,630002,2,3,47,52,05
Pottawatomie,U.S. House,Al Mcaffrey,DEM,630002,9,14,151,174,05
Pottawatomie,State House,Dell Kerbs,REP,630002,8,30,274,312,26
Pottawatomie,State House,Nick Atwood,DEM,630002,13,19,245,277,26
Pottawatomie,President,Donald Trump,REP,630003,29,80,507,616,
Pottawatomie,President,Gary Johnson,LIB,630003,5,13,89,107,
Pottawatomie,President,Hillary Clinton,DEM,630003,18,40,317,375,
Pottawatomie,U.S. Senate,James Lankford,REP,630003,33,88,538,659,
Pottawatomie,U.S. Senate,Robert Murphy,LIB,630003,1,5,45,51,
Pottawatomie,U.S. Senate,Mike Workman,DEM,630003,17,36,265,318,
Pottawatomie,U.S. Senate,Mark Beard,IND,630003,1,1,25,27,
Pottawatomie,U.S. Senate,Sean Braddy,IND,630003,1,1,33,35,
Pottawatomie,U.S. House,Steve Russell,REP,630003,29,79,485,593,05
Pottawatomie,U.S. House,Zachary Knight,LIB,630003,3,5,89,97,05
Pottawatomie,U.S. House,Al Mcaffrey,DEM,630003,17,45,324,386,05
Pottawatomie,State House,Dell Kerbs,REP,630003,26,68,441,535,26
Pottawatomie,State House,Nick Atwood,DEM,630003,25,60,457,542,26
Pottawatomie,President,Donald Trump,REP,630006,26,78,407,511,
Pottawatomie,President,Gary Johnson,LIB,630006,6,8,69,83,
Pottawatomie,President,Hillary Clinton,DEM,630006,18,44,196,258,
Pottawatomie,U.S. Senate,James Lankford,REP,630006,33,94,478,605,
Pottawatomie,U.S. Senate,Robert Murphy,LIB,630006,0,5,20,25,
Pottawatomie,U.S. Senate,Mike Workman,DEM,630006,15,29,143,187,
Pottawatomie,U.S. Senate,Mark Beard,IND,630006,0,1,9,10,
Pottawatomie,U.S. Senate,Sean Braddy,IND,630006,2,1,26,29,
Pottawatomie,U.S. House,Steve Russell,REP,630006,33,79,420,532,05
Pottawatomie,U.S. House,Zachary Knight,LIB,630006,0,9,62,71,05
Pottawatomie,U.S. House,Al Mcaffrey,DEM,630006,18,40,189,247,05
Pottawatomie,State House,Dell Kerbs,REP,630006,25,74,356,455,26
Pottawatomie,State House,Nick Atwood,DEM,630006,25,53,321,399,26
Pottawatomie,President,Donald Trump,REP,630007,34,104,471,609,
Pottawatomie,President,Gary Johnson,LIB,630007,1,8,68,77,
Pottawatomie,President,Hillary Clinton,DEM,630007,22,45,244,311,
Pottawatomie,U.S. Senate,James Lankford,REP,630007,41,123,542,706,
Pottawatomie,U.S. Senate,Robert Murphy,LIB,630007,1,2,21,24,
Pottawatomie,U.S. Senate,Mike Workman,DEM,630007,16,29,185,230,
Pottawatomie,U.S. Senate,Mark Beard,IND,630007,0,2,15,17,
Pottawatomie,U.S. Senate,Sean Braddy,IND,630007,0,2,25,27,
Pottawatomie,U.S. House,Steve Russell,REP,630007,38,112,497,647,05
Pottawatomie,U.S. House,Zachary Knight,LIB,630007,1,5,53,59,05
Pottawatomie,U.S. House,Al Mcaffrey,DEM,630007,19,41,233,293,05
Pottawatomie,State House,Dell Kerbs,REP,630007,35,90,395,520,26
Pottawatomie,State House,Nick Atwood,DEM,630007,24,69,383,476,26
Pottawatomie,President,Donald Trump,REP,630009,55,181,757,993,
Pottawatomie,President,Gary Johnson,LIB,630009,4,10,82,96,
Pottawatomie,President,Hillary Clinton,DEM,630009,17,65,190,272,
Pottawatomie,U.S. Senate,James Lankford,REP,630009,62,192,813,1067,
Pottawatomie,U.S. Senate,Robert Murphy,LIB,630009,3,3,26,32,
Pottawatomie,U.S. Senate,Mike Workman,DEM,630009,13,55,146,214,
Pottawatomie,U.S. Senate,Mark Beard,IND,630009,1,1,27,29,
Pottawatomie,U.S. Senate,Sean Braddy,IND,630009,1,7,28,36,
Pottawatomie,U.S. House,Steve Russell,REP,630009,57,181,753,991,05
Pottawatomie,U.S. House,Zachary Knight,LIB,630009,3,10,70,83,05
Pottawatomie,U.S. House,Al Mcaffrey,DEM,630009,17,66,202,285,05
Pottawatomie,State House,Dell Kerbs,REP,630009,43,162,621,826,26
Pottawatomie,State House,Nick Atwood,DEM,630009,34,92,410,536,26
Pottawatomie,President,Donald Trump,REP,630011,87,164,877,1128,
Pottawatomie,President,Gary Johnson,LIB,630011,7,9,97,113,
Pottawatomie,President,Hillary Clinton,DEM,630011,27,97,290,414,
Pottawatomie,U.S. Senate,James Lankford,REP,630011,95,197,988,1280,
Pottawatomie,U.S. Senate,Robert Murphy,LIB,630011,3,3,14,20,
Pottawatomie,U.S. Senate,Mike Workman,DEM,630011,22,63,227,312,
Pottawatomie,U.S. Senate,Mark Beard,IND,630011,2,5,23,30,
Pottawatomie,U.S. Senate,Sean Braddy,IND,630011,1,7,26,34,
Pottawatomie,U.S. House,Steve Russell,REP,630011,91,188,926,1205,05
Pottawatomie,U.S. House,Zachary Knight,LIB,630011,4,10,50,64,05
Pottawatomie,U.S. House,Al Mcaffrey,DEM,630011,28,77,290,395,05
Pottawatomie,State House,Dell Kerbs,REP,630011,76,150,751,977,26
Pottawatomie,State House,Nick Atwood,DEM,630011,46,125,514,685,26
Pottawatomie,President,Donald Trump,REP,630012,39,114,501,654,
Pottawatomie,President,Gary Johnson,LIB,630012,4,6,72,82,
Pottawatomie,President,Hillary Clinton,DEM,630012,32,59,221,312,
Pottawatomie,U.S. Senate,James Lankford,REP,630012,42,119,565,726,
Pottawatomie,U.S. Senate,Robert Murphy,LIB,630012,2,1,27,30,
Pottawatomie,U.S. Senate,Mike Workman,DEM,630012,28,51,167,246,
Pottawatomie,U.S. Senate,Mark Beard,IND,630012,1,4,17,22,
Pottawatomie,U.S. Senate,Sean Braddy,IND,630012,2,7,19,28,
Pottawatomie,U.S. House,Steve Russell,REP,630012,39,114,510,663,05
Pottawatomie,U.S. House,Zachary Knight,LIB,630012,3,2,53,58,05
Pottawatomie,U.S. House,Al Mcaffrey,DEM,630012,33,65,230,328,05
Pottawatomie,State House,Dell Kerbs,REP,630012,37,96,405,538,26
Pottawatomie,State House,Nick Atwood,DEM,630012,36,85,388,509,26
Pottawatomie,President,Donald Trump,REP,630013,78,146,720,944,
Pottawatomie,President,Gary Johnson,LIB,630013,8,6,51,65,
Pottawatomie,President,Hillary Clinton,DEM,630013,49,87,288,424,
Pottawatomie,U.S. Senate,James Lankford,REP,630013,92,159,818,1069,
Pottawatomie,U.S. Senate,Robert Murphy,LIB,630013,3,2,17,22,
Pottawatomie,U.S. Senate,Mike Workman,DEM,630013,36,69,205,310,
Pottawatomie,U.S. Senate,Mark Beard,IND,630013,0,1,8,9,
Pottawatomie,U.S. Senate,Sean Braddy,IND,630013,3,6,14,23,
Pottawatomie,U.S. House,Steve Russell,REP,630013,80,146,759,985,05
Pottawatomie,U.S. House,Zachary Knight,LIB,630013,4,7,36,47,05
Pottawatomie,U.S. House,Al Mcaffrey,DEM,630013,47,84,248,379,05
Pottawatomie,State House,Dell Kerbs,REP,630013,62,130,592,784,26
Pottawatomie,State House,Nick Atwood,DEM,630013,65,110,456,631,26
Pottawatomie,President,Donald Trump,REP,630015,22,104,615,741,
Pottawatomie,President,Gary Johnson,LIB,630015,3,7,98,108,
Pottawatomie,President,Hillary Clinton,DEM,630015,20,48,326,394,
Pottawatomie,U.S. Senate,James Lankford,REP,630015,27,110,692,829,
Pottawatomie,U.S. Senate,Robert Murphy,LIB,630015,2,2,42,46,
Pottawatomie,U.S. Senate,Mike Workman,DEM,630015,15,41,243,299,
Pottawatomie,U.S. Senate,Mark Beard,IND,630015,0,4,28,32,
Pottawatomie,U.S. Senate,Sean Braddy,IND,630015,2,3,33,38,
Pottawatomie,U.S. House,Steve Russell,REP,630015,22,100,615,737,05
Pottawatomie,U.S. House,Zachary Knight,LIB,630015,2,9,81,92,05
Pottawatomie,U.S. House,Al Mcaffrey,DEM,630015,20,50,338,408,05
Pottawatomie,State House,Dell Kerbs,REP,630015,14,87,513,614,26
Pottawatomie,State House,Nick Atwood,DEM,630015,28,70,521,619,26
Pottawatomie,President,Donald Trump,REP,630018,25,96,565,686,
Pottawatomie,President,Gary Johnson,LIB,630018,2,8,84,94,
Pottawatomie,President,Hillary Clinton,DEM,630018,20,31,313,364,
Pottawatomie,U.S. Senate,James Lankford,REP,630018,31,101,653,785,
Pottawatomie,U.S. Senate,Robert Murphy,LIB,630018,1,2,32,35,
Pottawatomie,U.S. Senate,Mike Workman,DEM,630018,16,26,222,264,
Pottawatomie,U.S. Senate,Mark Beard,IND,630018,0,0,23,23,
Pottawatomie,U.S. Senate,Sean Braddy,IND,630018,1,4,27,32,
Pottawatomie,U.S. House,Steve Russell,REP,630018,26,103,584,713,05
Pottawatomie,U.S. House,Zachary Knight,LIB,630018,1,5,80,86,05
Pottawatomie,U.S. House,Al Mcaffrey,DEM,630018,21,26,285,332,05
Pottawatomie,State House,Dell Kerbs,REP,630018,24,87,478,589,26
Pottawatomie,State House,Nick Atwood,DEM,630018,24,47,474,545,26
Pottawatomie,President,Donald Trump,REP,630021,9,34,412,455,
Pottawatomie,President,Gary Johnson,LIB,630021,4,0,23,27,
Pottawatomie,President,Hillary Clinton,DEM,630021,6,9,123,138,
Pottawatomie,U.S. Senate,James Lankford,REP,630021,13,34,443,490,
Pottawatomie,U.S. Senate,Robert Murphy,LIB,630021,0,0,9,9,
Pottawatomie,U.S. Senate,Mike Workman,DEM,630021,3,9,95,107,
Pottawatomie,U.S. Senate,Mark Beard,IND,630021,0,0,2,2,
Pottawatomie,U.S. Senate,Sean Braddy,IND,630021,2,0,8,10,
Pottawatomie,U.S. House,Steve Russell,REP,630021,11,31,414,456,05
Pottawatomie,U.S. House,Zachary Knight,LIB,630021,1,1,22,24,05
Pottawatomie,U.S. House,Al Mcaffrey,DEM,630021,6,11,118,135,05
Pottawatomie,State House,Dell Kerbs,REP,630021,12,32,363,407,26
Pottawatomie,State House,Nick Atwood,DEM,630021,5,11,191,207,26
Pottawatomie,President,Donald Trump,REP,630022,59,181,845,1085,
Pottawatomie,President,Gary Johnson,LIB,630022,3,8,54,65,
Pottawatomie,President,Hillary Clinton,DEM,630022,21,53,160,234,
Pottawatomie,U.S. Senate,James Lankford,REP,630022,63,177,872,1112,
Pottawatomie,U.S. Senate,Robert Murphy,LIB,630022,0,8,29,37,
Pottawatomie,U.S. Senate,Mike Workman,DEM,630022,19,54,122,195,
Pottawatomie,U.S. Senate,Mark Beard,IND,630022,0,4,17,21,
Pottawatomie,U.S. Senate,Sean Braddy,IND,630022,1,0,22,23,
Pottawatomie,U.S. House,Steve Russell,REP,630022,59,174,844,1077,05
Pottawatomie,U.S. House,Zachary Knight,LIB,630022,1,14,60,75,05
Pottawatomie,U.S. House,Al Mcaffrey,DEM,630022,23,52,146,221,05
Pottawatomie,State House,Josh Cockroft,REP,630022,63,172,853,1088,27
Pottawatomie,State House,John Karlin,DEM,630022,19,67,197,283,27
Pottawatomie,President,Donald Trump,REP,630024,73,106,952,1131,
Pottawatomie,President,Gary Johnson,LIB,630024,5,5,45,55,
Pottawatomie,President,Hillary Clinton,DEM,630024,9,35,169,213,
Pottawatomie,U.S. Senate,James Lankford,REP,630024,81,116,966,1163,
Pottawatomie,U.S. Senate,Robert Murphy,LIB,630024,0,1,31,32,
Pottawatomie,U.S. Senate,Mike Workman,DEM,630024,7,29,133,169,
Pottawatomie,U.S. Senate,Mark Beard,IND,630024,0,1,16,17,
Pottawatomie,U.S. Senate,Sean Braddy,IND,630024,1,0,25,26,
Pottawatomie,U.S. House,Steve Russell,REP,630024,80,103,917,1100,05
Pottawatomie,U.S. House,Zachary Knight,LIB,630024,0,3,53,56,05
Pottawatomie,U.S. House,Al Mcaffrey,DEM,630024,10,39,187,236,05
Pottawatomie,State House,Tom Newell,REP,630024,78,107,918,1103,28
Pottawatomie,State House,Marilyn Rainwater,DEM,630024,11,37,237,285,28
Pottawatomie,President,Donald Trump,REP,630025,28,44,554,626,
Pottawatomie,President,Gary Johnson,LIB,630025,0,4,32,36,
Pottawatomie,President,Hillary Clinton,DEM,630025,6,13,130,149,
Pottawatomie,U.S. Senate,James Lankford,REP,630025,29,45,551,625,
Pottawatomie,U.S. Senate,Robert Murphy,LIB,630025,1,0,20,21,
Pottawatomie,U.S. Senate,Mike Workman,DEM,630025,4,15,115,134,
Pottawatomie,U.S. Senate,Mark Beard,IND,630025,0,0,15,15,
Pottawatomie,U.S. Senate,Sean Braddy,IND,630025,0,0,19,19,
Pottawatomie,U.S. House,Steve Russell,REP,630025,29,43,538,610,05
Pottawatomie,U.S. House,Zachary Knight,LIB,630025,0,0,36,36,05
Pottawatomie,U.S. House,Al Mcaffrey,DEM,630025,5,16,145,166,05
Pottawatomie,State House,Tom Newell,REP,630025,27,42,530,599,28
Pottawatomie,State House,Marilyn Rainwater,DEM,630025,6,18,182,206,28
Pottawatomie,President,Donald Trump,REP,630026,50,121,490,661,
Pottawatomie,President,Gary Johnson,LIB,630026,0,3,41,44,
Pottawatomie,President,Hillary Clinton,DEM,630026,16,28,121,165,
Pottawatomie,U.S. Senate,James Lankford,REP,630026,50,134,511,695,
Pottawatomie,U.S. Senate,Robert Murphy,LIB,630026,0,2,14,16,
Pottawatomie,U.S. Senate,Mike Workman,DEM,630026,15,17,80,112,
Pottawatomie,U.S. Senate,Mark Beard,IND,630026,0,2,16,18,
Pottawatomie,U.S. Senate,Sean Braddy,IND,630026,0,3,8,11,
Pottawatomie,U.S. House,Steve Russell,REP,630026,45,124,479,648,05
Pottawatomie,U.S. House,Zachary Knight,LIB,630026,1,5,33,39,05
Pottawatomie,U.S. House,Al Mcaffrey,DEM,630026,19,27,111,157,05
Pottawatomie,State House,Dell Kerbs,REP,630026,45,112,409,566,26
Pottawatomie,State House,Nick Atwood,DEM,630026,20,44,214,278,26
Pottawatomie,President,Donald Trump,REP,630027,8,43,522,573,
Pottawatomie,President,Gary Johnson,LIB,630027,4,1,43,48,
Pottawatomie,President,Hillary Clinton,DEM,630027,5,3,135,143,
Pottawatomie,U.S. Senate,James Lankford,REP,630027,13,43,544,600,
Pottawatomie,U.S. Senate,Robert Murphy,LIB,630027,0,0,20,20,
Pottawatomie,U.S. Senate,Mike Workman,DEM,630027,2,2,97,101,
Pottawatomie,U.S. Senate,Mark Beard,IND,630027,1,0,15,16,
Pottawatomie,U.S. Senate,Sean Braddy,IND,630027,1,1,22,24,
Pottawatomie,U.S. House,Steve Russell,REP,630027,12,42,520,574,05
Pottawatomie,U.S. House,Zachary Knight,LIB,630027,1,1,48,50,05
Pottawatomie,U.S. House,Al Mcaffrey,DEM,630027,3,3,129,135,05
Pottawatomie,State House,Josh Cockroft,REP,630027,10,43,516,569,27
Pottawatomie,State House,John Karlin,DEM,630027,5,3,175,183,27
Pottawatomie,President,Donald Trump,REP,630029,41,93,749,883,
Pottawatomie,President,Gary Johnson,LIB,630029,5,5,75,85,
Pottawatomie,President,Hillary Clinton,DEM,630029,20,42,260,322,
Pottawatomie,U.S. Senate,James Lankford,REP,630029,48,107,802,957,
Pottawatomie,U.S. Senate,Robert Murphy,LIB,630029,1,1,34,36,
Pottawatomie,U.S. Senate,Mike Workman,DEM,630029,14,28,203,245,
Pottawatomie,U.S. Senate,Mark Beard,IND,630029,2,1,18,21,
Pottawatomie,U.S. Senate,Sean Braddy,IND,630029,2,4,24,30,
Pottawatomie,U.S. House,Steve Russell,REP,630029,45,98,730,873,05
Pottawatomie,U.S. House,Zachary Knight,LIB,630029,4,5,54,63,05
Pottawatomie,U.S. House,Al Mcaffrey,DEM,630029,18,36,280,334,05
Pottawatomie,State House,Josh Cockroft,REP,630029,46,103,773,922,27
Pottawatomie,State House,John Karlin,DEM,630029,21,37,294,352,27
Pottawatomie,President,Donald Trump,REP,630030,49,130,993,1172,
Pottawatomie,President,Gary Johnson,LIB,630030,8,12,105,125,
Pottawatomie,President,Hillary Clinton,DEM,630030,18,45,322,385,
Pottawatomie,U.S. Senate,James Lankford,REP,630030,51,142,1062,1255,
Pottawatomie,U.S. Senate,Robert Murphy,LIB,630030,5,5,41,51,
Pottawatomie,U.S. Senate,Mike Workman,DEM,630030,16,33,264,313,
Pottawatomie,U.S. Senate,Mark Beard,IND,630030,2,4,33,39,
Pottawatomie,U.S. Senate,Sean Braddy,IND,630030,1,4,30,35,
Pottawatomie,U.S. House,Steve Russell,REP,630030,50,121,989,1160,05
Pottawatomie,U.S. House,Zachary Knight,LIB,630030,7,14,84,105,05
Pottawatomie,U.S. House,Al Mcaffrey,DEM,630030,18,44,344,406,05
Pottawatomie,State House,Josh Cockroft,REP,630030,55,136,1029,1220,27
Pottawatomie,State House,John Karlin,DEM,630030,18,50,393,461,27
Pottawatomie,President,Donald Trump,REP,630031,99,192,1300,1591,
Pottawatomie,President,Gary Johnson,LIB,630031,11,9,85,105,
Pottawatomie,President,Hillary Clinton,DEM,630031,15,75,318,408,
Pottawatomie,U.S. Senate,James Lankford,REP,630031,113,198,1362,1673,
Pottawatomie,U.S. Senate,Robert Murphy,LIB,630031,1,7,35,43,
Pottawatomie,U.S. Senate,Mike Workman,DEM,630031,7,61,233,301,
Pottawatomie,U.S. Senate,Mark Beard,IND,630031,1,6,30,37,
Pottawatomie,U.S. Senate,Sean Braddy,IND,630031,3,3,43,49,
Pottawatomie,U.S. House,Steve Russell,REP,630031,106,193,1277,1576,05
Pottawatomie,U.S. House,Zachary Knight,LIB,630031,6,16,86,108,05
Pottawatomie,U.S. House,Al Mcaffrey,DEM,630031,13,63,319,395,05
Pottawatomie,State House,Tom Newell,REP,630031,97,198,1267,1562,28
Pottawatomie,State House,Marilyn Rainwater,DEM,630031,25,75,400,500,28
Pottawatomie,President,Donald Trump,REP,630033,11,25,369,405,
Pottawatomie,President,Gary Johnson,LIB,630033,0,2,21,23,
Pottawatomie,President,Hillary Clinton,DEM,630033,1,4,99,104,
Pottawatomie,U.S. Senate,James Lankford,REP,630033,9,25,395,429,
Pottawatomie,U.S. Senate,Robert Murphy,LIB,630033,0,2,10,12,
Pottawatomie,U.S. Senate,Mike Workman,DEM,630033,2,4,73,79,
Pottawatomie,U.S. Senate,Mark Beard,IND,630033,0,0,12,12,
Pottawatomie,U.S. Senate,Sean Braddy,IND,630033,2,0,3,5,
Pottawatomie,U.S. House,Steve Russell,REP,630033,11,24,358,393,05
Pottawatomie,U.S. House,Zachary Knight,LIB,630033,0,3,22,25,05
Pottawatomie,U.S. House,Al Mcaffrey,DEM,630033,2,4,109,115,05
Pottawatomie,State House,Josh Cockroft,REP,630033,10,26,361,397,27
Pottawatomie,State House,John Karlin,DEM,630033,2,5,125,132,27
Pottawatomie,President,Donald Trump,REP,630037,12,16,403,431,
Pottawatomie,President,Gary Johnson,LIB,630037,1,1,19,21,
Pottawatomie,President,Hillary Clinton,DEM,630037,9,1,73,83,
Pottawatomie,U.S. Senate,James Lankford,REP,630037,13,16,392,421,
Pottawatomie,U.S. Senate,Robert Murphy,LIB,630037,0,0,16,16,
Pottawatomie,U.S. Senate,Mike Workman,DEM,630037,8,1,66,75,
Pottawatomie,U.S. Senate,Mark Beard,IND,630037,0,0,15,15,
Pottawatomie,U.S. Senate,Sean Braddy,IND,630037,1,1,8,10,
Pottawatomie,U.S. House,Steve Russell,REP,630037,10,17,386,413,05
Pottawatomie,U.S. House,Zachary Knight,LIB,630037,0,1,26,27,05
Pottawatomie,U.S. House,Al Mcaffrey,DEM,630037,10,0,84,94,05
Pottawatomie,State Senate,Greg Mccortney,REP,630037,10,15,368,393,13
Pottawatomie,State Senate,Eric Hall,DEM,630037,10,3,122,135,13
Pottawatomie,State House,Josh Cockroft,REP,630037,11,16,395,422,27
Pottawatomie,State House,John Karlin,DEM,630037,11,2,94,107,27
Pottawatomie,President,Donald Trump,REP,630038,11,20,265,296,
Pottawatomie,President,Gary Johnson,LIB,630038,0,1,17,18,
Pottawatomie,President,Hillary Clinton,DEM,630038,3,4,77,84,
Pottawatomie,U.S. Senate,James Lankford,REP,630038,9,20,279,308,
Pottawatomie,U.S. Senate,Robert Murphy,LIB,630038,0,0,9,9,
Pottawatomie,U.S. Senate,Mike Workman,DEM,630038,3,6,56,65,
Pottawatomie,U.S. Senate,Mark Beard,IND,630038,1,0,6,7,
Pottawatomie,U.S. Senate,Sean Braddy,IND,630038,1,0,9,10,
Pottawatomie,U.S. House,Steve Russell,REP,630038,11,21,256,288,05
Pottawatomie,U.S. House,Zachary Knight,LIB,630038,0,0,12,12,05
Pottawatomie,U.S. House,Al Mcaffrey,DEM,630038,3,5,88,96,05
Pottawatomie,State Senate,Greg Mccortney,REP,630038,11,21,233,265,13
Pottawatomie,State Senate,Eric Hall,DEM,630038,3,5,120,128,13
Pottawatomie,State House,Josh Cockroft,REP,630038,11,20,263,294,27
Pottawatomie,State House,John Karlin,DEM,630038,3,6,95,104,27
Pottawatomie,President,Donald Trump,REP,630040,6,15,287,308,
Pottawatomie,President,Gary Johnson,LIB,630040,3,0,16,19,
Pottawatomie,President,Hillary Clinton,DEM,630040,7,0,58,65,
Pottawatomie,U.S. Senate,James Lankford,REP,630040,7,14,296,317,
Pottawatomie,U.S. Senate,Robert Murphy,LIB,630040,1,0,7,8,
Pottawatomie,U.S. Senate,Mike Workman,DEM,630040,7,0,46,53,
Pottawatomie,U.S. Senate,Mark Beard,IND,630040,0,1,7,8,
Pottawatomie,U.S. Senate,Sean Braddy,IND,630040,1,0,8,9,
Pottawatomie,U.S. House,Steve Russell,REP,630040,7,13,274,294,05
Pottawatomie,U.S. House,Zachary Knight,LIB,630040,2,1,16,19,05
Pottawatomie,U.S. House,Al Mcaffrey,DEM,630040,7,1,69,77,05
Pottawatomie,State Senate,Greg Mccortney,REP,630040,5,14,263,282,13
Pottawatomie,State Senate,Eric Hall,DEM,630040,11,1,95,107,13
Pottawatomie,State House,Josh Cockroft,REP,630040,5,13,276,294,27
Pottawatomie,State House,John Karlin,DEM,630040,11,2,82,95,27
Pottawatomie,President,Donald Trump,REP,630041,12,14,355,381,
Pottawatomie,President,Gary Johnson,LIB,630041,0,0,14,14,
Pottawatomie,President,Hillary Clinton,DEM,630041,2,5,70,77,
Pottawatomie,U.S. Senate,James Lankford,REP,630041,12,11,357,380,
Pottawatomie,U.S. Senate,Robert Murphy,LIB,630041,0,0,4,4,
Pottawatomie,U.S. Senate,Mike Workman,DEM,630041,1,6,60,67,
Pottawatomie,U.S. Senate,Mark Beard,IND,630041,0,3,5,8,
Pottawatomie,U.S. Senate,Sean Braddy,IND,630041,0,0,6,6,
Pottawatomie,U.S. House,Steve Russell,REP,630041,10,15,330,355,05
Pottawatomie,U.S. House,Zachary Knight,LIB,630041,0,0,13,13,05
Pottawatomie,U.S. House,Al Mcaffrey,DEM,630041,3,5,84,92,05
Pottawatomie,State Senate,Greg Mccortney,REP,630041,12,15,309,336,13
Pottawatomie,State Senate,Eric Hall,DEM,630041,1,5,113,119,13
Pottawatomie,State House,Josh Cockroft,REP,630041,12,14,329,355,27
Pottawatomie,State House,John Karlin,DEM,630041,1,6,94,101,27
Pottawatomie,President,Donald Trump,REP,630042,5,3,229,237,
Pottawatomie,President,Gary Johnson,LIB,630042,0,0,8,8,
Pottawatomie,President,Hillary Clinton,DEM,630042,2,1,34,37,
Pottawatomie,U.S. Senate,James Lankford,REP,630042,5,4,224,233,
Pottawatomie,U.S. Senate,Robert Murphy,LIB,630042,0,0,4,4,
Pottawatomie,U.S. Senate,Mike Workman,DEM,630042,2,0,36,38,
Pottawatomie,U.S. Senate,Mark Beard,IND,630042,0,0,6,6,
Pottawatomie,U.S. Senate,Sean Braddy,IND,630042,0,1,4,5,
Pottawatomie,U.S. House,Steve Russell,REP,630042,6,3,218,227,05
Pottawatomie,U.S. House,Zachary Knight,LIB,630042,0,1,8,9,05
Pottawatomie,U.S. House,Al Mcaffrey,DEM,630042,1,1,47,49,05
Pottawatomie,State Senate,Greg Mccortney,REP,630042,5,4,204,213,13
Pottawatomie,State Senate,Eric Hall,DEM,630042,2,1,67,70,13
Pottawatomie,State House,Bobby Cleveland,REP,630042,5,3,190,198,20
Pottawatomie,State House,Matt Failing,DEM,630042,2,2,80,84,20
Pushmataha,President,Donald Trump,REP,640001,7,67,194,268,
Pushmataha,President,Gary Johnson,LIB,640001,0,0,14,14,
Pushmataha,President,Hillary Clinton,DEM,640001,5,9,48,62,
Pushmataha,U.S. Senate,James Lankford,REP,640001,7,52,167,226,
Pushmataha,U.S. Senate,Robert Murphy,LIB,640001,0,3,13,16,
Pushmataha,U.S. Senate,Mike Workman,DEM,640001,5,11,57,73,
Pushmataha,U.S. Senate,Mark Beard,IND,640001,0,3,4,7,
Pushmataha,U.S. Senate,Sean Braddy,IND,640001,0,7,5,12,
Pushmataha,U.S. House,Markwayne Mullin,REP,640001,7,58,184,249,02
Pushmataha,U.S. House,Joshua Harris-Till,DEM,640001,5,12,48,65,02
Pushmataha,U.S. House,John Mccarthy,IND,640001,0,7,16,23,02
Pushmataha,State Senate,Joseph Silk,REP,640001,5,56,149,210,5
Pushmataha,State Senate,Stacey Allen Ebert,DEM,640001,6,21,100,127,5
Pushmataha,State House,Justin Humphrey,REP,640001,5,32,87,124,19
Pushmataha,State House,James Albert Campbell,DEM,640001,7,18,71,96,19
Pushmataha,State House,Morgan Hopson,IND,640001,0,28,94,122,19
Pushmataha,President,Donald Trump,REP,640002,27,172,417,616,
Pushmataha,President,Gary Johnson,LIB,640002,0,5,20,25,
Pushmataha,President,Hillary Clinton,DEM,640002,5,54,91,150,
Pushmataha,U.S. Senate,James Lankford,REP,640002,23,141,355,519,
Pushmataha,U.S. Senate,Robert Murphy,LIB,640002,0,4,18,22,
Pushmataha,U.S. Senate,Mike Workman,DEM,640002,6,66,111,183,
Pushmataha,U.S. Senate,Mark Beard,IND,640002,1,5,17,23,
Pushmataha,U.S. Senate,Sean Braddy,IND,640002,0,2,15,17,
Pushmataha,U.S. House,Markwayne Mullin,REP,640002,24,153,364,541,02
Pushmataha,U.S. House,Joshua Harris-Till,DEM,640002,4,58,94,156,02
Pushmataha,U.S. House,John Mccarthy,IND,640002,0,10,62,72,02
Pushmataha,State Senate,Joseph Silk,REP,640002,21,126,319,466,5
Pushmataha,State Senate,Stacey Allen Ebert,DEM,640002,9,100,202,311,5
Pushmataha,State House,Justin Humphrey,REP,640002,14,87,215,316,19
Pushmataha,State House,James Albert Campbell,DEM,640002,9,79,147,235,19
Pushmataha,State House,Morgan Hopson,IND,640002,7,58,157,222,19
Pushmataha,President,Donald Trump,REP,640003,1,51,240,292,
Pushmataha,President,Gary Johnson,LIB,640003,1,2,12,15,
Pushmataha,President,Hillary Clinton,DEM,640003,0,9,62,71,
Pushmataha,U.S. Senate,James Lankford,REP,640003,1,45,207,253,
Pushmataha,U.S. Senate,Robert Murphy,LIB,640003,0,0,5,5,
Pushmataha,U.S. Senate,Mike Workman,DEM,640003,0,13,75,88,
Pushmataha,U.S. Senate,Mark Beard,IND,640003,0,1,8,9,
Pushmataha,U.S. Senate,Sean Braddy,IND,640003,1,0,9,10,
Pushmataha,U.S. House,Markwayne Mullin,REP,640003,2,46,217,265,02
Pushmataha,U.S. House,Joshua Harris-Till,DEM,640003,0,9,61,70,02
Pushmataha,U.S. House,John Mccarthy,IND,640003,0,5,31,36,02
Pushmataha,State Senate,Joseph Silk,REP,640003,2,43,197,242,5
Pushmataha,State Senate,Stacey Allen Ebert,DEM,640003,0,18,117,135,5
Pushmataha,State House,Justin Humphrey,REP,640003,1,27,111,139,19
Pushmataha,State House,James Albert Campbell,DEM,640003,0,19,92,111,19
Pushmataha,State House,Morgan Hopson,IND,640003,1,14,114,129,19
Pushmataha,President,Donald Trump,REP,640004,8,61,321,390,
Pushmataha,President,Gary Johnson,LIB,640004,0,6,20,26,
Pushmataha,President,Hillary Clinton,DEM,640004,4,12,67,83,
Pushmataha,U.S. Senate,James Lankford,REP,640004,8,56,294,358,
Pushmataha,U.S. Senate,Robert Murphy,LIB,640004,0,2,8,10,
Pushmataha,U.S. Senate,Mike Workman,DEM,640004,3,20,70,93,
Pushmataha,U.S. Senate,Mark Beard,IND,640004,0,0,5,5,
Pushmataha,U.S. Senate,Sean Braddy,IND,640004,0,3,10,13,
Pushmataha,U.S. House,Markwayne Mullin,REP,640004,9,59,305,373,02
Pushmataha,U.S. House,Joshua Harris-Till,DEM,640004,3,18,69,90,02
Pushmataha,U.S. House,John Mccarthy,IND,640004,0,4,23,27,02
Pushmataha,State Senate,Joseph Silk,REP,640004,9,52,263,324,5
Pushmataha,State Senate,Stacey Allen Ebert,DEM,640004,4,26,138,168,5
Pushmataha,State House,Justin Humphrey,REP,640004,5,44,153,202,19
Pushmataha,State House,James Albert Campbell,DEM,640004,5,22,92,119,19
Pushmataha,State House,Morgan Hopson,IND,640004,2,14,153,169,19
Pushmataha,President,Donald Trump,REP,640005,2,9,51,62,
Pushmataha,President,Gary Johnson,LIB,640005,0,2,1,3,
Pushmataha,President,Hillary Clinton,DEM,640005,0,2,6,8,
Pushmataha,U.S. Senate,James Lankford,REP,640005,2,5,40,47,
Pushmataha,U.S. Senate,Robert Murphy,LIB,640005,0,2,4,6,
Pushmataha,U.S. Senate,Mike Workman,DEM,640005,0,5,10,15,
Pushmataha,U.S. Senate,Mark Beard,IND,640005,0,0,2,2,
Pushmataha,U.S. Senate,Sean Braddy,IND,640005,0,0,0,0,
Pushmataha,U.S. House,Markwayne Mullin,REP,640005,2,11,45,58,02
Pushmataha,U.S. House,Joshua Harris-Till,DEM,640005,0,2,8,10,02
Pushmataha,U.S. House,John Mccarthy,IND,640005,0,0,4,4,02
Pushmataha,State Senate,Joseph Silk,REP,640005,2,7,45,54,5
Pushmataha,State Senate,Stacey Allen Ebert,DEM,640005,0,5,12,17,5
Pushmataha,State House,Justin Humphrey,REP,640005,2,4,37,43,19
Pushmataha,State House,James Albert Campbell,DEM,640005,0,3,8,11,19
Pushmataha,State House,Morgan Hopson,IND,640005,0,6,12,18,19
Pushmataha,President,Donald Trump,REP,640007,1,22,110,133,
Pushmataha,President,Gary Johnson,LIB,640007,0,0,2,2,
Pushmataha,President,Hillary Clinton,DEM,640007,0,4,35,39,
Pushmataha,U.S. Senate,James Lankford,REP,640007,1,19,97,117,
Pushmataha,U.S. Senate,Robert Murphy,LIB,640007,0,1,4,5,
Pushmataha,U.S. Senate,Mike Workman,DEM,640007,0,6,34,40,
Pushmataha,U.S. Senate,Mark Beard,IND,640007,0,0,1,1,
Pushmataha,U.S. Senate,Sean Braddy,IND,640007,0,0,4,4,
Pushmataha,U.S. House,Markwayne Mullin,REP,640007,1,16,107,124,02
Pushmataha,U.S. House,Joshua Harris-Till,DEM,640007,0,6,23,29,02
Pushmataha,U.S. House,John Mccarthy,IND,640007,0,4,10,14,02
Pushmataha,State Senate,Joseph Silk,REP,640007,1,17,90,108,5
Pushmataha,State Senate,Stacey Allen Ebert,DEM,640007,0,8,49,57,5
Pushmataha,State House,Justin Humphrey,REP,640007,0,18,71,89,19
Pushmataha,State House,James Albert Campbell,DEM,640007,1,4,38,43,19
Pushmataha,State House,Morgan Hopson,IND,640007,0,4,33,37,19
Pushmataha,President,Donald Trump,REP,640008,9,12,106,127,
Pushmataha,President,Gary Johnson,LIB,640008,0,0,1,1,
Pushmataha,President,Hillary Clinton,DEM,640008,0,0,29,29,
Pushmataha,U.S. Senate,James Lankford,REP,640008,8,11,86,105,
Pushmataha,U.S. Senate,Robert Murphy,LIB,640008,0,0,5,5,
Pushmataha,U.S. Senate,Mike Workman,DEM,640008,0,0,36,36,
Pushmataha,U.S. Senate,Mark Beard,IND,640008,0,0,1,1,
Pushmataha,U.S. Senate,Sean Braddy,IND,640008,0,0,3,3,
Pushmataha,U.S. House,Markwayne Mullin,REP,640008,10,11,98,119,02
Pushmataha,U.S. House,Joshua Harris-Till,DEM,640008,0,0,26,26,02
Pushmataha,U.S. House,John Mccarthy,IND,640008,0,0,8,8,02
Pushmataha,State Senate,Joseph Silk,REP,640008,10,11,72,93,5
Pushmataha,State Senate,Stacey Allen Ebert,DEM,640008,0,0,57,57,5
Pushmataha,State House,Justin Humphrey,REP,640008,4,8,58,70,19
Pushmataha,State House,James Albert Campbell,DEM,640008,4,1,41,46,19
Pushmataha,State House,Morgan Hopson,IND,640008,2,2,32,36,19
Pushmataha,President,Donald Trump,REP,640009,2,7,158,167,
Pushmataha,President,Gary Johnson,LIB,640009,0,0,5,5,
Pushmataha,President,Hillary Clinton,DEM,640009,0,0,36,36,
Pushmataha,U.S. Senate,James Lankford,REP,640009,1,7,118,126,
Pushmataha,U.S. Senate,Robert Murphy,LIB,640009,0,0,8,8,
Pushmataha,U.S. Senate,Mike Workman,DEM,640009,0,0,57,57,
Pushmataha,U.S. Senate,Mark Beard,IND,640009,1,0,2,3,
Pushmataha,U.S. Senate,Sean Braddy,IND,640009,0,0,5,5,
Pushmataha,U.S. House,Markwayne Mullin,REP,640009,1,6,135,142,02
Pushmataha,U.S. House,Joshua Harris-Till,DEM,640009,1,0,51,52,02
Pushmataha,U.S. House,John Mccarthy,IND,640009,0,0,9,9,02
Pushmataha,State Senate,Joseph Silk,REP,640009,2,6,124,132,5
Pushmataha,State Senate,Stacey Allen Ebert,DEM,640009,0,1,74,75,5
Pushmataha,State House,Justin Humphrey,REP,640009,2,6,89,97,19
Pushmataha,State House,James Albert Campbell,DEM,640009,0,0,61,61,19
Pushmataha,State House,Morgan Hopson,IND,640009,0,0,44,44,19
Pushmataha,President,Donald Trump,REP,640010,3,4,84,91,
Pushmataha,President,Gary Johnson,LIB,640010,1,1,2,4,
Pushmataha,President,Hillary Clinton,DEM,640010,0,2,17,19,
Pushmataha,U.S. Senate,James Lankford,REP,640010,4,4,74,82,
Pushmataha,U.S. Senate,Robert Murphy,LIB,640010,0,0,0,0,
Pushmataha,U.S. Senate,Mike Workman,DEM,640010,0,3,22,25,
Pushmataha,U.S. Senate,Mark Beard,IND,640010,0,0,0,0,
Pushmataha,U.S. Senate,Sean Braddy,IND,640010,0,0,7,7,
Pushmataha,U.S. House,Markwayne Mullin,REP,640010,4,4,79,87,02
Pushmataha,U.S. House,Joshua Harris-Till,DEM,640010,0,2,20,22,02
Pushmataha,U.S. House,John Mccarthy,IND,640010,0,1,3,4,02
Pushmataha,State Senate,Joseph Silk,REP,640010,2,3,64,69,5
Pushmataha,State Senate,Stacey Allen Ebert,DEM,640010,2,4,39,45,5
Pushmataha,State House,Justin Humphrey,REP,640010,3,3,50,56,19
Pushmataha,State House,James Albert Campbell,DEM,640010,1,4,25,30,19
Pushmataha,State House,Morgan Hopson,IND,640010,0,0,28,28,19
Pushmataha,President,Donald Trump,REP,640011,10,36,439,485,
Pushmataha,President,Gary Johnson,LIB,640011,0,2,11,13,
Pushmataha,President,Hillary Clinton,DEM,640011,1,7,50,58,
Pushmataha,U.S. Senate,James Lankford,REP,640011,9,33,390,432,
Pushmataha,U.S. Senate,Robert Murphy,LIB,640011,0,1,9,10,
Pushmataha,U.S. Senate,Mike Workman,DEM,640011,1,8,71,80,
Pushmataha,U.S. Senate,Mark Beard,IND,640011,0,1,4,5,
Pushmataha,U.S. Senate,Sean Braddy,IND,640011,1,0,14,15,
Pushmataha,U.S. House,Markwayne Mullin,REP,640011,10,37,394,441,02
Pushmataha,U.S. House,Joshua Harris-Till,DEM,640011,1,3,60,64,02
Pushmataha,U.S. House,John Mccarthy,IND,640011,0,3,34,37,02
Pushmataha,State Senate,Joseph Silk,REP,640011,10,24,296,330,5
Pushmataha,State Senate,Stacey Allen Ebert,DEM,640011,1,19,193,213,5
Pushmataha,State House,Justin Humphrey,REP,640011,8,24,241,273,19
Pushmataha,State House,James Albert Campbell,DEM,640011,1,16,168,185,19
Pushmataha,State House,Morgan Hopson,IND,640011,2,3,83,88,19
Pushmataha,President,Donald Trump,REP,640012,3,3,80,86,
Pushmataha,President,Gary Johnson,LIB,640012,0,0,3,3,
Pushmataha,President,Hillary Clinton,DEM,640012,1,1,13,15,
Pushmataha,U.S. Senate,James Lankford,REP,640012,3,2,67,72,
Pushmataha,U.S. Senate,Robert Murphy,LIB,640012,0,0,1,1,
Pushmataha,U.S. Senate,Mike Workman,DEM,640012,1,1,21,23,
Pushmataha,U.S. Senate,Mark Beard,IND,640012,0,0,2,2,
Pushmataha,U.S. Senate,Sean Braddy,IND,640012,0,1,3,4,
Pushmataha,U.S. House,Markwayne Mullin,REP,640012,3,2,75,80,02
Pushmataha,U.S. House,Joshua Harris-Till,DEM,640012,1,1,16,18,02
Pushmataha,U.S. House,John Mccarthy,IND,640012,0,1,4,5,02
Pushmataha,State Senate,Joseph Silk,REP,640012,3,2,52,57,5
Pushmataha,State Senate,Stacey Allen Ebert,DEM,640012,1,2,43,46,5
Pushmataha,State House,Justin Humphrey,REP,640012,3,3,44,50,19
Pushmataha,State House,James Albert Campbell,DEM,640012,1,1,42,44,19
Pushmataha,State House,Morgan Hopson,IND,640012,0,0,8,8,19
Pushmataha,President,Donald Trump,REP,640013,0,0,41,41,
Pushmataha,President,Gary Johnson,LIB,640013,0,0,2,2,
Pushmataha,President,Hillary Clinton,DEM,640013,0,0,9,9,
Pushmataha,U.S. Senate,James Lankford,REP,640013,0,0,38,38,
Pushmataha,U.S. Senate,Robert Murphy,LIB,640013,0,0,0,0,
Pushmataha,U.S. Senate,Mike Workman,DEM,640013,0,0,11,11,
Pushmataha,U.S. Senate,Mark Beard,IND,640013,0,0,2,2,
Pushmataha,U.S. Senate,Sean Braddy,IND,640013,0,0,1,1,
Pushmataha,U.S. House,Markwayne Mullin,REP,640013,0,0,37,37,02
Pushmataha,U.S. House,Joshua Harris-Till,DEM,640013,0,0,10,10,02
Pushmataha,U.S. House,John Mccarthy,IND,640013,0,0,5,5,02
Pushmataha,State Senate,Joseph Silk,REP,640013,0,0,38,38,5
Pushmataha,State Senate,Stacey Allen Ebert,DEM,640013,0,0,13,13,5
Pushmataha,State House,Justin Humphrey,REP,640013,0,0,37,37,19
Pushmataha,State House,James Albert Campbell,DEM,640013,0,0,9,9,19
Pushmataha,State House,Morgan Hopson,IND,640013,0,0,4,4,19
Pushmataha,President,Donald Trump,REP,640014,2,5,89,96,
Pushmataha,President,Gary Johnson,LIB,640014,0,0,7,7,
Pushmataha,President,Hillary Clinton,DEM,640014,0,0,5,5,
Pushmataha,U.S. Senate,James Lankford,REP,640014,2,4,77,83,
Pushmataha,U.S. Senate,Robert Murphy,LIB,640014,0,0,3,3,
Pushmataha,U.S. Senate,Mike Workman,DEM,640014,0,0,8,8,
Pushmataha,U.S. Senate,Mark Beard,IND,640014,0,0,2,2,
Pushmataha,U.S. Senate,Sean Braddy,IND,640014,0,1,4,5,
Pushmataha,U.S. House,Markwayne Mullin,REP,640014,2,4,81,87,02
Pushmataha,U.S. House,Joshua Harris-Till,DEM,640014,0,0,8,8,02
Pushmataha,U.S. House,John Mccarthy,IND,640014,0,1,9,10,02
Pushmataha,State Senate,Joseph Silk,REP,640014,2,5,54,61,5
Pushmataha,State Senate,Stacey Allen Ebert,DEM,640014,0,0,40,40,5
Pushmataha,State House,Justin Humphrey,REP,640014,2,3,61,66,19
Pushmataha,State House,James Albert Campbell,DEM,640014,0,0,18,18,19
Pushmataha,State House,Morgan Hopson,IND,640014,0,2,16,18,19
Pushmataha,President,Donald Trump,REP,640015,15,25,403,443,
Pushmataha,President,Gary Johnson,LIB,640015,1,2,14,17,
Pushmataha,President,Hillary Clinton,DEM,640015,10,4,77,91,
Pushmataha,U.S. Senate,James Lankford,REP,640015,14,24,319,357,
Pushmataha,U.S. Senate,Robert Murphy,LIB,640015,0,0,14,14,
Pushmataha,U.S. Senate,Mike Workman,DEM,640015,11,6,123,140,
Pushmataha,U.S. Senate,Mark Beard,IND,640015,0,0,9,9,
Pushmataha,U.S. Senate,Sean Braddy,IND,640015,0,1,14,15,
Pushmataha,U.S. House,Markwayne Mullin,REP,640015,13,22,354,389,02
Pushmataha,U.S. House,Joshua Harris-Till,DEM,640015,11,5,97,113,02
Pushmataha,U.S. House,John Mccarthy,IND,640015,1,4,31,36,02
Pushmataha,State Senate,Joseph Silk,REP,640015,12,17,304,333,5
Pushmataha,State Senate,Stacey Allen Ebert,DEM,640015,12,14,174,200,5
Pushmataha,State House,Justin Humphrey,REP,640015,15,21,268,304,19
Pushmataha,State House,James Albert Campbell,DEM,640015,9,7,152,168,19
Pushmataha,State House,Morgan Hopson,IND,640015,0,3,57,60,19
Pushmataha,President,Donald Trump,REP,640016,12,3,116,131,
Pushmataha,President,Gary Johnson,LIB,640016,1,0,9,10,
Pushmataha,President,Hillary Clinton,DEM,640016,4,2,20,26,
Pushmataha,U.S. Senate,James Lankford,REP,640016,11,4,103,118,
Pushmataha,U.S. Senate,Robert Murphy,LIB,640016,0,0,4,4,
Pushmataha,U.S. Senate,Mike Workman,DEM,640016,4,1,32,37,
Pushmataha,U.S. Senate,Mark Beard,IND,640016,0,0,1,1,
Pushmataha,U.S. Senate,Sean Braddy,IND,640016,1,0,0,1,
Pushmataha,U.S. House,Markwayne Mullin,REP,640016,11,3,117,131,02
Pushmataha,U.S. House,Joshua Harris-Till,DEM,640016,4,2,19,25,02
Pushmataha,U.S. House,John Mccarthy,IND,640016,1,0,3,4,02
Pushmataha,State Senate,Joseph Silk,REP,640016,11,2,112,125,5
Pushmataha,State Senate,Stacey Allen Ebert,DEM,640016,5,3,26,34,5
Pushmataha,State House,Justin Humphrey,REP,640016,12,2,94,108,19
Pushmataha,State House,James Albert Campbell,DEM,640016,4,3,35,42,19
Pushmataha,State House,Morgan Hopson,IND,640016,0,0,9,9,19
Pushmataha,President,Donald Trump,REP,640017,9,4,140,153,
Pushmataha,President,Gary Johnson,LIB,640017,0,0,7,7,
Pushmataha,President,Hillary Clinton,DEM,640017,1,2,44,47,
Pushmataha,U.S. Senate,James Lankford,REP,640017,9,4,115,128,
Pushmataha,U.S. Senate,Robert Murphy,LIB,640017,0,1,6,7,
Pushmataha,U.S. Senate,Mike Workman,DEM,640017,1,0,61,62,
Pushmataha,U.S. Senate,Mark Beard,IND,640017,0,1,4,5,
Pushmataha,U.S. Senate,Sean Braddy,IND,640017,0,0,4,4,
Pushmataha,U.S. House,Markwayne Mullin,REP,640017,10,4,124,138,02
Pushmataha,U.S. House,Joshua Harris-Till,DEM,640017,0,2,55,57,02
Pushmataha,U.S. House,John Mccarthy,IND,640017,0,0,10,10,02
Pushmataha,State Senate,Joseph Silk,REP,640017,9,4,120,133,5
Pushmataha,State Senate,Stacey Allen Ebert,DEM,640017,1,2,70,73,5
Pushmataha,State House,Justin Humphrey,REP,640017,9,5,108,122,19
Pushmataha,State House,James Albert Campbell,DEM,640017,1,1,69,71,19
Pushmataha,State House,Morgan Hopson,IND,640017,0,0,14,14,19
Roger Mills,President,Donald Trump,REP,650101,5,22,128,155,
Roger Mills,President,Gary Johnson,LIB,650101,0,1,3,4,
Roger Mills,President,Hillary Clinton,DEM,650101,1,0,12,13,
Roger Mills,U.S. Senate,James Lankford,REP,650101,7,20,128,155,
Roger Mills,U.S. Senate,Robert Murphy,LIB,650101,0,2,0,2,
Roger Mills,U.S. Senate,Mike Workman,DEM,650101,1,0,10,11,
Roger Mills,U.S. Senate,Mark Beard,IND,650101,0,0,4,4,
Roger Mills,U.S. Senate,Sean Braddy,IND,650101,0,0,1,1,
Roger Mills,U.S. House,Frank Lucas,REP,650101,7,17,127,151,03
Roger Mills,U.S. House,Frankie Robbins,DEM,650101,1,4,17,22,03
Roger Mills,State House,Todd Russ,REP,650101,7,14,87,108,55
Roger Mills,State House,Wayne Walters,DEM,650101,1,8,56,65,55
Roger Mills,President,Donald Trump,REP,650102,8,23,108,139,
Roger Mills,President,Gary Johnson,LIB,650102,1,0,5,6,
Roger Mills,President,Hillary Clinton,DEM,650102,1,1,10,12,
Roger Mills,U.S. Senate,James Lankford,REP,650102,9,22,104,135,
Roger Mills,U.S. Senate,Robert Murphy,LIB,650102,1,1,4,6,
Roger Mills,U.S. Senate,Mike Workman,DEM,650102,0,1,11,12,
Roger Mills,U.S. Senate,Mark Beard,IND,650102,0,0,2,2,
Roger Mills,U.S. Senate,Sean Braddy,IND,650102,0,0,0,0,
Roger Mills,U.S. House,Frank Lucas,REP,650102,8,20,108,136,03
Roger Mills,U.S. House,Frankie Robbins,DEM,650102,2,3,13,18,03
Roger Mills,State House,Todd Russ,REP,650102,5,13,70,88,55
Roger Mills,State House,Wayne Walters,DEM,650102,5,11,50,66,55
Roger Mills,President,Donald Trump,REP,650103,7,34,181,222,
Roger Mills,President,Gary Johnson,LIB,650103,1,3,7,11,
Roger Mills,President,Hillary Clinton,DEM,650103,2,8,20,30,
Roger Mills,U.S. Senate,James Lankford,REP,650103,8,34,184,226,
Roger Mills,U.S. Senate,Robert Murphy,LIB,650103,0,2,2,4,
Roger Mills,U.S. Senate,Mike Workman,DEM,650103,2,8,18,28,
Roger Mills,U.S. Senate,Mark Beard,IND,650103,0,0,1,1,
Roger Mills,U.S. Senate,Sean Braddy,IND,650103,0,0,3,3,
Roger Mills,U.S. House,Frank Lucas,REP,650103,8,35,193,236,03
Roger Mills,U.S. House,Frankie Robbins,DEM,650103,2,8,15,25,03
Roger Mills,State House,Todd Russ,REP,650103,5,18,117,140,55
Roger Mills,State House,Wayne Walters,DEM,650103,5,27,90,122,55
Roger Mills,President,Donald Trump,REP,650201,9,10,325,344,
Roger Mills,President,Gary Johnson,LIB,650201,1,1,15,17,
Roger Mills,President,Hillary Clinton,DEM,650201,2,1,50,53,
Roger Mills,U.S. Senate,James Lankford,REP,650201,9,11,323,343,
Roger Mills,U.S. Senate,Robert Murphy,LIB,650201,0,0,8,8,
Roger Mills,U.S. Senate,Mike Workman,DEM,650201,2,1,48,51,
Roger Mills,U.S. Senate,Mark Beard,IND,650201,0,0,3,3,
Roger Mills,U.S. Senate,Sean Braddy,IND,650201,1,0,3,4,
Roger Mills,U.S. House,Frank Lucas,REP,650201,9,12,333,354,03
Roger Mills,U.S. House,Frankie Robbins,DEM,650201,3,0,51,54,03
Roger Mills,State House,Todd Russ,REP,650201,3,6,169,178,55
Roger Mills,State House,Wayne Walters,DEM,650201,9,6,218,233,55
Roger Mills,President,Donald Trump,REP,650202,4,22,64,90,
Roger Mills,President,Gary Johnson,LIB,650202,1,1,2,4,
Roger Mills,President,Hillary Clinton,DEM,650202,1,1,2,4,
Roger Mills,U.S. Senate,James Lankford,REP,650202,8,21,63,92,
Roger Mills,U.S. Senate,Robert Murphy,LIB,650202,0,2,1,3,
Roger Mills,U.S. Senate,Mike Workman,DEM,650202,0,3,3,6,
Roger Mills,U.S. Senate,Mark Beard,IND,650202,0,0,0,0,
Roger Mills,U.S. Senate,Sean Braddy,IND,650202,0,0,0,0,
Roger Mills,U.S. House,Frank Lucas,REP,650202,8,25,61,94,03
Roger Mills,U.S. House,Frankie Robbins,DEM,650202,0,1,7,8,03
Roger Mills,State House,Todd Russ,REP,650202,5,10,32,47,55
Roger Mills,State House,Wayne Walters,DEM,650202,3,16,36,55,55
Roger Mills,President,Donald Trump,REP,650203,7,1,82,90,
Roger Mills,President,Gary Johnson,LIB,650203,0,0,3,3,
Roger Mills,President,Hillary Clinton,DEM,650203,0,2,4,6,
Roger Mills,U.S. Senate,James Lankford,REP,650203,6,1,85,92,
Roger Mills,U.S. Senate,Robert Murphy,LIB,650203,0,0,1,1,
Roger Mills,U.S. Senate,Mike Workman,DEM,650203,0,2,2,4,
Roger Mills,U.S. Senate,Mark Beard,IND,650203,0,0,1,1,
Roger Mills,U.S. Senate,Sean Braddy,IND,650203,0,0,0,0,
Roger Mills,U.S. House,Frank Lucas,REP,650203,6,1,73,80,03
Roger Mills,U.S. House,Frankie Robbins,DEM,650203,0,2,13,15,03
Roger Mills,State House,Todd Russ,REP,650203,5,0,50,55,55
Roger Mills,State House,Wayne Walters,DEM,650203,1,3,36,40,55
Roger Mills,President,Donald Trump,REP,650301,5,17,134,156,
Roger Mills,President,Gary Johnson,LIB,650301,0,1,4,5,
Roger Mills,President,Hillary Clinton,DEM,650301,0,1,8,9,
Roger Mills,U.S. Senate,James Lankford,REP,650301,6,18,124,148,
Roger Mills,U.S. Senate,Robert Murphy,LIB,650301,0,0,3,3,
Roger Mills,U.S. Senate,Mike Workman,DEM,650301,0,0,10,10,
Roger Mills,U.S. Senate,Mark Beard,IND,650301,0,1,0,1,
Roger Mills,U.S. Senate,Sean Braddy,IND,650301,0,0,4,4,
Roger Mills,U.S. House,Frank Lucas,REP,650301,6,17,133,156,03
Roger Mills,U.S. House,Frankie Robbins,DEM,650301,0,2,9,11,03
Roger Mills,State House,Todd Russ,REP,650301,6,12,92,110,55
Roger Mills,State House,Wayne Walters,DEM,650301,0,7,49,56,55
Roger Mills,President,Donald Trump,REP,650302,5,20,133,158,
Roger Mills,President,Gary Johnson,LIB,650302,0,0,0,0,
Roger Mills,President,Hillary Clinton,DEM,650302,1,1,5,7,
Roger Mills,U.S. Senate,James Lankford,REP,650302,5,17,132,154,
Roger Mills,U.S. Senate,Robert Murphy,LIB,650302,0,0,1,1,
Roger Mills,U.S. Senate,Mike Workman,DEM,650302,0,3,4,7,
Roger Mills,U.S. Senate,Mark Beard,IND,650302,0,0,1,1,
Roger Mills,U.S. Senate,Sean Braddy,IND,650302,0,0,1,1,
Roger Mills,U.S. House,Frank Lucas,REP,650302,5,18,123,146,03
Roger Mills,U.S. House,Frankie Robbins,DEM,650302,0,3,15,18,03
Roger Mills,State House,Todd Russ,REP,650302,3,10,102,115,55
Roger Mills,State House,Wayne Walters,DEM,650302,2,11,36,49,55
Roger Mills,President,Donald Trump,REP,650303,6,46,141,193,
Roger Mills,President,Gary Johnson,LIB,650303,2,1,8,11,
Roger Mills,President,Hillary Clinton,DEM,650303,0,2,15,17,
Roger Mills,U.S. Senate,James Lankford,REP,650303,7,44,141,192,
Roger Mills,U.S. Senate,Robert Murphy,LIB,650303,1,0,4,5,
Roger Mills,U.S. Senate,Mike Workman,DEM,650303,0,4,11,15,
Roger Mills,U.S. Senate,Mark Beard,IND,650303,0,0,4,4,
Roger Mills,U.S. Senate,Sean Braddy,IND,650303,0,0,3,3,
Roger Mills,U.S. House,Frank Lucas,REP,650303,8,44,149,201,03
Roger Mills,U.S. House,Frankie Robbins,DEM,650303,0,5,15,20,03
Roger Mills,State House,Todd Russ,REP,650303,3,26,89,118,55
Roger Mills,State House,Wayne Walters,DEM,650303,4,22,74,100,55
Rogers,President,Donald Trump,REP,660001,49,200,805,1054,
Rogers,President,Gary Johnson,LIB,660001,8,12,85,105,
Rogers,President,Hillary Clinton,DEM,660001,46,86,299,431,
Rogers,U.S. Senate,James Lankford,REP,660001,55,208,806,1069,
Rogers,U.S. Senate,Robert Murphy,LIB,660001,4,5,49,58,
Rogers,U.S. Senate,Mike Workman,DEM,660001,40,75,247,362,
Rogers,U.S. Senate,Mark Beard,IND,660001,2,4,43,49,
Rogers,U.S. Senate,Sean Braddy,IND,660001,0,3,47,50,
Rogers,U.S. House,Markwayne Mullin,REP,660001,64,209,826,1099,02
Rogers,U.S. House,Joshua Harris-Till,DEM,660001,39,76,266,381,02
Rogers,U.S. House,John Mccarthy,IND,660001,2,10,99,111,02
Rogers,President,Donald Trump,REP,660002,18,100,433,551,
Rogers,President,Gary Johnson,LIB,660002,3,7,56,66,
Rogers,President,Hillary Clinton,DEM,660002,12,44,159,215,
Rogers,U.S. Senate,James Lankford,REP,660002,20,103,431,554,
Rogers,U.S. Senate,Robert Murphy,LIB,660002,2,3,26,31,
Rogers,U.S. Senate,Mike Workman,DEM,660002,9,35,145,189,
Rogers,U.S. Senate,Mark Beard,IND,660002,0,3,18,21,
Rogers,U.S. Senate,Sean Braddy,IND,660002,3,7,24,34,
Rogers,U.S. House,Markwayne Mullin,REP,660002,19,99,422,540,02
Rogers,U.S. House,Joshua Harris-Till,DEM,660002,10,41,154,205,02
Rogers,U.S. House,John Mccarthy,IND,660002,4,12,67,83,02
Rogers,President,Donald Trump,REP,660003,31,148,577,756,
Rogers,President,Gary Johnson,LIB,660003,2,8,53,63,
Rogers,President,Hillary Clinton,DEM,660003,22,34,167,223,
Rogers,U.S. Senate,James Lankford,REP,660003,31,147,581,759,
Rogers,U.S. Senate,Robert Murphy,LIB,660003,2,4,23,29,
Rogers,U.S. Senate,Mike Workman,DEM,660003,18,35,142,195,
Rogers,U.S. Senate,Mark Beard,IND,660003,3,2,16,21,
Rogers,U.S. Senate,Sean Braddy,IND,660003,3,2,27,32,
Rogers,U.S. House,Markwayne Mullin,REP,660003,34,139,575,748,02
Rogers,U.S. House,Joshua Harris-Till,DEM,660003,19,35,144,198,02
Rogers,U.S. House,John Mccarthy,IND,660003,3,15,69,87,02
Rogers,President,Donald Trump,REP,660004,52,175,845,1072,
Rogers,President,Gary Johnson,LIB,660004,6,12,75,93,
Rogers,President,Hillary Clinton,DEM,660004,29,71,275,375,
Rogers,U.S. Senate,James Lankford,REP,660004,61,195,869,1125,
Rogers,U.S. Senate,Robert Murphy,LIB,660004,2,3,38,43,
Rogers,U.S. Senate,Mike Workman,DEM,660004,22,55,234,311,
Rogers,U.S. Senate,Mark Beard,IND,660004,0,5,24,29,
Rogers,U.S. Senate,Sean Braddy,IND,660004,1,6,33,40,
Rogers,U.S. House,Markwayne Mullin,REP,660004,59,195,860,1114,02
Rogers,U.S. House,Joshua Harris-Till,DEM,660004,23,52,242,317,02
Rogers,U.S. House,John Mccarthy,IND,660004,5,16,100,121,02
Rogers,President,Donald Trump,REP,660005,40,133,500,673,
Rogers,President,Gary Johnson,LIB,660005,2,6,29,37,
Rogers,President,Hillary Clinton,DEM,660005,10,37,98,145,
Rogers,U.S. Senate,James Lankford,REP,660005,42,136,511,689,
Rogers,U.S. Senate,Robert Murphy,LIB,660005,1,4,18,23,
Rogers,U.S. Senate,Mike Workman,DEM,660005,8,34,84,126,
Rogers,U.S. Senate,Mark Beard,IND,660005,0,2,9,11,
Rogers,U.S. Senate,Sean Braddy,IND,660005,0,1,7,8,
Rogers,U.S. House,Markwayne Mullin,REP,660005,41,132,517,690,02
Rogers,U.S. House,Joshua Harris-Till,DEM,660005,8,32,83,123,02
Rogers,U.S. House,John Mccarthy,IND,660005,2,12,29,43,02
Rogers,President,Donald Trump,REP,660006,49,90,561,700,
Rogers,President,Gary Johnson,LIB,660006,8,2,48,58,
Rogers,President,Hillary Clinton,DEM,660006,27,29,131,187,
Rogers,U.S. Senate,James Lankford,REP,660006,55,86,575,716,
Rogers,U.S. Senate,Robert Murphy,LIB,660006,1,2,19,22,
Rogers,U.S. Senate,Mike Workman,DEM,660006,20,28,111,159,
Rogers,U.S. Senate,Mark Beard,IND,660006,3,2,17,22,
Rogers,U.S. Senate,Sean Braddy,IND,660006,3,1,15,19,
Rogers,President,Donald Trump,REP,660007,48,192,740,980,
Rogers,President,Gary Johnson,LIB,660007,4,9,58,71,
Rogers,President,Hillary Clinton,DEM,660007,17,43,203,263,
Rogers,U.S. Senate,James Lankford,REP,660007,49,183,751,983,
Rogers,U.S. Senate,Robert Murphy,LIB,660007,4,7,35,46,
Rogers,U.S. Senate,Mike Workman,DEM,660007,15,43,164,222,
Rogers,U.S. Senate,Mark Beard,IND,660007,0,6,20,26,
Rogers,U.S. Senate,Sean Braddy,IND,660007,1,4,30,35,
Rogers,U.S. House,Markwayne Mullin,REP,660007,51,179,735,965,02
Rogers,U.S. House,Joshua Harris-Till,DEM,660007,14,49,173,236,02
Rogers,U.S. House,John Mccarthy,IND,660007,4,15,84,103,02
Rogers,President,Donald Trump,REP,660008,60,123,528,711,
Rogers,President,Gary Johnson,LIB,660008,3,6,37,46,
Rogers,President,Hillary Clinton,DEM,660008,47,57,182,286,
Rogers,U.S. Senate,James Lankford,REP,660008,60,138,543,741,
Rogers,U.S. Senate,Robert Murphy,LIB,660008,3,1,17,21,
Rogers,U.S. Senate,Mike Workman,DEM,660008,36,44,154,234,
Rogers,U.S. Senate,Mark Beard,IND,660008,3,2,22,27,
Rogers,U.S. Senate,Sean Braddy,IND,660008,5,2,12,19,
Rogers,U.S. House,Markwayne Mullin,REP,660008,58,132,525,715,02
Rogers,U.S. House,Joshua Harris-Till,DEM,660008,37,44,175,256,02
Rogers,U.S. House,John Mccarthy,IND,660008,11,11,46,68,02
Rogers,President,Donald Trump,REP,660009,28,83,400,511,
Rogers,President,Gary Johnson,LIB,660009,2,3,23,28,
Rogers,President,Hillary Clinton,DEM,660009,9,24,60,93,
Rogers,U.S. Senate,James Lankford,REP,660009,32,81,398,511,
Rogers,U.S. Senate,Robert Murphy,LIB,660009,2,2,7,11,
Rogers,U.S. Senate,Mike Workman,DEM,660009,4,23,59,86,
Rogers,U.S. Senate,Mark Beard,IND,660009,0,1,8,9,
Rogers,U.S. Senate,Sean Braddy,IND,660009,1,3,6,10,
Rogers,U.S. House,Markwayne Mullin,REP,660009,31,86,406,523,02
Rogers,U.S. House,Joshua Harris-Till,DEM,660009,7,18,52,77,02
Rogers,U.S. House,John Mccarthy,IND,660009,1,6,21,28,02
Rogers,President,Donald Trump,REP,660010,60,111,1288,1459,
Rogers,President,Gary Johnson,LIB,660010,3,6,81,90,
Rogers,President,Hillary Clinton,DEM,660010,18,35,348,401,
Rogers,U.S. Senate,James Lankford,REP,660010,62,117,1246,1425,
Rogers,U.S. Senate,Robert Murphy,LIB,660010,2,3,48,53,
Rogers,U.S. Senate,Mike Workman,DEM,660010,15,28,312,355,
Rogers,U.S. Senate,Mark Beard,IND,660010,0,0,48,48,
Rogers,U.S. Senate,Sean Braddy,IND,660010,2,4,45,51,
Rogers,State House,Terry O'Donnell,REP,660010,61,119,1288,1468,23
Rogers,State House,Keith Welch Sr.,DEM,660010,20,30,398,448,23
Rogers,President,Donald Trump,REP,660011,47,104,997,1148,
Rogers,President,Gary Johnson,LIB,660011,4,7,53,64,
Rogers,President,Hillary Clinton,DEM,660011,11,28,298,337,
Rogers,U.S. Senate,James Lankford,REP,660011,51,107,970,1128,
Rogers,U.S. Senate,Robert Murphy,LIB,660011,2,2,24,28,
Rogers,U.S. Senate,Mike Workman,DEM,660011,10,27,273,310,
Rogers,U.S. Senate,Mark Beard,IND,660011,1,2,35,38,
Rogers,U.S. Senate,Sean Braddy,IND,660011,0,1,39,40,
Rogers,U.S. House,Markwayne Mullin,REP,660011,53,105,968,1126,02
Rogers,U.S. House,Joshua Harris-Till,DEM,660011,9,24,270,303,02
Rogers,U.S. House,John Mccarthy,IND,660011,3,11,103,117,02
Rogers,State Senate,Julie Daniels,REP,660011,49,103,927,1079,29
Rogers,State Senate,Robert Jobe,DEM,660011,15,35,389,439,29
Rogers,President,Donald Trump,REP,660012,4,15,249,268,
Rogers,President,Gary Johnson,LIB,660012,0,0,13,13,
Rogers,President,Hillary Clinton,DEM,660012,3,5,53,61,
Rogers,U.S. Senate,James Lankford,REP,660012,5,15,244,264,
Rogers,U.S. Senate,Robert Murphy,LIB,660012,0,0,8,8,
Rogers,U.S. Senate,Mike Workman,DEM,660012,2,5,51,58,
Rogers,U.S. Senate,Mark Beard,IND,660012,0,0,4,4,
Rogers,U.S. Senate,Sean Braddy,IND,660012,0,0,11,11,
Rogers,U.S. House,Markwayne Mullin,REP,660012,4,15,245,264,02
Rogers,U.S. House,Joshua Harris-Till,DEM,660012,3,5,49,57,02
Rogers,U.S. House,John Mccarthy,IND,660012,0,0,23,23,02
Rogers,State House,Tom Gann,REP,660012,5,15,231,251,8
Rogers,State House,Darrell Moore,DEM,660012,2,5,83,90,8
Rogers,President,Donald Trump,REP,660013,33,108,632,773,
Rogers,President,Gary Johnson,LIB,660013,3,6,41,50,
Rogers,President,Hillary Clinton,DEM,660013,12,25,145,182,
Rogers,U.S. Senate,James Lankford,REP,660013,34,115,643,792,
Rogers,U.S. Senate,Robert Murphy,LIB,660013,0,2,20,22,
Rogers,U.S. Senate,Mike Workman,DEM,660013,11,19,131,161,
Rogers,U.S. Senate,Mark Beard,IND,660013,0,3,10,13,
Rogers,U.S. Senate,Sean Braddy,IND,660013,2,2,13,17,
Rogers,U.S. House,Markwayne Mullin,REP,660013,34,112,623,769,02
Rogers,U.S. House,Joshua Harris-Till,DEM,660013,9,20,141,170,02
Rogers,U.S. House,John Mccarthy,IND,660013,4,9,56,69,02
Rogers,President,Donald Trump,REP,660014,27,118,570,715,
Rogers,President,Gary Johnson,LIB,660014,3,3,43,49,
Rogers,President,Hillary Clinton,DEM,660014,8,44,140,192,
Rogers,U.S. Senate,James Lankford,REP,660014,27,125,582,734,
Rogers,U.S. Senate,Robert Murphy,LIB,660014,1,1,12,14,
Rogers,U.S. Senate,Mike Workman,DEM,660014,5,37,119,161,
Rogers,U.S. Senate,Mark Beard,IND,660014,1,0,18,19,
Rogers,U.S. Senate,Sean Braddy,IND,660014,1,1,20,22,
Rogers,U.S. House,Markwayne Mullin,REP,660014,26,121,585,732,02
Rogers,U.S. House,Joshua Harris-Till,DEM,660014,6,36,122,164,02
Rogers,U.S. House,John Mccarthy,IND,660014,3,4,42,49,02
Rogers,President,Donald Trump,REP,660015,49,45,855,949,
Rogers,President,Gary Johnson,LIB,660015,1,5,62,68,
Rogers,President,Hillary Clinton,DEM,660015,22,23,229,274,
Rogers,U.S. Senate,James Lankford,REP,660015,54,46,862,962,
Rogers,U.S. Senate,Robert Murphy,LIB,660015,0,4,38,42,
Rogers,U.S. Senate,Mike Workman,DEM,660015,15,23,195,233,
Rogers,U.S. Senate,Mark Beard,IND,660015,3,1,24,28,
Rogers,U.S. Senate,Sean Braddy,IND,660015,0,1,28,29,
Rogers,U.S. House,Markwayne Mullin,REP,660015,52,43,849,944,02
Rogers,U.S. House,Joshua Harris-Till,DEM,660015,18,28,219,265,02
Rogers,U.S. House,John Mccarthy,IND,660015,3,4,73,80,02
Rogers,State Senate,Julie Daniels,REP,660015,48,40,783,871,29
Rogers,State Senate,Robert Jobe,DEM,660015,23,31,347,401,29
Rogers,President,Donald Trump,REP,660017,13,76,435,524,
Rogers,President,Gary Johnson,LIB,660017,4,2,37,43,
Rogers,President,Hillary Clinton,DEM,660017,8,15,115,138,
Rogers,U.S. Senate,James Lankford,REP,660017,14,73,464,551,
Rogers,U.S. Senate,Robert Murphy,LIB,660017,2,1,10,13,
Rogers,U.S. Senate,Mike Workman,DEM,660017,7,16,98,121,
Rogers,U.S. Senate,Mark Beard,IND,660017,0,3,11,14,
Rogers,U.S. Senate,Sean Braddy,IND,660017,2,0,5,7,
Rogers,U.S. House,Markwayne Mullin,REP,660017,17,73,458,548,02
Rogers,U.S. House,Joshua Harris-Till,DEM,660017,7,15,107,129,02
Rogers,U.S. House,John Mccarthy,IND,660017,1,4,20,25,02
Rogers,State Senate,Julie Daniels,REP,660017,15,75,430,520,29
Rogers,State Senate,Robert Jobe,DEM,660017,10,17,145,172,29
Rogers,President,Donald Trump,REP,660018,60,174,888,1122,
Rogers,President,Gary Johnson,LIB,660018,9,6,54,69,
Rogers,President,Hillary Clinton,DEM,660018,18,53,173,244,
Rogers,U.S. Senate,James Lankford,REP,660018,68,174,884,1126,
Rogers,U.S. Senate,Robert Murphy,LIB,660018,2,1,20,23,
Rogers,U.S. Senate,Mike Workman,DEM,660018,15,50,156,221,
Rogers,U.S. Senate,Mark Beard,IND,660018,2,6,26,34,
Rogers,U.S. Senate,Sean Braddy,IND,660018,1,2,23,26,
Rogers,U.S. House,Markwayne Mullin,REP,660018,67,176,880,1123,02
Rogers,U.S. House,Joshua Harris-Till,DEM,660018,18,46,156,220,02
Rogers,U.S. House,John Mccarthy,IND,660018,3,11,78,92,02
Rogers,President,Donald Trump,REP,660019,20,61,580,661,
Rogers,President,Gary Johnson,LIB,660019,3,0,29,32,
Rogers,President,Hillary Clinton,DEM,660019,12,19,96,127,
Rogers,U.S. Senate,James Lankford,REP,660019,23,61,583,667,
Rogers,U.S. Senate,Robert Murphy,LIB,660019,2,2,15,19,
Rogers,U.S. Senate,Mike Workman,DEM,660019,10,16,89,115,
Rogers,U.S. Senate,Mark Beard,IND,660019,0,0,11,11,
Rogers,U.S. Senate,Sean Braddy,IND,660019,0,1,10,11,
Rogers,U.S. House,Markwayne Mullin,REP,660019,21,59,574,654,02
Rogers,U.S. House,Joshua Harris-Till,DEM,660019,12,17,96,125,02
Rogers,U.S. House,John Mccarthy,IND,660019,2,4,36,42,02
Rogers,State House,Tom Gann,REP,660019,23,61,530,614,8
Rogers,State House,Darrell Moore,DEM,660019,12,19,174,205,8
Rogers,President,Donald Trump,REP,660020,65,261,1002,1328,
Rogers,President,Gary Johnson,LIB,660020,5,7,69,81,
Rogers,President,Hillary Clinton,DEM,660020,24,71,256,351,
Rogers,U.S. Senate,James Lankford,REP,660020,71,270,998,1339,
Rogers,U.S. Senate,Robert Murphy,LIB,660020,3,4,37,44,
Rogers,U.S. Senate,Mike Workman,DEM,660020,16,64,238,318,
Rogers,U.S. Senate,Mark Beard,IND,660020,1,4,22,27,
Rogers,U.S. Senate,Sean Braddy,IND,660020,0,2,29,31,
Rogers,U.S. House,Markwayne Mullin,REP,660020,69,276,987,1332,02
Rogers,U.S. House,Joshua Harris-Till,DEM,660020,18,56,239,313,02
Rogers,U.S. House,John Mccarthy,IND,660020,4,7,94,105,02
Rogers,President,Donald Trump,REP,660021,22,29,283,334,
Rogers,President,Gary Johnson,LIB,660021,0,1,11,12,
Rogers,President,Hillary Clinton,DEM,660021,10,5,52,67,
Rogers,U.S. Senate,James Lankford,REP,660021,24,27,290,341,
Rogers,U.S. Senate,Robert Murphy,LIB,660021,1,2,5,8,
Rogers,U.S. Senate,Mike Workman,DEM,660021,7,4,40,51,
Rogers,U.S. Senate,Mark Beard,IND,660021,0,0,4,4,
Rogers,U.S. Senate,Sean Braddy,IND,660021,0,1,4,5,
Rogers,State House,Dale Derby,REP,660021,23,27,252,302,74
Rogers,State House,Jeri Moberly,DEM,660021,9,7,90,106,74
Rogers,President,Donald Trump,REP,660022,38,175,800,1013,
Rogers,President,Gary Johnson,LIB,660022,2,4,60,66,
Rogers,President,Hillary Clinton,DEM,660022,8,33,150,191,
Rogers,U.S. Senate,James Lankford,REP,660022,37,181,799,1017,
Rogers,U.S. Senate,Robert Murphy,LIB,660022,1,3,26,30,
Rogers,U.S. Senate,Mike Workman,DEM,660022,7,28,143,178,
Rogers,U.S. Senate,Mark Beard,IND,660022,2,1,25,28,
Rogers,U.S. Senate,Sean Braddy,IND,660022,0,2,21,23,
Rogers,U.S. House,Markwayne Mullin,REP,660022,37,178,789,1004,02
Rogers,U.S. House,Joshua Harris-Till,DEM,660022,7,26,138,171,02
Rogers,U.S. House,John Mccarthy,IND,660022,4,11,85,100,02
Rogers,President,Donald Trump,REP,660023,47,86,1393,1526,
Rogers,President,Gary Johnson,LIB,660023,3,0,76,79,
Rogers,President,Hillary Clinton,DEM,660023,9,13,288,310,
Rogers,U.S. Senate,James Lankford,REP,660023,45,80,1358,1483,
Rogers,U.S. Senate,Robert Murphy,LIB,660023,2,0,31,33,
Rogers,U.S. Senate,Mike Workman,DEM,660023,8,14,281,303,
Rogers,U.S. Senate,Mark Beard,IND,660023,1,2,40,43,
Rogers,U.S. Senate,Sean Braddy,IND,660023,1,1,39,41,
Rogers,U.S. House,Markwayne Mullin,REP,660023,47,82,1371,1500,02
Rogers,U.S. House,Joshua Harris-Till,DEM,660023,8,13,275,296,02
Rogers,U.S. House,John Mccarthy,IND,660023,4,3,102,109,02
Rogers,State Senate,Julie Daniels,REP,660023,47,72,1217,1336,29
Rogers,State Senate,Robert Jobe,DEM,660023,9,25,520,554,29
Rogers,President,Donald Trump,REP,660024,16,13,502,531,
Rogers,President,Gary Johnson,LIB,660024,1,0,24,25,
Rogers,President,Hillary Clinton,DEM,660024,3,3,79,85,
Rogers,U.S. Senate,James Lankford,REP,660024,16,13,478,507,
Rogers,U.S. Senate,Robert Murphy,LIB,660024,0,1,12,13,
Rogers,U.S. Senate,Mike Workman,DEM,660024,2,1,94,97,
Rogers,U.S. Senate,Mark Beard,IND,660024,2,0,11,13,
Rogers,U.S. Senate,Sean Braddy,IND,660024,0,0,9,9,
Rogers,U.S. House,Markwayne Mullin,REP,660024,14,12,471,497,02
Rogers,U.S. House,Joshua Harris-Till,DEM,660024,2,2,92,96,02
Rogers,U.S. House,John Mccarthy,IND,660024,4,2,39,45,02
Rogers,State Senate,Julie Daniels,REP,660024,16,12,414,442,29
Rogers,State Senate,Robert Jobe,DEM,660024,2,3,188,193,29
Rogers,President,Donald Trump,REP,660025,6,11,175,192,
Rogers,President,Gary Johnson,LIB,660025,0,0,6,6,
Rogers,President,Hillary Clinton,DEM,660025,4,6,60,70,
Rogers,U.S. Senate,James Lankford,REP,660025,6,12,185,203,
Rogers,U.S. Senate,Robert Murphy,LIB,660025,0,0,2,2,
Rogers,U.S. Senate,Mike Workman,DEM,660025,4,5,54,63,
Rogers,U.S. Senate,Mark Beard,IND,660025,0,0,1,1,
Rogers,U.S. Senate,Sean Braddy,IND,660025,1,0,5,6,
Rogers,President,Donald Trump,REP,660026,67,114,1279,1460,
Rogers,President,Gary Johnson,LIB,660026,3,4,85,92,
Rogers,President,Hillary Clinton,DEM,660026,18,20,218,256,
Rogers,U.S. Senate,James Lankford,REP,660026,70,111,1273,1454,
Rogers,U.S. Senate,Robert Murphy,LIB,660026,1,1,39,41,
Rogers,U.S. Senate,Mike Workman,DEM,660026,13,23,213,249,
Rogers,U.S. Senate,Mark Beard,IND,660026,0,1,27,28,
Rogers,U.S. Senate,Sean Braddy,IND,660026,1,3,32,36,
Rogers,U.S. House,Markwayne Mullin,REP,660026,70,112,1237,1419,02
Rogers,U.S. House,Joshua Harris-Till,DEM,660026,16,25,220,261,02
Rogers,U.S. House,John Mccarthy,IND,660026,0,4,115,119,02
Rogers,State Senate,Wayne Shaw,REP,660026,64,98,1138,1300,3
Rogers,State Senate,Rhonda Cox,DEM,660026,19,41,435,495,3
Rogers,State House,Tom Gann,REP,660026,62,102,1194,1358,8
Rogers,State House,Darrell Moore,DEM,660026,21,37,376,434,8
Rogers,President,Donald Trump,REP,660027,11,34,591,636,
Rogers,President,Gary Johnson,LIB,660027,4,2,43,49,
Rogers,President,Hillary Clinton,DEM,660027,6,8,123,137,
Rogers,U.S. Senate,James Lankford,REP,660027,13,34,584,631,
Rogers,U.S. Senate,Robert Murphy,LIB,660027,2,3,20,25,
Rogers,U.S. Senate,Mike Workman,DEM,660027,5,8,126,139,
Rogers,U.S. Senate,Mark Beard,IND,660027,0,1,12,13,
Rogers,U.S. Senate,Sean Braddy,IND,660027,1,0,14,15,
Rogers,U.S. House,Markwayne Mullin,REP,660027,13,32,570,615,02
Rogers,U.S. House,Joshua Harris-Till,DEM,660027,6,9,132,147,02
Rogers,U.S. House,John Mccarthy,IND,660027,2,5,53,60,02
Rogers,State Senate,Wayne Shaw,REP,660027,13,31,519,563,3
Rogers,State Senate,Rhonda Cox,DEM,660027,7,14,231,252,3
Rogers,State House,Tom Gann,REP,660027,13,32,562,607,8
Rogers,State House,Darrell Moore,DEM,660027,8,13,192,213,8
Rogers,President,Donald Trump,REP,660029,27,45,473,545,
Rogers,President,Gary Johnson,LIB,660029,2,2,32,36,
Rogers,President,Hillary Clinton,DEM,660029,7,22,88,117,
Rogers,U.S. Senate,James Lankford,REP,660029,31,46,473,550,
Rogers,U.S. Senate,Robert Murphy,LIB,660029,1,3,21,25,
Rogers,U.S. Senate,Mike Workman,DEM,660029,4,18,74,96,
Rogers,U.S. Senate,Mark Beard,IND,660029,0,2,12,14,
Rogers,U.S. Senate,Sean Braddy,IND,660029,0,0,13,13,
Rogers,U.S. House,Markwayne Mullin,REP,660029,28,45,474,547,02
Rogers,U.S. House,Joshua Harris-Till,DEM,660029,4,18,74,96,02
Rogers,U.S. House,John Mccarthy,IND,660029,3,6,45,54,02
Rogers,President,Donald Trump,REP,660030,131,180,1411,1722,
Rogers,President,Gary Johnson,LIB,660030,10,7,80,97,
Rogers,President,Hillary Clinton,DEM,660030,42,48,274,364,
Rogers,U.S. Senate,James Lankford,REP,660030,138,183,1438,1759,
Rogers,U.S. Senate,Robert Murphy,LIB,660030,6,2,53,61,
Rogers,U.S. Senate,Mike Workman,DEM,660030,32,43,214,289,
Rogers,U.S. Senate,Mark Beard,IND,660030,2,2,26,30,
Rogers,U.S. Senate,Sean Braddy,IND,660030,6,3,29,38,
Rogers,U.S. House,Markwayne Mullin,REP,660030,140,180,1405,1725,02
Rogers,U.S. House,Joshua Harris-Till,DEM,660030,33,43,250,326,02
Rogers,U.S. House,John Mccarthy,IND,660030,9,9,94,112,02
Rogers,State House,Dale Derby,REP,660030,128,166,1293,1587,74
Rogers,State House,Jeri Moberly,DEM,660030,55,68,456,579,74
Rogers,President,Donald Trump,REP,660031,83,131,1000,1214,
Rogers,President,Gary Johnson,LIB,660031,17,10,85,112,
Rogers,President,Hillary Clinton,DEM,660031,43,61,258,362,
Rogers,U.S. Senate,James Lankford,REP,660031,104,134,1027,1265,
Rogers,U.S. Senate,Robert Murphy,LIB,660031,3,5,39,47,
Rogers,U.S. Senate,Mike Workman,DEM,660031,25,48,205,278,
Rogers,U.S. Senate,Mark Beard,IND,660031,8,9,30,47,
Rogers,U.S. Senate,Sean Braddy,IND,660031,5,2,32,39,
Rogers,State House,Dale Derby,REP,660031,94,115,904,1113,74
Rogers,State House,Jeri Moberly,DEM,660031,50,83,425,558,74
Rogers,President,Donald Trump,REP,660032,56,77,511,644,
Rogers,President,Gary Johnson,LIB,660032,4,6,41,51,
Rogers,President,Hillary Clinton,DEM,660032,17,15,118,150,
Rogers,U.S. Senate,James Lankford,REP,660032,58,80,530,668,
Rogers,U.S. Senate,Robert Murphy,LIB,660032,1,4,20,25,
Rogers,U.S. Senate,Mike Workman,DEM,660032,18,12,93,123,
Rogers,U.S. Senate,Mark Beard,IND,660032,0,1,17,18,
Rogers,U.S. Senate,Sean Braddy,IND,660032,0,1,11,12,
Rogers,U.S. House,Markwayne Mullin,REP,660032,58,74,524,656,02
Rogers,U.S. House,Joshua Harris-Till,DEM,660032,17,16,103,136,02
Rogers,U.S. House,John Mccarthy,IND,660032,1,8,41,50,02
Rogers,President,Donald Trump,REP,660033,11,13,310,334,
Rogers,President,Gary Johnson,LIB,660033,0,1,29,30,
Rogers,President,Hillary Clinton,DEM,660033,4,0,77,81,
Rogers,U.S. Senate,James Lankford,REP,660033,11,10,324,345,
Rogers,U.S. Senate,Robert Murphy,LIB,660033,0,0,4,4,
Rogers,U.S. Senate,Mike Workman,DEM,660033,4,0,59,63,
Rogers,U.S. Senate,Mark Beard,IND,660033,0,2,16,18,
Rogers,U.S. Senate,Sean Braddy,IND,660033,0,2,17,19,
Rogers,U.S. House,Markwayne Mullin,REP,660033,12,12,325,349,02
Rogers,U.S. House,Joshua Harris-Till,DEM,660033,4,0,59,63,02
Rogers,U.S. House,John Mccarthy,IND,660033,0,2,35,37,02
Rogers,President,Donald Trump,REP,660110,43,97,631,771,
Rogers,President,Gary Johnson,LIB,660110,1,3,48,52,
Rogers,President,Hillary Clinton,DEM,660110,21,37,135,193,
Rogers,U.S. Senate,James Lankford,REP,660110,49,101,627,777,
Rogers,U.S. Senate,Robert Murphy,LIB,660110,0,0,31,31,
Rogers,U.S. Senate,Mike Workman,DEM,660110,18,34,106,158,
Rogers,U.S. Senate,Mark Beard,IND,660110,0,2,20,22,
Rogers,U.S. Senate,Sean Braddy,IND,660110,1,0,22,23,
Rogers,U.S. House,Markwayne Mullin,REP,660110,49,99,619,767,02
Rogers,U.S. House,Joshua Harris-Till,DEM,660110,16,36,116,168,02
Rogers,U.S. House,John Mccarthy,IND,660110,3,1,73,77,02
Rogers,State House,Terry O'Donnell,REP,660110,48,100,657,805,23
Rogers,State House,Keith Welch Sr.,DEM,660110,19,37,140,196,23
Rogers,President,Donald Trump,REP,660116,16,36,639,691,
Rogers,President,Gary Johnson,LIB,660116,0,2,32,34,
Rogers,President,Hillary Clinton,DEM,660116,4,6,117,127,
Rogers,U.S. Senate,James Lankford,REP,660116,14,36,603,653,
Rogers,U.S. Senate,Robert Murphy,LIB,660116,1,2,21,24,
Rogers,U.S. Senate,Mike Workman,DEM,660116,4,7,116,127,
Rogers,U.S. Senate,Mark Beard,IND,660116,0,0,28,28,
Rogers,U.S. Senate,Sean Braddy,IND,660116,0,0,13,13,
Rogers,U.S. House,Markwayne Mullin,REP,660116,15,36,592,643,02
Rogers,U.S. House,Joshua Harris-Till,DEM,660116,3,7,126,136,02
Rogers,U.S. House,John Mccarthy,IND,660116,1,2,65,68,02
Rogers,State Senate,Julie Daniels,REP,660116,14,36,575,625,29
Rogers,State Senate,Robert Jobe,DEM,660116,5,9,206,220,29
Rogers,President,Donald Trump,REP,660120,36,101,681,818,
Rogers,President,Gary Johnson,LIB,660120,2,3,25,30,
Rogers,President,Hillary Clinton,DEM,660120,8,34,133,175,
Rogers,U.S. Senate,James Lankford,REP,660120,37,105,676,818,
Rogers,U.S. Senate,Robert Murphy,LIB,660120,0,1,18,19,
Rogers,U.S. Senate,Mike Workman,DEM,660120,9,31,114,154,
Rogers,U.S. Senate,Mark Beard,IND,660120,0,0,14,14,
Rogers,U.S. Senate,Sean Braddy,IND,660120,0,1,16,17,
Rogers,U.S. House,Markwayne Mullin,REP,660120,36,99,655,790,02
Rogers,U.S. House,Joshua Harris-Till,DEM,660120,7,33,118,158,02
Rogers,U.S. House,John Mccarthy,IND,660120,3,6,63,72,02
Rogers,President,Donald Trump,REP,660128,14,39,532,585,
Rogers,President,Gary Johnson,LIB,660128,1,1,30,32,
Rogers,President,Hillary Clinton,DEM,660128,6,12,132,150,
Rogers,U.S. Senate,James Lankford,REP,660128,14,41,536,591,
Rogers,U.S. Senate,Robert Murphy,LIB,660128,0,0,18,18,
Rogers,U.S. Senate,Mike Workman,DEM,660128,4,11,114,129,
Rogers,U.S. Senate,Mark Beard,IND,660128,1,0,12,13,
Rogers,U.S. Senate,Sean Braddy,IND,660128,1,0,9,10,
Rogers,U.S. House,Markwayne Mullin,REP,660128,12,38,540,590,02
Rogers,U.S. House,Joshua Harris-Till,DEM,660128,4,11,110,125,02
Rogers,U.S. House,John Mccarthy,IND,660128,4,3,38,45,02
Rogers,State House,Terry O'Donnell,REP,660128,16,37,555,608,23
Rogers,State House,Keith Welch Sr.,DEM,660128,4,15,133,152,23
Rogers,President,Donald Trump,REP,660130,167,289,1486,1942,
Rogers,President,Gary Johnson,LIB,660130,8,8,102,118,
Rogers,President,Hillary Clinton,DEM,660130,65,84,393,542,
Rogers,U.S. Senate,James Lankford,REP,660130,180,294,1523,1997,
Rogers,U.S. Senate,Robert Murphy,LIB,660130,6,5,54,65,
Rogers,U.S. Senate,Mike Workman,DEM,660130,42,71,315,428,
Rogers,U.S. Senate,Mark Beard,IND,660130,2,3,31,36,
Rogers,U.S. Senate,Sean Braddy,IND,660130,9,4,51,64,
Rogers,State House,Dale Derby,REP,660130,154,260,1338,1752,74
Rogers,State House,Jeri Moberly,DEM,660130,83,116,630,829,74
Seminole,President,Donald Trump,REP,670010,25,41,559,625,
Seminole,President,Gary Johnson,LIB,670010,3,4,45,52,
Seminole,President,Hillary Clinton,DEM,670010,10,28,233,271,
Seminole,U.S. Senate,James Lankford,REP,670010,26,43,585,654,
Seminole,U.S. Senate,Robert Murphy,LIB,670010,1,2,21,24,
Seminole,U.S. Senate,Mike Workman,DEM,670010,9,26,187,222,
Seminole,U.S. Senate,Mark Beard,IND,670010,0,0,18,18,
Seminole,U.S. Senate,Sean Braddy,IND,670010,3,3,26,32,
Seminole,U.S. House,Steve Russell,REP,670010,25,39,518,582,05
Seminole,U.S. House,Zachary Knight,LIB,670010,2,3,46,51,05
Seminole,U.S. House,Al Mcaffrey,DEM,670010,12,32,266,310,05
Seminole,State House,Tom Newell,REP,670010,23,38,449,510,28
Seminole,State House,Marilyn Rainwater,DEM,670010,15,36,379,430,28
Seminole,President,Donald Trump,REP,670012,4,2,91,97,
Seminole,President,Gary Johnson,LIB,670012,0,0,5,5,
Seminole,President,Hillary Clinton,DEM,670012,1,0,21,22,
Seminole,U.S. Senate,James Lankford,REP,670012,4,2,84,90,
Seminole,U.S. Senate,Robert Murphy,LIB,670012,0,0,3,3,
Seminole,U.S. Senate,Mike Workman,DEM,670012,1,0,25,26,
Seminole,U.S. Senate,Mark Beard,IND,670012,0,0,3,3,
Seminole,U.S. Senate,Sean Braddy,IND,670012,0,0,4,4,
Seminole,U.S. House,Steve Russell,REP,670012,4,2,69,75,05
Seminole,U.S. House,Zachary Knight,LIB,670012,0,0,12,12,05
Seminole,U.S. House,Al Mcaffrey,DEM,670012,1,0,33,34,05
Seminole,State Senate,Greg Mccortney,REP,670012,3,2,79,84,13
Seminole,State Senate,Eric Hall,DEM,670012,2,0,37,39,13
Seminole,State House,Tom Newell,REP,670012,4,1,85,90,28
Seminole,State House,Marilyn Rainwater,DEM,670012,1,1,31,33,28
Seminole,President,Donald Trump,REP,670014,24,29,600,653,
Seminole,President,Gary Johnson,LIB,670014,2,0,30,32,
Seminole,President,Hillary Clinton,DEM,670014,15,5,171,191,
Seminole,U.S. Senate,James Lankford,REP,670014,28,29,610,667,
Seminole,U.S. Senate,Robert Murphy,LIB,670014,2,0,16,18,
Seminole,U.S. Senate,Mike Workman,DEM,670014,10,4,155,169,
Seminole,U.S. Senate,Mark Beard,IND,670014,0,0,15,15,
Seminole,U.S. Senate,Sean Braddy,IND,670014,1,1,12,14,
Seminole,U.S. House,Steve Russell,REP,670014,25,25,556,606,05
Seminole,U.S. House,Zachary Knight,LIB,670014,3,1,40,44,05
Seminole,U.S. House,Al Mcaffrey,DEM,670014,13,8,202,223,05
Seminole,State Senate,Greg Mccortney,REP,670014,27,23,546,596,13
Seminole,State Senate,Eric Hall,DEM,670014,14,10,250,274,13
Seminole,State House,Tom Newell,REP,670014,21,21,551,593,28
Seminole,State House,Marilyn Rainwater,DEM,670014,18,12,246,276,28
Seminole,President,Donald Trump,REP,670015,14,19,288,321,
Seminole,President,Gary Johnson,LIB,670015,0,0,15,15,
Seminole,President,Hillary Clinton,DEM,670015,4,5,70,79,
Seminole,U.S. Senate,James Lankford,REP,670015,15,20,288,323,
Seminole,U.S. Senate,Robert Murphy,LIB,670015,0,0,9,9,
Seminole,U.S. Senate,Mike Workman,DEM,670015,3,3,59,65,
Seminole,U.S. Senate,Mark Beard,IND,670015,0,0,12,12,
Seminole,U.S. Senate,Sean Braddy,IND,670015,0,1,4,5,
Seminole,U.S. House,Steve Russell,REP,670015,13,20,261,294,05
Seminole,U.S. House,Zachary Knight,LIB,670015,0,0,19,19,05
Seminole,U.S. House,Al Mcaffrey,DEM,670015,5,4,85,94,05
Seminole,State Senate,Greg Mccortney,REP,670015,13,20,242,275,13
Seminole,State Senate,Eric Hall,DEM,670015,6,6,118,130,13
Seminole,State House,Tom Newell,REP,670015,13,21,238,272,28
Seminole,State House,Marilyn Rainwater,DEM,670015,6,5,129,140,28
Seminole,President,Donald Trump,REP,670020,16,32,535,583,
Seminole,President,Gary Johnson,LIB,670020,1,1,29,31,
Seminole,President,Hillary Clinton,DEM,670020,6,5,125,136,
Seminole,U.S. Senate,James Lankford,REP,670020,18,31,548,597,
Seminole,U.S. Senate,Robert Murphy,LIB,670020,1,0,20,21,
Seminole,U.S. Senate,Mike Workman,DEM,670020,4,4,98,106,
Seminole,U.S. Senate,Mark Beard,IND,670020,0,1,7,8,
Seminole,U.S. Senate,Sean Braddy,IND,670020,0,2,13,15,
Seminole,U.S. House,Steve Russell,REP,670020,18,30,488,536,05
Seminole,U.S. House,Zachary Knight,LIB,670020,1,2,25,28,05
Seminole,U.S. House,Al Mcaffrey,DEM,670020,4,6,165,175,05
Seminole,State House,Tom Newell,REP,670020,17,29,478,524,28
Seminole,State House,Marilyn Rainwater,DEM,670020,5,8,201,214,28
Seminole,President,Donald Trump,REP,670022,28,27,448,503,
Seminole,President,Gary Johnson,LIB,670022,2,5,38,45,
Seminole,President,Hillary Clinton,DEM,670022,17,21,179,217,
Seminole,U.S. Senate,James Lankford,REP,670022,30,29,475,534,
Seminole,U.S. Senate,Robert Murphy,LIB,670022,1,5,25,31,
Seminole,U.S. Senate,Mike Workman,DEM,670022,16,19,143,178,
Seminole,U.S. Senate,Mark Beard,IND,670022,0,1,15,16,
Seminole,U.S. Senate,Sean Braddy,IND,670022,0,0,9,9,
Seminole,U.S. House,Steve Russell,REP,670022,32,25,416,473,05
Seminole,U.S. House,Zachary Knight,LIB,670022,1,4,32,37,05
Seminole,U.S. House,Al Mcaffrey,DEM,670022,14,23,215,252,05
Seminole,State House,Tom Newell,REP,670022,26,26,397,449,28
Seminole,State House,Marilyn Rainwater,DEM,670022,21,28,263,312,28
Seminole,President,Donald Trump,REP,670023,21,49,554,624,
Seminole,President,Gary Johnson,LIB,670023,2,4,38,44,
Seminole,President,Hillary Clinton,DEM,670023,7,34,211,252,
Seminole,U.S. Senate,James Lankford,REP,670023,23,59,600,682,
Seminole,U.S. Senate,Robert Murphy,LIB,670023,0,0,10,10,
Seminole,U.S. Senate,Mike Workman,DEM,670023,5,29,153,187,
Seminole,U.S. Senate,Mark Beard,IND,670023,1,0,19,20,
Seminole,U.S. Senate,Sean Braddy,IND,670023,1,0,18,19,
Seminole,U.S. House,Steve Russell,REP,670023,22,52,528,602,05
Seminole,U.S. House,Zachary Knight,LIB,670023,2,2,25,29,05
Seminole,U.S. House,Al Mcaffrey,DEM,670023,6,34,240,280,05
Seminole,State House,Tom Newell,REP,670023,17,41,478,536,28
Seminole,State House,Marilyn Rainwater,DEM,670023,13,47,320,380,28
Seminole,President,Donald Trump,REP,670024,8,21,385,414,
Seminole,President,Gary Johnson,LIB,670024,0,1,24,25,
Seminole,President,Hillary Clinton,DEM,670024,2,10,128,140,
Seminole,U.S. Senate,James Lankford,REP,670024,8,24,415,447,
Seminole,U.S. Senate,Robert Murphy,LIB,670024,0,0,14,14,
Seminole,U.S. Senate,Mike Workman,DEM,670024,2,7,85,94,
Seminole,U.S. Senate,Mark Beard,IND,670024,0,0,8,8,
Seminole,U.S. Senate,Sean Braddy,IND,670024,0,3,15,18,
Seminole,U.S. House,Steve Russell,REP,670024,8,25,356,389,05
Seminole,U.S. House,Zachary Knight,LIB,670024,0,1,24,25,05
Seminole,U.S. House,Al Mcaffrey,DEM,670024,2,8,151,161,05
Seminole,State House,Tom Newell,REP,670024,7,22,318,347,28
Seminole,State House,Marilyn Rainwater,DEM,670024,3,12,218,233,28
Seminole,President,Donald Trump,REP,670025,8,7,92,107,
Seminole,President,Gary Johnson,LIB,670025,0,0,2,2,
Seminole,President,Hillary Clinton,DEM,670025,2,2,35,39,
Seminole,U.S. Senate,James Lankford,REP,670025,8,8,102,118,
Seminole,U.S. Senate,Robert Murphy,LIB,670025,0,0,2,2,
Seminole,U.S. Senate,Mike Workman,DEM,670025,1,0,23,24,
Seminole,U.S. Senate,Mark Beard,IND,670025,0,0,1,1,
Seminole,U.S. Senate,Sean Braddy,IND,670025,1,0,0,1,
Seminole,U.S. House,Steve Russell,REP,670025,8,7,88,103,05
Seminole,U.S. House,Zachary Knight,LIB,670025,0,0,1,1,05
Seminole,U.S. House,Al Mcaffrey,DEM,670025,2,1,38,41,05
Seminole,State Senate,Greg Mccortney,REP,670025,8,7,83,98,13
Seminole,State Senate,Eric Hall,DEM,670025,2,1,43,46,13
Seminole,State House,Tom Newell,REP,670025,5,6,83,94,28
Seminole,State House,Marilyn Rainwater,DEM,670025,5,2,43,50,28
Seminole,President,Donald Trump,REP,670030,4,10,181,195,
Seminole,President,Gary Johnson,LIB,670030,1,1,7,9,
Seminole,President,Hillary Clinton,DEM,670030,0,2,48,50,
Seminole,U.S. Senate,James Lankford,REP,670030,4,12,189,205,
Seminole,U.S. Senate,Robert Murphy,LIB,670030,1,0,3,4,
Seminole,U.S. Senate,Mike Workman,DEM,670030,0,1,35,36,
Seminole,U.S. Senate,Mark Beard,IND,670030,0,0,4,4,
Seminole,U.S. Senate,Sean Braddy,IND,670030,1,0,3,4,
Seminole,U.S. House,Steve Russell,REP,670030,5,9,175,189,05
Seminole,U.S. House,Zachary Knight,LIB,670030,0,0,3,3,05
Seminole,U.S. House,Al Mcaffrey,DEM,670030,1,2,52,55,05
Seminole,State House,Tom Newell,REP,670030,5,10,174,189,28
Seminole,State House,Marilyn Rainwater,DEM,670030,1,1,56,58,28
Seminole,President,Donald Trump,REP,670032,23,74,326,423,
Seminole,President,Gary Johnson,LIB,670032,1,1,15,17,
Seminole,President,Hillary Clinton,DEM,670032,15,41,124,180,
Seminole,U.S. Senate,James Lankford,REP,670032,23,81,347,451,
Seminole,U.S. Senate,Robert Murphy,LIB,670032,1,0,12,13,
Seminole,U.S. Senate,Mike Workman,DEM,670032,14,30,93,137,
Seminole,U.S. Senate,Mark Beard,IND,670032,0,2,6,8,
Seminole,U.S. Senate,Sean Braddy,IND,670032,1,2,11,14,
Seminole,U.S. House,Steve Russell,REP,670032,23,72,308,403,05
Seminole,U.S. House,Zachary Knight,LIB,670032,0,0,26,26,05
Seminole,U.S. House,Al Mcaffrey,DEM,670032,16,42,128,186,05
Seminole,State House,Tom Newell,REP,670032,21,66,291,378,28
Seminole,State House,Marilyn Rainwater,DEM,670032,17,49,172,238,28
Seminole,President,Donald Trump,REP,670033,1,15,69,85,
Seminole,President,Gary Johnson,LIB,670033,1,0,3,4,
Seminole,President,Hillary Clinton,DEM,670033,0,5,14,19,
Seminole,U.S. Senate,James Lankford,REP,670033,2,16,72,90,
Seminole,U.S. Senate,Robert Murphy,LIB,670033,0,0,0,0,
Seminole,U.S. Senate,Mike Workman,DEM,670033,0,3,14,17,
Seminole,U.S. Senate,Mark Beard,IND,670033,0,0,1,1,
Seminole,U.S. Senate,Sean Braddy,IND,670033,0,1,0,1,
Seminole,U.S. House,Steve Russell,REP,670033,2,15,62,79,05
Seminole,U.S. House,Zachary Knight,LIB,670033,0,0,2,2,05
Seminole,U.S. House,Al Mcaffrey,DEM,670033,0,5,22,27,05
Seminole,State Senate,Greg Mccortney,REP,670033,2,14,61,77,13
Seminole,State Senate,Eric Hall,DEM,670033,0,4,25,29,13
Seminole,State House,Tom Newell,REP,670033,2,12,59,73,28
Seminole,State House,Marilyn Rainwater,DEM,670033,0,8,27,35,28
Seminole,President,Donald Trump,REP,670034,24,127,485,636,
Seminole,President,Gary Johnson,LIB,670034,1,5,39,45,
Seminole,President,Hillary Clinton,DEM,670034,12,73,296,381,
Seminole,U.S. Senate,James Lankford,REP,670034,24,131,518,673,
Seminole,U.S. Senate,Robert Murphy,LIB,670034,0,5,13,18,
Seminole,U.S. Senate,Mike Workman,DEM,670034,12,67,262,341,
Seminole,U.S. Senate,Mark Beard,IND,670034,0,1,15,16,
Seminole,U.S. Senate,Sean Braddy,IND,670034,0,2,17,19,
Seminole,U.S. House,Steve Russell,REP,670034,21,119,440,580,05
Seminole,U.S. House,Zachary Knight,LIB,670034,1,5,30,36,05
Seminole,U.S. House,Al Mcaffrey,DEM,670034,13,82,348,443,05
Seminole,State House,Tom Newell,REP,670034,21,114,395,530,28
Seminole,State House,Marilyn Rainwater,DEM,670034,13,91,427,531,28
Seminole,President,Donald Trump,REP,670035,13,24,310,347,
Seminole,President,Gary Johnson,LIB,670035,2,3,22,27,
Seminole,President,Hillary Clinton,DEM,670035,8,10,76,94,
Seminole,U.S. Senate,James Lankford,REP,670035,13,27,326,366,
Seminole,U.S. Senate,Robert Murphy,LIB,670035,0,0,8,8,
Seminole,U.S. Senate,Mike Workman,DEM,670035,7,10,53,70,
Seminole,U.S. Senate,Mark Beard,IND,670035,0,0,13,13,
Seminole,U.S. Senate,Sean Braddy,IND,670035,0,0,7,7,
Seminole,U.S. House,Steve Russell,REP,670035,13,25,305,343,05
Seminole,U.S. House,Zachary Knight,LIB,670035,0,1,19,20,05
Seminole,U.S. House,Al Mcaffrey,DEM,670035,8,11,80,99,05
Seminole,State House,Tom Newell,REP,670035,11,24,290,325,28
Seminole,State House,Marilyn Rainwater,DEM,670035,10,13,115,138,28
Sequoyah,President,Donald Trump,REP,680101,16,81,701,798,
Sequoyah,President,Gary Johnson,LIB,680101,0,3,19,22,
Sequoyah,President,Hillary Clinton,DEM,680101,6,18,148,172,
Sequoyah,U.S. Senate,James Lankford,REP,680101,14,74,592,680,
Sequoyah,U.S. Senate,Robert Murphy,LIB,680101,1,0,21,22,
Sequoyah,U.S. Senate,Mike Workman,DEM,680101,6,22,196,224,
Sequoyah,U.S. Senate,Mark Beard,IND,680101,0,3,16,19,
Sequoyah,U.S. Senate,Sean Braddy,IND,680101,0,3,20,23,
Sequoyah,U.S. House,Markwayne Mullin,REP,680101,16,75,623,714,02
Sequoyah,U.S. House,Joshua Harris-Till,DEM,680101,6,21,180,207,02
Sequoyah,U.S. House,John Mccarthy,IND,680101,0,7,44,51,02
Sequoyah,State House,John Bennett,REP,680101,13,59,484,556,2
Sequoyah,State House,Tom Stites,DEM,680101,9,45,383,437,2
Sequoyah,President,Donald Trump,REP,680102,11,39,352,402,
Sequoyah,President,Gary Johnson,LIB,680102,1,1,14,16,
Sequoyah,President,Hillary Clinton,DEM,680102,4,12,109,125,
Sequoyah,U.S. Senate,James Lankford,REP,680102,14,36,303,353,
Sequoyah,U.S. Senate,Robert Murphy,LIB,680102,1,0,10,11,
Sequoyah,U.S. Senate,Mike Workman,DEM,680102,0,13,137,150,
Sequoyah,U.S. Senate,Mark Beard,IND,680102,1,3,5,9,
Sequoyah,U.S. Senate,Sean Braddy,IND,680102,0,1,9,10,
Sequoyah,U.S. House,Markwayne Mullin,REP,680102,10,33,307,350,02
Sequoyah,U.S. House,Joshua Harris-Till,DEM,680102,3,14,134,151,02
Sequoyah,U.S. House,John Mccarthy,IND,680102,3,6,22,31,02
Sequoyah,State House,John Bennett,REP,680102,8,27,238,273,2
Sequoyah,State House,Tom Stites,DEM,680102,8,26,236,270,2
Sequoyah,President,Donald Trump,REP,680103,19,69,595,683,
Sequoyah,President,Gary Johnson,LIB,680103,0,3,21,24,
Sequoyah,President,Hillary Clinton,DEM,680103,9,21,164,194,
Sequoyah,U.S. Senate,James Lankford,REP,680103,18,68,500,586,
Sequoyah,U.S. Senate,Robert Murphy,LIB,680103,0,0,6,6,
Sequoyah,U.S. Senate,Mike Workman,DEM,680103,8,19,219,246,
Sequoyah,U.S. Senate,Mark Beard,IND,680103,1,2,20,23,
Sequoyah,U.S. Senate,Sean Braddy,IND,680103,2,2,15,19,
Sequoyah,U.S. House,Markwayne Mullin,REP,680103,20,68,526,614,02
Sequoyah,U.S. House,Joshua Harris-Till,DEM,680103,9,19,198,226,02
Sequoyah,U.S. House,John Mccarthy,IND,680103,0,4,43,47,02
Sequoyah,State House,John Bennett,REP,680103,13,57,415,485,2
Sequoyah,State House,Tom Stites,DEM,680103,16,34,369,419,2
Sequoyah,President,Donald Trump,REP,680104,49,90,536,675,
Sequoyah,President,Gary Johnson,LIB,680104,3,1,11,15,
Sequoyah,President,Hillary Clinton,DEM,680104,5,14,107,126,
Sequoyah,U.S. Senate,James Lankford,REP,680104,50,83,471,604,
Sequoyah,U.S. Senate,Robert Murphy,LIB,680104,1,4,13,18,
Sequoyah,U.S. Senate,Mike Workman,DEM,680104,6,16,132,154,
Sequoyah,U.S. Senate,Mark Beard,IND,680104,0,0,14,14,
Sequoyah,U.S. Senate,Sean Braddy,IND,680104,0,1,5,6,
Sequoyah,U.S. House,Markwayne Mullin,REP,680104,49,85,505,639,02
Sequoyah,U.S. House,Joshua Harris-Till,DEM,680104,6,14,104,124,02
Sequoyah,U.S. House,John Mccarthy,IND,680104,2,4,27,33,02
Sequoyah,State House,John Bennett,REP,680104,47,71,400,518,2
Sequoyah,State House,Tom Stites,DEM,680104,10,33,250,293,2
Sequoyah,President,Donald Trump,REP,680105,17,59,557,633,
Sequoyah,President,Gary Johnson,LIB,680105,2,1,31,34,
Sequoyah,President,Hillary Clinton,DEM,680105,19,19,139,177,
Sequoyah,U.S. Senate,James Lankford,REP,680105,17,55,497,569,
Sequoyah,U.S. Senate,Robert Murphy,LIB,680105,1,1,16,18,
Sequoyah,U.S. Senate,Mike Workman,DEM,680105,18,17,158,193,
Sequoyah,U.S. Senate,Mark Beard,IND,680105,0,0,17,17,
Sequoyah,U.S. Senate,Sean Braddy,IND,680105,1,4,18,23,
Sequoyah,U.S. House,Markwayne Mullin,REP,680105,19,53,501,573,02
Sequoyah,U.S. House,Joshua Harris-Till,DEM,680105,15,18,145,178,02
Sequoyah,U.S. House,John Mccarthy,IND,680105,3,5,61,69,02
Sequoyah,State House,John Bennett,REP,680105,18,50,443,511,2
Sequoyah,State House,Tom Stites,DEM,680105,19,29,282,330,2
Sequoyah,President,Donald Trump,REP,680106,17,23,442,482,
Sequoyah,President,Gary Johnson,LIB,680106,1,0,20,21,
Sequoyah,President,Hillary Clinton,DEM,680106,2,9,92,103,
Sequoyah,U.S. Senate,James Lankford,REP,680106,16,22,380,418,
Sequoyah,U.S. Senate,Robert Murphy,LIB,680106,0,0,18,18,
Sequoyah,U.S. Senate,Mike Workman,DEM,680106,3,8,117,128,
Sequoyah,U.S. Senate,Mark Beard,IND,680106,0,0,12,12,
Sequoyah,U.S. Senate,Sean Braddy,IND,680106,1,2,10,13,
Sequoyah,U.S. House,Markwayne Mullin,REP,680106,17,22,401,440,02
Sequoyah,U.S. House,Joshua Harris-Till,DEM,680106,3,8,109,120,02
Sequoyah,U.S. House,John Mccarthy,IND,680106,0,1,29,30,02
Sequoyah,State House,John Bennett,REP,680106,15,21,343,379,2
Sequoyah,State House,Tom Stites,DEM,680106,5,12,211,228,2
Sequoyah,President,Donald Trump,REP,680201,11,12,185,208,
Sequoyah,President,Gary Johnson,LIB,680201,2,1,17,20,
Sequoyah,President,Hillary Clinton,DEM,680201,3,4,50,57,
Sequoyah,U.S. Senate,James Lankford,REP,680201,11,13,157,181,
Sequoyah,U.S. Senate,Robert Murphy,LIB,680201,0,0,12,12,
Sequoyah,U.S. Senate,Mike Workman,DEM,680201,3,3,64,70,
Sequoyah,U.S. Senate,Mark Beard,IND,680201,0,0,9,9,
Sequoyah,U.S. Senate,Sean Braddy,IND,680201,2,2,5,9,
Sequoyah,U.S. House,Markwayne Mullin,REP,680201,12,14,167,193,02
Sequoyah,U.S. House,Joshua Harris-Till,DEM,680201,3,4,58,65,02
Sequoyah,U.S. House,John Mccarthy,IND,680201,1,0,24,25,02
Sequoyah,State House,Don Herrold,REP,680201,9,8,135,152,15
Sequoyah,State House,Ed Cannaday,DEM,680201,7,9,112,128,15
Sequoyah,President,Donald Trump,REP,680202,8,23,313,344,
Sequoyah,President,Gary Johnson,LIB,680202,2,0,25,27,
Sequoyah,President,Hillary Clinton,DEM,680202,3,7,121,131,
Sequoyah,U.S. Senate,James Lankford,REP,680202,6,18,253,277,
Sequoyah,U.S. Senate,Robert Murphy,LIB,680202,0,0,17,17,
Sequoyah,U.S. Senate,Mike Workman,DEM,680202,4,11,154,169,
Sequoyah,U.S. Senate,Mark Beard,IND,680202,0,0,13,13,
Sequoyah,U.S. Senate,Sean Braddy,IND,680202,2,1,14,17,
Sequoyah,U.S. House,Markwayne Mullin,REP,680202,5,20,278,303,02
Sequoyah,U.S. House,Joshua Harris-Till,DEM,680202,5,8,130,143,02
Sequoyah,U.S. House,John Mccarthy,IND,680202,2,2,40,44,02
Sequoyah,State House,John Bennett,REP,680202,8,11,259,278,2
Sequoyah,State House,Tom Stites,DEM,680202,5,20,199,224,2
Sequoyah,President,Donald Trump,REP,680203,5,11,147,163,
Sequoyah,President,Gary Johnson,LIB,680203,0,0,11,11,
Sequoyah,President,Hillary Clinton,DEM,680203,1,4,46,51,
Sequoyah,U.S. Senate,James Lankford,REP,680203,5,10,128,143,
Sequoyah,U.S. Senate,Robert Murphy,LIB,680203,0,0,4,4,
Sequoyah,U.S. Senate,Mike Workman,DEM,680203,1,4,55,60,
Sequoyah,U.S. Senate,Mark Beard,IND,680203,0,0,6,6,
Sequoyah,U.S. Senate,Sean Braddy,IND,680203,0,1,2,3,
Sequoyah,U.S. House,Markwayne Mullin,REP,680203,5,10,140,155,02
Sequoyah,U.S. House,Joshua Harris-Till,DEM,680203,1,5,44,50,02
Sequoyah,U.S. House,John Mccarthy,IND,680203,0,0,11,11,02
Sequoyah,State House,Don Herrold,REP,680203,4,7,89,100,15
Sequoyah,State House,Ed Cannaday,DEM,680203,2,8,108,118,15
Sequoyah,President,Donald Trump,REP,680204,8,14,157,179,
Sequoyah,President,Gary Johnson,LIB,680204,0,1,6,7,
Sequoyah,President,Hillary Clinton,DEM,680204,0,2,41,43,
Sequoyah,U.S. Senate,James Lankford,REP,680204,9,14,137,160,
Sequoyah,U.S. Senate,Robert Murphy,LIB,680204,0,0,4,4,
Sequoyah,U.S. Senate,Mike Workman,DEM,680204,0,1,51,52,
Sequoyah,U.S. Senate,Mark Beard,IND,680204,0,0,4,4,
Sequoyah,U.S. Senate,Sean Braddy,IND,680204,0,1,4,5,
Sequoyah,U.S. House,Markwayne Mullin,REP,680204,7,13,150,170,02
Sequoyah,U.S. House,Joshua Harris-Till,DEM,680204,1,3,45,49,02
Sequoyah,U.S. House,John Mccarthy,IND,680204,1,0,7,8,02
Sequoyah,State House,John Bennett,REP,680204,3,12,124,139,2
Sequoyah,State House,Tom Stites,DEM,680204,6,5,84,95,2
Sequoyah,President,Donald Trump,REP,680205,34,125,509,668,
Sequoyah,President,Gary Johnson,LIB,680205,1,4,28,33,
Sequoyah,President,Hillary Clinton,DEM,680205,8,43,166,217,
Sequoyah,U.S. Senate,James Lankford,REP,680205,37,102,418,557,
Sequoyah,U.S. Senate,Robert Murphy,LIB,680205,0,6,21,27,
Sequoyah,U.S. Senate,Mike Workman,DEM,680205,6,49,201,256,
Sequoyah,U.S. Senate,Mark Beard,IND,680205,0,4,26,30,
Sequoyah,U.S. Senate,Sean Braddy,IND,680205,1,6,25,32,
Sequoyah,U.S. House,Markwayne Mullin,REP,680205,33,104,439,576,02
Sequoyah,U.S. House,Joshua Harris-Till,DEM,680205,7,50,194,251,02
Sequoyah,U.S. House,John Mccarthy,IND,680205,4,12,54,70,02
Sequoyah,State House,John Bennett,REP,680205,19,83,370,472,2
Sequoyah,State House,Tom Stites,DEM,680205,25,90,330,445,2
Sequoyah,President,Donald Trump,REP,680206,7,52,215,274,
Sequoyah,President,Gary Johnson,LIB,680206,0,0,7,7,
Sequoyah,President,Hillary Clinton,DEM,680206,5,12,59,76,
Sequoyah,U.S. Senate,James Lankford,REP,680206,8,45,182,235,
Sequoyah,U.S. Senate,Robert Murphy,LIB,680206,0,1,2,3,
Sequoyah,U.S. Senate,Mike Workman,DEM,680206,3,13,78,94,
Sequoyah,U.S. Senate,Mark Beard,IND,680206,0,0,4,4,
Sequoyah,U.S. Senate,Sean Braddy,IND,680206,0,4,6,10,
Sequoyah,U.S. House,Markwayne Mullin,REP,680206,7,47,194,248,02
Sequoyah,U.S. House,Joshua Harris-Till,DEM,680206,4,13,76,93,02
Sequoyah,U.S. House,John Mccarthy,IND,680206,0,3,6,9,02
Sequoyah,State House,John Bennett,REP,680206,8,35,124,167,2
Sequoyah,State House,Tom Stites,DEM,680206,4,27,159,190,2
Sequoyah,President,Donald Trump,REP,680207,12,23,274,309,
Sequoyah,President,Gary Johnson,LIB,680207,0,1,13,14,
Sequoyah,President,Hillary Clinton,DEM,680207,9,16,98,123,
Sequoyah,U.S. Senate,James Lankford,REP,680207,12,25,250,287,
Sequoyah,U.S. Senate,Robert Murphy,LIB,680207,0,0,7,7,
Sequoyah,U.S. Senate,Mike Workman,DEM,680207,9,15,99,123,
Sequoyah,U.S. Senate,Mark Beard,IND,680207,0,0,10,10,
Sequoyah,U.S. Senate,Sean Braddy,IND,680207,0,0,8,8,
Sequoyah,U.S. House,Markwayne Mullin,REP,680207,11,22,271,304,02
Sequoyah,U.S. House,Joshua Harris-Till,DEM,680207,9,17,80,106,02
Sequoyah,U.S. House,John Mccarthy,IND,680207,1,1,24,26,02
Sequoyah,State House,John Bennett,REP,680207,11,16,239,266,2
Sequoyah,State House,Tom Stites,DEM,680207,10,25,143,178,2
Sequoyah,President,Donald Trump,REP,680208,16,53,374,443,
Sequoyah,President,Gary Johnson,LIB,680208,0,4,25,29,
Sequoyah,President,Hillary Clinton,DEM,680208,7,3,159,169,
Sequoyah,U.S. Senate,James Lankford,REP,680208,14,49,328,391,
Sequoyah,U.S. Senate,Robert Murphy,LIB,680208,0,0,16,16,
Sequoyah,U.S. Senate,Mike Workman,DEM,680208,8,9,185,202,
Sequoyah,U.S. Senate,Mark Beard,IND,680208,0,0,12,12,
Sequoyah,U.S. Senate,Sean Braddy,IND,680208,0,1,13,14,
Sequoyah,U.S. House,Markwayne Mullin,REP,680208,15,50,343,408,02
Sequoyah,U.S. House,Joshua Harris-Till,DEM,680208,7,8,180,195,02
Sequoyah,U.S. House,John Mccarthy,IND,680208,0,2,32,34,02
Sequoyah,State House,Don Herrold,REP,680208,11,34,252,297,15
Sequoyah,State House,Ed Cannaday,DEM,680208,10,23,301,334,15
Sequoyah,President,Donald Trump,REP,680209,22,16,360,398,
Sequoyah,President,Gary Johnson,LIB,680209,1,0,22,23,
Sequoyah,President,Hillary Clinton,DEM,680209,12,2,90,104,
Sequoyah,U.S. Senate,James Lankford,REP,680209,20,12,318,350,
Sequoyah,U.S. Senate,Robert Murphy,LIB,680209,3,0,8,11,
Sequoyah,U.S. Senate,Mike Workman,DEM,680209,12,2,118,132,
Sequoyah,U.S. Senate,Mark Beard,IND,680209,0,2,10,12,
Sequoyah,U.S. Senate,Sean Braddy,IND,680209,0,1,14,15,
Sequoyah,U.S. House,Markwayne Mullin,REP,680209,21,15,333,369,02
Sequoyah,U.S. House,Joshua Harris-Till,DEM,680209,11,2,104,117,02
Sequoyah,U.S. House,John Mccarthy,IND,680209,1,1,31,33,02
Sequoyah,State House,Don Herrold,REP,680209,13,10,192,215,15
Sequoyah,State House,Ed Cannaday,DEM,680209,19,8,272,299,15
Sequoyah,President,Donald Trump,REP,680210,18,7,349,374,
Sequoyah,President,Gary Johnson,LIB,680210,0,0,23,23,
Sequoyah,President,Hillary Clinton,DEM,680210,9,6,119,134,
Sequoyah,U.S. Senate,James Lankford,REP,680210,18,6,329,353,
Sequoyah,U.S. Senate,Robert Murphy,LIB,680210,0,0,13,13,
Sequoyah,U.S. Senate,Mike Workman,DEM,680210,8,5,125,138,
Sequoyah,U.S. Senate,Mark Beard,IND,680210,0,0,7,7,
Sequoyah,U.S. Senate,Sean Braddy,IND,680210,0,2,11,13,
Sequoyah,U.S. House,Markwayne Mullin,REP,680210,17,6,329,352,02
Sequoyah,U.S. House,Joshua Harris-Till,DEM,680210,8,5,120,133,02
Sequoyah,U.S. House,John Mccarthy,IND,680210,2,2,36,40,02
Sequoyah,State House,Don Herrold,REP,680210,15,3,213,231,15
Sequoyah,State House,Ed Cannaday,DEM,680210,11,10,274,295,15
Sequoyah,President,Donald Trump,REP,680301,32,84,536,652,
Sequoyah,President,Gary Johnson,LIB,680301,1,4,34,39,
Sequoyah,President,Hillary Clinton,DEM,680301,18,26,166,210,
Sequoyah,U.S. Senate,James Lankford,REP,680301,31,69,492,592,
Sequoyah,U.S. Senate,Robert Murphy,LIB,680301,2,2,17,21,
Sequoyah,U.S. Senate,Mike Workman,DEM,680301,14,34,172,220,
Sequoyah,U.S. Senate,Mark Beard,IND,680301,1,2,14,17,
Sequoyah,U.S. Senate,Sean Braddy,IND,680301,0,3,27,30,
Sequoyah,U.S. House,Markwayne Mullin,REP,680301,31,76,511,618,02
Sequoyah,U.S. House,Joshua Harris-Till,DEM,680301,14,31,169,214,02
Sequoyah,U.S. House,John Mccarthy,IND,680301,4,4,46,54,02
Sequoyah,State House,John Bennett,REP,680301,19,41,309,369,2
Sequoyah,State House,Tom Stites,DEM,680301,31,72,434,537,2
Sequoyah,President,Donald Trump,REP,680302,16,49,204,269,
Sequoyah,President,Gary Johnson,LIB,680302,0,2,16,18,
Sequoyah,President,Hillary Clinton,DEM,680302,4,17,68,89,
Sequoyah,U.S. Senate,James Lankford,REP,680302,14,41,174,229,
Sequoyah,U.S. Senate,Robert Murphy,LIB,680302,2,3,7,12,
Sequoyah,U.S. Senate,Mike Workman,DEM,680302,5,18,88,111,
Sequoyah,U.S. Senate,Mark Beard,IND,680302,0,3,6,9,
Sequoyah,U.S. Senate,Sean Braddy,IND,680302,0,3,10,13,
Sequoyah,U.S. House,Markwayne Mullin,REP,680302,15,41,179,235,02
Sequoyah,U.S. House,Joshua Harris-Till,DEM,680302,6,19,86,111,02
Sequoyah,U.S. House,John Mccarthy,IND,680302,0,6,16,22,02
Sequoyah,State House,John Bennett,REP,680302,10,31,126,167,2
Sequoyah,State House,Tom Stites,DEM,680302,12,37,163,212,2
Sequoyah,President,Donald Trump,REP,680303,17,86,497,600,
Sequoyah,President,Gary Johnson,LIB,680303,1,4,21,26,
Sequoyah,President,Hillary Clinton,DEM,680303,12,40,161,213,
Sequoyah,U.S. Senate,James Lankford,REP,680303,15,78,434,527,
Sequoyah,U.S. Senate,Robert Murphy,LIB,680303,4,2,19,25,
Sequoyah,U.S. Senate,Mike Workman,DEM,680303,11,39,172,222,
Sequoyah,U.S. Senate,Mark Beard,IND,680303,0,1,12,13,
Sequoyah,U.S. Senate,Sean Braddy,IND,680303,1,8,26,35,
Sequoyah,U.S. House,Markwayne Mullin,REP,680303,15,80,457,552,02
Sequoyah,U.S. House,Joshua Harris-Till,DEM,680303,12,37,170,219,02
Sequoyah,U.S. House,John Mccarthy,IND,680303,2,10,37,49,02
Sequoyah,State House,John Bennett,REP,680303,13,60,311,384,2
Sequoyah,State House,Tom Stites,DEM,680303,19,70,370,459,2
Sequoyah,President,Donald Trump,REP,680304,5,50,332,387,
Sequoyah,President,Gary Johnson,LIB,680304,0,1,9,10,
Sequoyah,President,Hillary Clinton,DEM,680304,1,9,77,87,
Sequoyah,U.S. Senate,James Lankford,REP,680304,5,48,281,334,
Sequoyah,U.S. Senate,Robert Murphy,LIB,680304,1,0,9,10,
Sequoyah,U.S. Senate,Mike Workman,DEM,680304,0,12,101,113,
Sequoyah,U.S. Senate,Mark Beard,IND,680304,0,0,16,16,
Sequoyah,U.S. Senate,Sean Braddy,IND,680304,0,0,8,8,
Sequoyah,U.S. House,Markwayne Mullin,REP,680304,5,47,298,350,02
Sequoyah,U.S. House,Joshua Harris-Till,DEM,680304,1,10,87,98,02
Sequoyah,U.S. House,John Mccarthy,IND,680304,0,3,28,31,02
Sequoyah,State House,John Bennett,REP,680304,3,42,242,287,2
Sequoyah,State House,Tom Stites,DEM,680304,3,18,175,196,2
Sequoyah,President,Donald Trump,REP,680305,14,38,221,273,
Sequoyah,President,Gary Johnson,LIB,680305,2,0,12,14,
Sequoyah,President,Hillary Clinton,DEM,680305,1,5,48,54,
Sequoyah,U.S. Senate,James Lankford,REP,680305,15,35,193,243,
Sequoyah,U.S. Senate,Robert Murphy,LIB,680305,0,1,10,11,
Sequoyah,U.S. Senate,Mike Workman,DEM,680305,2,6,65,73,
Sequoyah,U.S. Senate,Mark Beard,IND,680305,0,0,2,2,
Sequoyah,U.S. Senate,Sean Braddy,IND,680305,0,0,4,4,
Sequoyah,U.S. House,Markwayne Mullin,REP,680305,14,37,195,246,02
Sequoyah,U.S. House,Joshua Harris-Till,DEM,680305,2,4,64,70,02
Sequoyah,U.S. House,John Mccarthy,IND,680305,1,2,12,15,02
Sequoyah,State House,John Bennett,REP,680305,9,27,145,181,2
Sequoyah,State House,Tom Stites,DEM,680305,8,16,134,158,2
Sequoyah,President,Donald Trump,REP,680306,22,54,469,545,
Sequoyah,President,Gary Johnson,LIB,680306,1,1,10,12,
Sequoyah,President,Hillary Clinton,DEM,680306,7,7,118,132,
Sequoyah,U.S. Senate,James Lankford,REP,680306,14,44,388,446,
Sequoyah,U.S. Senate,Robert Murphy,LIB,680306,1,3,15,19,
Sequoyah,U.S. Senate,Mike Workman,DEM,680306,9,11,149,169,
Sequoyah,U.S. Senate,Mark Beard,IND,680306,1,1,15,17,
Sequoyah,U.S. Senate,Sean Braddy,IND,680306,2,1,17,20,
Sequoyah,U.S. House,Markwayne Mullin,REP,680306,18,46,410,474,02
Sequoyah,U.S. House,Joshua Harris-Till,DEM,680306,9,12,134,155,02
Sequoyah,U.S. House,John Mccarthy,IND,680306,0,1,44,45,02
Sequoyah,State House,John Bennett,REP,680306,15,41,332,388,2
Sequoyah,State House,Tom Stites,DEM,680306,15,20,264,299,2
Sequoyah,President,Donald Trump,REP,680307,14,40,244,298,
Sequoyah,President,Gary Johnson,LIB,680307,0,1,11,12,
Sequoyah,President,Hillary Clinton,DEM,680307,2,10,62,74,
Sequoyah,U.S. Senate,James Lankford,REP,680307,12,29,193,234,
Sequoyah,U.S. Senate,Robert Murphy,LIB,680307,1,3,10,14,
Sequoyah,U.S. Senate,Mike Workman,DEM,680307,3,15,76,94,
Sequoyah,U.S. Senate,Mark Beard,IND,680307,0,0,9,9,
Sequoyah,U.S. Senate,Sean Braddy,IND,680307,0,3,13,16,
Sequoyah,U.S. House,Markwayne Mullin,REP,680307,14,34,207,255,02
Sequoyah,U.S. House,Joshua Harris-Till,DEM,680307,2,13,75,90,02
Sequoyah,U.S. House,John Mccarthy,IND,680307,0,3,25,28,02
Sequoyah,State House,John Bennett,REP,680307,8,31,165,204,2
Sequoyah,State House,Tom Stites,DEM,680307,8,20,149,177,2
Sequoyah,President,Donald Trump,REP,680308,4,14,201,219,
Sequoyah,President,Gary Johnson,LIB,680308,0,0,9,9,
Sequoyah,President,Hillary Clinton,DEM,680308,1,4,41,46,
Sequoyah,U.S. Senate,James Lankford,REP,680308,5,13,166,184,
Sequoyah,U.S. Senate,Robert Murphy,LIB,680308,0,0,5,5,
Sequoyah,U.S. Senate,Mike Workman,DEM,680308,1,2,64,67,
Sequoyah,U.S. Senate,Mark Beard,IND,680308,0,0,6,6,
Sequoyah,U.S. Senate,Sean Braddy,IND,680308,0,2,5,7,
Sequoyah,U.S. House,Markwayne Mullin,REP,680308,5,13,176,194,02
Sequoyah,U.S. House,Joshua Harris-Till,DEM,680308,0,4,56,60,02
Sequoyah,U.S. House,John Mccarthy,IND,680308,0,0,13,13,02
Sequoyah,State House,John Bennett,REP,680308,4,9,154,167,2
Sequoyah,State House,Tom Stites,DEM,680308,1,9,100,110,2
Sequoyah,President,Donald Trump,REP,680309,11,18,267,296,
Sequoyah,President,Gary Johnson,LIB,680309,0,0,7,7,
Sequoyah,President,Hillary Clinton,DEM,680309,10,3,67,80,
Sequoyah,U.S. Senate,James Lankford,REP,680309,12,15,234,261,
Sequoyah,U.S. Senate,Robert Murphy,LIB,680309,0,0,8,8,
Sequoyah,U.S. Senate,Mike Workman,DEM,680309,7,3,73,83,
Sequoyah,U.S. Senate,Mark Beard,IND,680309,0,2,7,9,
Sequoyah,U.S. Senate,Sean Braddy,IND,680309,1,0,7,8,
Sequoyah,U.S. House,Markwayne Mullin,REP,680309,13,14,241,268,02
Sequoyah,U.S. House,Joshua Harris-Till,DEM,680309,7,2,67,76,02
Sequoyah,U.S. House,John Mccarthy,IND,680309,1,4,20,25,02
Sequoyah,State House,John Bennett,REP,680309,6,15,197,218,2
Sequoyah,State House,Tom Stites,DEM,680309,15,6,141,162,2
Sequoyah,President,Donald Trump,REP,680310,9,32,275,316,
Sequoyah,President,Gary Johnson,LIB,680310,0,0,15,15,
Sequoyah,President,Hillary Clinton,DEM,680310,2,3,69,74,
Sequoyah,U.S. Senate,James Lankford,REP,680310,8,24,232,264,
Sequoyah,U.S. Senate,Robert Murphy,LIB,680310,0,1,13,14,
Sequoyah,U.S. Senate,Mike Workman,DEM,680310,4,6,87,97,
Sequoyah,U.S. Senate,Mark Beard,IND,680310,0,3,4,7,
Sequoyah,U.S. Senate,Sean Braddy,IND,680310,0,1,16,17,
Sequoyah,U.S. House,Markwayne Mullin,REP,680310,6,30,239,275,02
Sequoyah,U.S. House,Joshua Harris-Till,DEM,680310,4,2,77,83,02
Sequoyah,U.S. House,John Mccarthy,IND,680310,2,3,32,37,02
Sequoyah,State House,John Bennett,REP,680310,7,23,218,248,2
Sequoyah,State House,Tom Stites,DEM,680310,4,12,141,157,2
Stephens,President,Donald Trump,REP,690001,32,82,615,729,
Stephens,President,Gary Johnson,LIB,690001,3,2,32,37,
Stephens,President,Hillary Clinton,DEM,690001,6,16,114,136,
Stephens,U.S. Senate,James Lankford,REP,690001,35,86,636,757,
Stephens,U.S. Senate,Robert Murphy,LIB,690001,1,0,10,11,
Stephens,U.S. Senate,Mike Workman,DEM,690001,8,12,98,118,
Stephens,U.S. Senate,Mark Beard,IND,690001,0,1,6,7,
Stephens,U.S. Senate,Sean Braddy,IND,690001,0,0,10,10,
Stephens,U.S. House,Tom Cole,REP,690001,36,84,655,775,04
Stephens,U.S. House,Sevier White,LIB,690001,2,3,15,20,04
Stephens,U.S. House,Christina Owen,DEM,690001,6,13,93,112,04
Stephens,State Senate,Paul Scott,REP,690001,34,78,613,725,43
Stephens,State Senate,Leah Pollan,DEM,690001,9,21,146,176,43
Stephens,State House,Marcus Mcentire,REP,690001,33,84,668,785,50
Stephens,State House,Melissa Tilley,DEM,690001,8,14,91,113,50
Stephens,President,Donald Trump,REP,690003,38,53,559,650,
Stephens,President,Gary Johnson,LIB,690003,1,2,24,27,
Stephens,President,Hillary Clinton,DEM,690003,15,23,102,140,
Stephens,U.S. Senate,James Lankford,REP,690003,40,58,565,663,
Stephens,U.S. Senate,Robert Murphy,LIB,690003,0,0,11,11,
Stephens,U.S. Senate,Mike Workman,DEM,690003,13,17,87,117,
Stephens,U.S. Senate,Mark Beard,IND,690003,0,3,14,17,
Stephens,U.S. Senate,Sean Braddy,IND,690003,0,0,10,10,
Stephens,U.S. House,Tom Cole,REP,690003,43,56,568,667,04
Stephens,U.S. House,Sevier White,LIB,690003,0,1,19,20,04
Stephens,U.S. House,Christina Owen,DEM,690003,11,21,103,135,04
Stephens,State Senate,Paul Scott,REP,690003,38,50,534,622,43
Stephens,State Senate,Leah Pollan,DEM,690003,14,28,154,196,43
Stephens,State House,Marcus Mcentire,REP,690003,42,56,565,663,50
Stephens,State House,Melissa Tilley,DEM,690003,11,22,119,152,50
Stephens,President,Donald Trump,REP,690004,33,62,590,685,
Stephens,President,Gary Johnson,LIB,690004,3,3,39,45,
Stephens,President,Hillary Clinton,DEM,690004,7,18,174,199,
Stephens,U.S. Senate,James Lankford,REP,690004,35,61,579,675,
Stephens,U.S. Senate,Robert Murphy,LIB,690004,0,0,31,31,
Stephens,U.S. Senate,Mike Workman,DEM,690004,8,19,152,179,
Stephens,U.S. Senate,Mark Beard,IND,690004,0,0,16,16,
Stephens,U.S. Senate,Sean Braddy,IND,690004,1,2,26,29,
Stephens,U.S. House,Tom Cole,REP,690004,36,63,603,702,04
Stephens,U.S. House,Sevier White,LIB,690004,0,0,41,41,04
Stephens,U.S. House,Christina Owen,DEM,690004,8,20,162,190,04
Stephens,State Senate,Paul Scott,REP,690004,30,59,586,675,43
Stephens,State Senate,Leah Pollan,DEM,690004,12,24,214,250,43
Stephens,State House,Marcus Mcentire,REP,690004,33,62,599,694,50
Stephens,State House,Melissa Tilley,DEM,690004,8,20,200,228,50
Stephens,President,Donald Trump,REP,690008,8,41,439,488,
Stephens,President,Gary Johnson,LIB,690008,1,7,31,39,
Stephens,President,Hillary Clinton,DEM,690008,4,29,249,282,
Stephens,U.S. Senate,James Lankford,REP,690008,8,42,421,471,
Stephens,U.S. Senate,Robert Murphy,LIB,690008,0,7,26,33,
Stephens,U.S. Senate,Mike Workman,DEM,690008,5,25,221,251,
Stephens,U.S. Senate,Mark Beard,IND,690008,0,0,23,23,
Stephens,U.S. Senate,Sean Braddy,IND,690008,0,3,24,27,
Stephens,U.S. House,Tom Cole,REP,690008,9,44,446,499,04
Stephens,U.S. House,Sevier White,LIB,690008,0,4,29,33,04
Stephens,U.S. House,Christina Owen,DEM,690008,4,28,240,272,04
Stephens,State Senate,Paul Scott,REP,690008,9,44,429,482,43
Stephens,State Senate,Leah Pollan,DEM,690008,4,32,282,318,43
Stephens,State House,Marcus Mcentire,REP,690008,7,44,423,474,50
Stephens,State House,Melissa Tilley,DEM,690008,5,32,286,323,50
Stephens,President,Donald Trump,REP,690012,27,58,491,576,
Stephens,President,Gary Johnson,LIB,690012,1,4,31,36,
Stephens,President,Hillary Clinton,DEM,690012,7,27,154,188,
Stephens,U.S. Senate,James Lankford,REP,690012,27,59,462,548,
Stephens,U.S. Senate,Robert Murphy,LIB,690012,1,2,14,17,
Stephens,U.S. Senate,Mike Workman,DEM,690012,7,23,149,179,
Stephens,U.S. Senate,Mark Beard,IND,690012,0,1,20,21,
Stephens,U.S. Senate,Sean Braddy,IND,690012,0,3,22,25,
Stephens,U.S. House,Tom Cole,REP,690012,26,65,485,576,04
Stephens,U.S. House,Sevier White,LIB,690012,1,1,25,27,04
Stephens,U.S. House,Christina Owen,DEM,690012,8,21,159,188,04
Stephens,State Senate,Paul Scott,REP,690012,26,58,458,542,43
Stephens,State Senate,Leah Pollan,DEM,690012,8,30,208,246,43
Stephens,State House,Marcus Mcentire,REP,690012,24,65,491,580,50
Stephens,State House,Melissa Tilley,DEM,690012,10,23,178,211,50
Stephens,President,Donald Trump,REP,690013,18,12,158,188,
Stephens,President,Gary Johnson,LIB,690013,0,1,9,10,
Stephens,President,Hillary Clinton,DEM,690013,27,1,94,122,
Stephens,U.S. Senate,James Lankford,REP,690013,21,10,155,186,
Stephens,U.S. Senate,Robert Murphy,LIB,690013,0,0,7,7,
Stephens,U.S. Senate,Mike Workman,DEM,690013,21,1,81,103,
Stephens,U.S. Senate,Mark Beard,IND,690013,0,1,5,6,
Stephens,U.S. Senate,Sean Braddy,IND,690013,1,1,11,13,
Stephens,U.S. House,Tom Cole,REP,690013,19,11,165,195,04
Stephens,U.S. House,Sevier White,LIB,690013,1,2,8,11,04
Stephens,U.S. House,Christina Owen,DEM,690013,22,1,86,109,04
Stephens,State Senate,Paul Scott,REP,690013,18,12,138,168,43
Stephens,State Senate,Leah Pollan,DEM,690013,24,2,122,148,43
Stephens,State House,Marcus Mcentire,REP,690013,17,10,142,169,50
Stephens,State House,Melissa Tilley,DEM,690013,25,4,114,143,50
Stephens,President,Donald Trump,REP,690014,48,157,799,1004,
Stephens,President,Gary Johnson,LIB,690014,4,2,39,45,
Stephens,President,Hillary Clinton,DEM,690014,14,39,148,201,
Stephens,U.S. Senate,James Lankford,REP,690014,49,165,784,998,
Stephens,U.S. Senate,Robert Murphy,LIB,690014,2,0,23,25,
Stephens,U.S. Senate,Mike Workman,DEM,690014,14,32,141,187,
Stephens,U.S. Senate,Mark Beard,IND,690014,0,0,17,17,
Stephens,U.S. Senate,Sean Braddy,IND,690014,0,2,17,19,
Stephens,U.S. House,Tom Cole,REP,690014,49,157,810,1016,04
Stephens,U.S. House,Sevier White,LIB,690014,2,4,36,42,04
Stephens,U.S. House,Christina Owen,DEM,690014,14,37,133,184,04
Stephens,State Senate,Chris Kidd,REP,690014,49,129,705,883,31
Stephens,State Senate,Perry Brinegar,DEM,690014,16,68,275,359,31
Stephens,State House,Marcus Mcentire,REP,690014,49,157,778,984,50
Stephens,State House,Melissa Tilley,DEM,690014,16,41,197,254,50
Stephens,President,Donald Trump,REP,690015,10,15,151,176,
Stephens,President,Gary Johnson,LIB,690015,0,0,6,6,
Stephens,President,Hillary Clinton,DEM,690015,3,4,38,45,
Stephens,U.S. Senate,James Lankford,REP,690015,10,15,150,175,
Stephens,U.S. Senate,Robert Murphy,LIB,690015,0,0,2,2,
Stephens,U.S. Senate,Mike Workman,DEM,690015,2,4,31,37,
Stephens,U.S. Senate,Mark Beard,IND,690015,0,0,5,5,
Stephens,U.S. Senate,Sean Braddy,IND,690015,1,0,6,7,
Stephens,U.S. House,Tom Cole,REP,690015,9,15,157,181,04
Stephens,U.S. House,Sevier White,LIB,690015,1,0,5,6,04
Stephens,U.S. House,Christina Owen,DEM,690015,3,4,32,39,04
Stephens,State Senate,Chris Kidd,REP,690015,10,16,141,167,31
Stephens,State Senate,Perry Brinegar,DEM,690015,2,3,51,56,31
Stephens,State House,Marcus Mcentire,REP,690015,8,15,150,173,50
Stephens,State House,Melissa Tilley,DEM,690015,4,4,43,51,50
Stephens,President,Donald Trump,REP,690016,49,142,918,1109,
Stephens,President,Gary Johnson,LIB,690016,4,5,52,61,
Stephens,President,Hillary Clinton,DEM,690016,30,31,183,244,
Stephens,U.S. Senate,James Lankford,REP,690016,61,149,944,1154,
Stephens,U.S. Senate,Robert Murphy,LIB,690016,0,0,23,23,
Stephens,U.S. Senate,Mike Workman,DEM,690016,21,25,154,200,
Stephens,U.S. Senate,Mark Beard,IND,690016,0,2,17,19,
Stephens,U.S. Senate,Sean Braddy,IND,690016,1,0,13,14,
Stephens,U.S. House,Tom Cole,REP,690016,60,147,955,1162,04
Stephens,U.S. House,Sevier White,LIB,690016,1,2,43,46,04
Stephens,U.S. House,Christina Owen,DEM,690016,21,28,155,204,04
Stephens,State Senate,Chris Kidd,REP,690016,53,132,824,1009,31
Stephens,State Senate,Perry Brinegar,DEM,690016,29,45,320,394,31
Stephens,State House,Marcus Mcentire,REP,690016,58,146,939,1143,50
Stephens,State House,Melissa Tilley,DEM,690016,24,31,205,260,50
Stephens,President,Donald Trump,REP,690019,51,103,857,1011,
Stephens,President,Gary Johnson,LIB,690019,5,2,43,50,
Stephens,President,Hillary Clinton,DEM,690019,17,36,177,230,
Stephens,U.S. Senate,James Lankford,REP,690019,55,106,892,1053,
Stephens,U.S. Senate,Robert Murphy,LIB,690019,0,1,17,18,
Stephens,U.S. Senate,Mike Workman,DEM,690019,14,30,138,182,
Stephens,U.S. Senate,Mark Beard,IND,690019,2,1,19,22,
Stephens,U.S. Senate,Sean Braddy,IND,690019,0,1,12,13,
Stephens,U.S. House,Tom Cole,REP,690019,56,108,914,1078,04
Stephens,U.S. House,Sevier White,LIB,690019,1,3,19,23,04
Stephens,U.S. House,Christina Owen,DEM,690019,16,29,149,194,04
Stephens,State Senate,Paul Scott,REP,690019,49,102,845,996,43
Stephens,State Senate,Leah Pollan,DEM,690019,22,37,234,293,43
Stephens,State House,Marcus Mcentire,REP,690019,54,113,898,1065,50
Stephens,State House,Melissa Tilley,DEM,690019,18,26,174,218,50
Stephens,President,Donald Trump,REP,690032,26,58,752,836,
Stephens,President,Gary Johnson,LIB,690032,3,1,23,27,
Stephens,President,Hillary Clinton,DEM,690032,9,15,165,189,
Stephens,U.S. Senate,James Lankford,REP,690032,27,61,733,821,
Stephens,U.S. Senate,Robert Murphy,LIB,690032,3,1,16,20,
Stephens,U.S. Senate,Mike Workman,DEM,690032,7,9,145,161,
Stephens,U.S. Senate,Mark Beard,IND,690032,0,1,21,22,
Stephens,U.S. Senate,Sean Braddy,IND,690032,0,0,20,20,
Stephens,U.S. House,Tom Cole,REP,690032,30,61,769,860,04
Stephens,U.S. House,Sevier White,LIB,690032,2,1,22,25,04
Stephens,U.S. House,Christina Owen,DEM,690032,6,9,150,165,04
Stephens,State Senate,Paul Scott,REP,690032,29,60,692,781,43
Stephens,State Senate,Leah Pollan,DEM,690032,9,12,241,262,43
Stephens,State House,Scott Biggs,REP,690032,24,54,670,748,51
Stephens,State House,Charles Murdock,DEM,690032,14,19,262,295,51
Stephens,President,Donald Trump,REP,690033,55,113,861,1029,
Stephens,President,Gary Johnson,LIB,690033,2,3,31,36,
Stephens,President,Hillary Clinton,DEM,690033,22,25,156,203,
Stephens,U.S. Senate,James Lankford,REP,690033,59,114,846,1019,
Stephens,U.S. Senate,Robert Murphy,LIB,690033,1,1,21,23,
Stephens,U.S. Senate,Mike Workman,DEM,690033,12,22,148,182,
Stephens,U.S. Senate,Mark Beard,IND,690033,2,0,13,15,
Stephens,U.S. Senate,Sean Braddy,IND,690033,4,2,16,22,
Stephens,U.S. House,Tom Cole,REP,690033,63,113,868,1044,04
Stephens,U.S. House,Sevier White,LIB,690033,0,2,32,34,04
Stephens,U.S. House,Christina Owen,DEM,690033,16,22,146,184,04
Stephens,State Senate,Paul Scott,REP,690033,54,107,828,989,43
Stephens,State Senate,Leah Pollan,DEM,690033,21,33,216,270,43
Stephens,State House,Scott Biggs,REP,690033,52,104,772,928,51
Stephens,State House,Charles Murdock,DEM,690033,26,35,269,330,51
Stephens,President,Donald Trump,REP,690041,16,27,604,647,
Stephens,President,Gary Johnson,LIB,690041,1,2,30,33,
Stephens,President,Hillary Clinton,DEM,690041,2,5,106,113,
Stephens,U.S. Senate,James Lankford,REP,690041,17,27,586,630,
Stephens,U.S. Senate,Robert Murphy,LIB,690041,0,0,16,16,
Stephens,U.S. Senate,Mike Workman,DEM,690041,1,7,112,120,
Stephens,U.S. Senate,Mark Beard,IND,690041,0,2,11,13,
Stephens,U.S. Senate,Sean Braddy,IND,690041,0,0,9,9,
Stephens,U.S. House,Tom Cole,REP,690041,14,29,605,648,04
Stephens,U.S. House,Sevier White,LIB,690041,1,1,26,28,04
Stephens,U.S. House,Christina Owen,DEM,690041,3,6,112,121,04
Stephens,State Senate,Paul Scott,REP,690041,17,29,549,595,43
Stephens,State Senate,Leah Pollan,DEM,690041,1,7,181,189,43
Stephens,State House,Marcus Mcentire,REP,690041,15,26,504,545,50
Stephens,State House,Melissa Tilley,DEM,690041,3,9,228,240,50
Stephens,President,Donald Trump,REP,690049,2,6,127,135,
Stephens,President,Gary Johnson,LIB,690049,0,0,6,6,
Stephens,President,Hillary Clinton,DEM,690049,1,3,19,23,
Stephens,U.S. Senate,James Lankford,REP,690049,2,8,125,135,
Stephens,U.S. Senate,Robert Murphy,LIB,690049,0,0,0,0,
Stephens,U.S. Senate,Mike Workman,DEM,690049,1,1,22,24,
Stephens,U.S. Senate,Mark Beard,IND,690049,0,0,4,4,
Stephens,U.S. Senate,Sean Braddy,IND,690049,0,0,1,1,
Stephens,U.S. House,Tom Cole,REP,690049,2,6,126,134,04
Stephens,U.S. House,Sevier White,LIB,690049,0,1,1,2,04
Stephens,U.S. House,Christina Owen,DEM,690049,1,2,25,28,04
Stephens,State Senate,Chris Kidd,REP,690049,2,8,111,121,31
Stephens,State Senate,Perry Brinegar,DEM,690049,1,1,41,43,31
Stephens,State House,Scott Biggs,REP,690049,2,6,107,115,51
Stephens,State House,Charles Murdock,DEM,690049,1,3,45,49,51
Stephens,President,Donald Trump,REP,690050,38,108,834,980,
Stephens,President,Gary Johnson,LIB,690050,4,4,30,38,
Stephens,President,Hillary Clinton,DEM,690050,16,19,134,169,
Stephens,U.S. Senate,James Lankford,REP,690050,42,102,823,967,
Stephens,U.S. Senate,Robert Murphy,LIB,690050,2,2,15,19,
Stephens,U.S. Senate,Mike Workman,DEM,690050,12,20,136,168,
Stephens,U.S. Senate,Mark Beard,IND,690050,1,1,11,13,
Stephens,U.S. Senate,Sean Braddy,IND,690050,1,5,11,17,
Stephens,U.S. House,Tom Cole,REP,690050,39,106,826,971,04
Stephens,U.S. House,Sevier White,LIB,690050,3,3,29,35,04
Stephens,U.S. House,Christina Owen,DEM,690050,17,22,137,176,04
Stephens,State Senate,Paul Scott,REP,690050,40,106,800,946,43
Stephens,State Senate,Leah Pollan,DEM,690050,19,25,194,238,43
Stephens,State House,Scott Biggs,REP,690050,38,104,772,914,51
Stephens,State House,Charles Murdock,DEM,690050,21,25,212,258,51
Stephens,President,Donald Trump,REP,690051,9,19,336,364,
Stephens,President,Gary Johnson,LIB,690051,0,2,14,16,
Stephens,President,Hillary Clinton,DEM,690051,3,0,37,40,
Stephens,U.S. Senate,James Lankford,REP,690051,8,14,332,354,
Stephens,U.S. Senate,Robert Murphy,LIB,690051,1,2,8,11,
Stephens,U.S. Senate,Mike Workman,DEM,690051,3,3,27,33,
Stephens,U.S. Senate,Mark Beard,IND,690051,0,2,11,13,
Stephens,U.S. Senate,Sean Braddy,IND,690051,0,0,6,6,
Stephens,U.S. House,Tom Cole,REP,690051,9,15,340,364,04
Stephens,U.S. House,Sevier White,LIB,690051,1,4,14,19,04
Stephens,U.S. House,Christina Owen,DEM,690051,2,2,31,35,04
Stephens,State Senate,Chris Kidd,REP,690051,10,14,296,320,31
Stephens,State Senate,Perry Brinegar,DEM,690051,2,7,89,98,31
Stephens,State House,Scooter Park,REP,690051,8,14,316,338,65
Stephens,State House,Rick Gilleland,DEM,690051,4,7,65,76,65
Stephens,President,Donald Trump,REP,690052,10,19,114,143,
Stephens,President,Gary Johnson,LIB,690052,0,0,6,6,
Stephens,President,Hillary Clinton,DEM,690052,4,2,29,35,
Stephens,U.S. Senate,James Lankford,REP,690052,8,19,117,144,
Stephens,U.S. Senate,Robert Murphy,LIB,690052,0,0,2,2,
Stephens,U.S. Senate,Mike Workman,DEM,690052,5,2,20,27,
Stephens,U.S. Senate,Mark Beard,IND,690052,0,0,2,2,
Stephens,U.S. Senate,Sean Braddy,IND,690052,1,0,4,5,
Stephens,U.S. House,Tom Cole,REP,690052,10,18,119,147,04
Stephens,U.S. House,Sevier White,LIB,690052,0,1,4,5,04
Stephens,U.S. House,Christina Owen,DEM,690052,4,2,23,29,04
Stephens,State Senate,Paul Scott,REP,690052,9,19,119,147,43
Stephens,State Senate,Leah Pollan,DEM,690052,5,2,29,36,43
Stephens,State House,Marcus Mcentire,REP,690052,8,19,125,152,50
Stephens,State House,Melissa Tilley,DEM,690052,6,2,21,29,50
Stephens,President,Donald Trump,REP,690053,2,9,153,164,
Stephens,President,Gary Johnson,LIB,690053,0,1,4,5,
Stephens,President,Hillary Clinton,DEM,690053,2,3,18,23,
Stephens,U.S. Senate,James Lankford,REP,690053,2,10,145,157,
Stephens,U.S. Senate,Robert Murphy,LIB,690053,0,0,1,1,
Stephens,U.S. Senate,Mike Workman,DEM,690053,2,3,20,25,
Stephens,U.S. Senate,Mark Beard,IND,690053,0,0,4,4,
Stephens,U.S. Senate,Sean Braddy,IND,690053,0,0,3,3,
Stephens,U.S. House,Tom Cole,REP,690053,2,8,150,160,04
Stephens,U.S. House,Sevier White,LIB,690053,0,1,4,5,04
Stephens,U.S. House,Christina Owen,DEM,690053,2,4,19,25,04
Stephens,State Senate,Paul Scott,REP,690053,2,9,153,164,43
Stephens,State Senate,Leah Pollan,DEM,690053,2,4,20,26,43
Stephens,State House,Scott Biggs,REP,690053,1,8,138,147,51
Stephens,State House,Charles Murdock,DEM,690053,3,5,34,42,51
Stephens,President,Donald Trump,REP,690054,7,10,203,220,
Stephens,President,Gary Johnson,LIB,690054,0,0,10,10,
Stephens,President,Hillary Clinton,DEM,690054,3,0,43,46,
Stephens,U.S. Senate,James Lankford,REP,690054,6,10,204,220,
Stephens,U.S. Senate,Robert Murphy,LIB,690054,0,0,5,5,
Stephens,U.S. Senate,Mike Workman,DEM,690054,2,0,36,38,
Stephens,U.S. Senate,Mark Beard,IND,690054,1,0,6,7,
Stephens,U.S. Senate,Sean Braddy,IND,690054,1,0,5,6,
Stephens,U.S. House,Tom Cole,REP,690054,6,10,206,222,04
Stephens,U.S. House,Sevier White,LIB,690054,1,0,7,8,04
Stephens,U.S. House,Christina Owen,DEM,690054,3,0,43,46,04
Stephens,State Senate,Paul Scott,REP,690054,7,10,195,212,43
Stephens,State Senate,Leah Pollan,DEM,690054,3,0,61,64,43
Stephens,State House,Scott Biggs,REP,690054,6,10,190,206,51
Stephens,State House,Charles Murdock,DEM,690054,4,0,65,69,51
Stephens,President,Donald Trump,REP,690055,8,5,194,207,
Stephens,President,Gary Johnson,LIB,690055,0,1,5,6,
Stephens,President,Hillary Clinton,DEM,690055,1,2,56,59,
Stephens,U.S. Senate,James Lankford,REP,690055,8,5,185,198,
Stephens,U.S. Senate,Robert Murphy,LIB,690055,0,0,7,7,
Stephens,U.S. Senate,Mike Workman,DEM,690055,1,2,56,59,
Stephens,U.S. Senate,Mark Beard,IND,690055,0,0,3,3,
Stephens,U.S. Senate,Sean Braddy,IND,690055,0,0,3,3,
Stephens,U.S. House,Tom Cole,REP,690055,8,5,183,196,04
Stephens,U.S. House,Sevier White,LIB,690055,0,1,6,7,04
Stephens,U.S. House,Christina Owen,DEM,690055,1,2,65,68,04
Stephens,State Senate,Paul Scott,REP,690055,8,6,175,189,43
Stephens,State Senate,Leah Pollan,DEM,690055,1,2,75,78,43
Stephens,State House,Scott Biggs,REP,690055,8,6,174,188,51
Stephens,State House,Charles Murdock,DEM,690055,1,2,77,80,51
Stephens,President,Donald Trump,REP,690056,6,8,300,314,
Stephens,President,Gary Johnson,LIB,690056,0,0,15,15,
Stephens,President,Hillary Clinton,DEM,690056,1,1,35,37,
Stephens,U.S. Senate,James Lankford,REP,690056,7,7,298,312,
Stephens,U.S. Senate,Robert Murphy,LIB,690056,0,0,4,4,
Stephens,U.S. Senate,Mike Workman,DEM,690056,1,1,37,39,
Stephens,U.S. Senate,Mark Beard,IND,690056,0,0,4,4,
Stephens,U.S. Senate,Sean Braddy,IND,690056,0,0,4,4,
Stephens,U.S. House,Tom Cole,REP,690056,7,7,301,315,04
Stephens,U.S. House,Sevier White,LIB,690056,0,0,10,10,04
Stephens,U.S. House,Christina Owen,DEM,690056,1,1,37,39,04
Stephens,State Senate,Paul Scott,REP,690056,7,6,279,292,43
Stephens,State Senate,Leah Pollan,DEM,690056,1,2,63,66,43
Stephens,State House,Scott Biggs,REP,690056,6,7,253,266,51
Stephens,State House,Charles Murdock,DEM,690056,1,1,92,94,51
Stephens,President,Donald Trump,REP,690057,12,58,508,578,
Stephens,President,Gary Johnson,LIB,690057,3,2,22,27,
Stephens,President,Hillary Clinton,DEM,690057,2,12,69,83,
Stephens,U.S. Senate,James Lankford,REP,690057,13,59,505,577,
Stephens,U.S. Senate,Robert Murphy,LIB,690057,0,1,11,12,
Stephens,U.S. Senate,Mike Workman,DEM,690057,1,9,61,71,
Stephens,U.S. Senate,Mark Beard,IND,690057,2,1,11,14,
Stephens,U.S. Senate,Sean Braddy,IND,690057,0,2,6,8,
Stephens,U.S. House,Tom Cole,REP,690057,15,60,514,589,04
Stephens,U.S. House,Sevier White,LIB,690057,0,4,14,18,04
Stephens,U.S. House,Christina Owen,DEM,690057,1,8,68,77,04
Stephens,State Senate,Paul Scott,REP,690057,13,59,503,575,43
Stephens,State Senate,Leah Pollan,DEM,690057,3,13,93,109,43
Stephens,State House,Marcus Mcentire,REP,690057,15,56,504,575,50
Stephens,State House,Melissa Tilley,DEM,690057,1,16,91,108,50
Stephens,President,Donald Trump,REP,690058,4,6,308,318,
Stephens,President,Gary Johnson,LIB,690058,1,0,6,7,
Stephens,President,Hillary Clinton,DEM,690058,2,0,35,37,
Stephens,U.S. Senate,James Lankford,REP,690058,4,5,301,310,
Stephens,U.S. Senate,Robert Murphy,LIB,690058,1,0,2,3,
Stephens,U.S. Senate,Mike Workman,DEM,690058,1,0,36,37,
Stephens,U.S. Senate,Mark Beard,IND,690058,0,1,4,5,
Stephens,U.S. Senate,Sean Braddy,IND,690058,1,0,5,6,
Stephens,U.S. House,Tom Cole,REP,690058,5,6,303,314,04
Stephens,U.S. House,Sevier White,LIB,690058,1,0,2,3,04
Stephens,U.S. House,Christina Owen,DEM,690058,1,0,41,42,04
Stephens,State Senate,Paul Scott,REP,690058,4,5,289,298,43
Stephens,State Senate,Leah Pollan,DEM,690058,3,1,58,62,43
Stephens,State House,Scott Biggs,REP,690058,3,6,236,245,51
Stephens,State House,Charles Murdock,DEM,690058,4,0,112,116,51
Stephens,President,Donald Trump,REP,690059,12,14,222,248,
Stephens,President,Gary Johnson,LIB,690059,0,0,9,9,
Stephens,President,Hillary Clinton,DEM,690059,1,0,17,18,
Stephens,U.S. Senate,James Lankford,REP,690059,11,14,217,242,
Stephens,U.S. Senate,Robert Murphy,LIB,690059,0,0,1,1,
Stephens,U.S. Senate,Mike Workman,DEM,690059,1,0,24,25,
Stephens,U.S. Senate,Mark Beard,IND,690059,1,0,3,4,
Stephens,U.S. Senate,Sean Braddy,IND,690059,0,0,2,2,
Stephens,U.S. House,Tom Cole,REP,690059,11,13,217,241,04
Stephens,U.S. House,Sevier White,LIB,690059,1,0,4,5,04
Stephens,U.S. House,Christina Owen,DEM,690059,1,0,26,27,04
Stephens,State Senate,Paul Scott,REP,690059,11,13,203,227,43
Stephens,State Senate,Leah Pollan,DEM,690059,2,0,41,43,43
Stephens,State House,Marcus Mcentire,REP,690059,11,14,200,225,50
Stephens,State House,Melissa Tilley,DEM,690059,2,0,44,46,50
Stephens,President,Donald Trump,REP,690060,1,4,63,68,
Stephens,President,Gary Johnson,LIB,690060,0,0,1,1,
Stephens,President,Hillary Clinton,DEM,690060,0,0,9,9,
Stephens,U.S. Senate,James Lankford,REP,690060,1,4,60,65,
Stephens,U.S. Senate,Robert Murphy,LIB,690060,0,0,2,2,
Stephens,U.S. Senate,Mike Workman,DEM,690060,0,0,8,8,
Stephens,U.S. Senate,Mark Beard,IND,690060,0,0,2,2,
Stephens,U.S. Senate,Sean Braddy,IND,690060,0,0,1,1,
Stephens,U.S. House,Tom Cole,REP,690060,1,4,62,67,04
Stephens,U.S. House,Sevier White,LIB,690060,0,0,2,2,04
Stephens,U.S. House,Christina Owen,DEM,690060,0,0,9,9,04
Stephens,State Senate,Paul Scott,REP,690060,0,4,60,64,43
Stephens,State Senate,Leah Pollan,DEM,690060,1,0,12,13,43
Stephens,State House,Scooter Park,REP,690060,1,4,60,65,65
Stephens,State House,Rick Gilleland,DEM,690060,0,0,12,12,65
Stephens,President,Donald Trump,REP,690061,11,38,546,595,
Stephens,President,Gary Johnson,LIB,690061,1,1,11,13,
Stephens,President,Hillary Clinton,DEM,690061,3,4,77,84,
Stephens,U.S. Senate,James Lankford,REP,690061,9,38,518,565,
Stephens,U.S. Senate,Robert Murphy,LIB,690061,1,0,9,10,
Stephens,U.S. Senate,Mike Workman,DEM,690061,3,4,76,83,
Stephens,U.S. Senate,Mark Beard,IND,690061,1,0,18,19,
Stephens,U.S. Senate,Sean Braddy,IND,690061,0,0,14,14,
Stephens,U.S. House,Tom Cole,REP,690061,11,38,530,579,04
Stephens,U.S. House,Sevier White,LIB,690061,1,0,21,22,04
Stephens,U.S. House,Christina Owen,DEM,690061,3,4,89,96,04
Stephens,State Senate,Paul Scott,REP,690061,11,33,494,538,43
Stephens,State Senate,Leah Pollan,DEM,690061,4,5,138,147,43
Stephens,State House,Marcus Mcentire,REP,690061,11,34,499,544,50
Stephens,State House,Melissa Tilley,DEM,690061,4,7,138,149,50
Stephens,President,Donald Trump,REP,690062,20,21,409,450,
Stephens,President,Gary Johnson,LIB,690062,1,2,12,15,
Stephens,President,Hillary Clinton,DEM,690062,2,2,94,98,
Stephens,U.S. Senate,James Lankford,REP,690062,20,22,400,442,
Stephens,U.S. Senate,Robert Murphy,LIB,690062,0,0,9,9,
Stephens,U.S. Senate,Mike Workman,DEM,690062,1,3,88,92,
Stephens,U.S. Senate,Mark Beard,IND,690062,2,0,6,8,
Stephens,U.S. Senate,Sean Braddy,IND,690062,0,0,6,6,
Stephens,U.S. House,Tom Cole,REP,690062,22,20,411,453,04
Stephens,U.S. House,Sevier White,LIB,690062,0,0,17,17,04
Stephens,U.S. House,Christina Owen,DEM,690062,1,5,82,88,04
Stephens,State Senate,Chris Kidd,REP,690062,20,21,403,444,31
Stephens,State Senate,Perry Brinegar,DEM,690062,3,4,110,117,31
Stephens,State House,Marcus Mcentire,REP,690062,21,19,360,400,50
Stephens,State House,Melissa Tilley,DEM,690062,2,6,149,157,50
Stephens,President,Donald Trump,REP,690063,10,12,248,270,
Stephens,President,Gary Johnson,LIB,690063,0,0,10,10,
Stephens,President,Hillary Clinton,DEM,690063,1,2,30,33,
Stephens,U.S. Senate,James Lankford,REP,690063,11,10,243,264,
Stephens,U.S. Senate,Robert Murphy,LIB,690063,0,1,4,5,
Stephens,U.S. Senate,Mike Workman,DEM,690063,0,2,33,35,
Stephens,U.S. Senate,Mark Beard,IND,690063,0,1,6,7,
Stephens,U.S. Senate,Sean Braddy,IND,690063,0,0,1,1,
Stephens,U.S. House,Tom Cole,REP,690063,11,13,245,269,04
Stephens,U.S. House,Sevier White,LIB,690063,0,0,10,10,04
Stephens,U.S. House,Christina Owen,DEM,690063,0,2,33,35,04
Stephens,State Senate,Chris Kidd,REP,690063,9,8,215,232,31
Stephens,State Senate,Perry Brinegar,DEM,690063,2,7,72,81,31
Stephens,State House,Scooter Park,REP,690063,11,12,237,260,65
Stephens,State House,Rick Gilleland,DEM,690063,0,2,46,48,65
Texas,President,Donald Trump,REP,700101,33,46,585,664,
Texas,President,Gary Johnson,LIB,700101,1,5,30,36,
Texas,President,Hillary Clinton,DEM,700101,4,2,73,79,
Texas,U.S. Senate,James Lankford,REP,700101,29,47,548,624,
Texas,U.S. Senate,Robert Murphy,LIB,700101,0,1,20,21,
Texas,U.S. Senate,Mike Workman,DEM,700101,4,1,78,83,
Texas,U.S. Senate,Mark Beard,IND,700101,2,2,15,19,
Texas,U.S. Senate,Sean Braddy,IND,700101,0,0,23,23,
Texas,U.S. House,Frank Lucas,REP,700101,30,49,604,683,03
Texas,U.S. House,Frankie Robbins,DEM,700101,5,2,78,85,03
Texas,State House,Casey Murdock,REP,700101,34,47,580,661,61
Texas,State House,Ashlee Renee Ortiz,DEM,700101,4,5,103,112,61
Texas,President,Donald Trump,REP,700102,4,42,169,215,
Texas,President,Gary Johnson,LIB,700102,0,4,15,19,
Texas,President,Hillary Clinton,DEM,700102,1,27,87,115,
Texas,U.S. Senate,James Lankford,REP,700102,3,38,181,222,
Texas,U.S. Senate,Robert Murphy,LIB,700102,1,7,14,22,
Texas,U.S. Senate,Mike Workman,DEM,700102,1,25,62,88,
Texas,U.S. Senate,Mark Beard,IND,700102,0,1,2,3,
Texas,U.S. Senate,Sean Braddy,IND,700102,0,0,7,7,
Texas,U.S. House,Frank Lucas,REP,700102,4,49,187,240,03
Texas,U.S. House,Frankie Robbins,DEM,700102,1,22,78,101,03
Texas,State House,Casey Murdock,REP,700102,4,40,167,211,61
Texas,State House,Ashlee Renee Ortiz,DEM,700102,1,31,103,135,61
Texas,President,Donald Trump,REP,700104,20,8,311,339,
Texas,President,Gary Johnson,LIB,700104,2,0,10,12,
Texas,President,Hillary Clinton,DEM,700104,3,3,35,41,
Texas,U.S. Senate,James Lankford,REP,700104,19,7,292,318,
Texas,U.S. Senate,Robert Murphy,LIB,700104,3,2,9,14,
Texas,U.S. Senate,Mike Workman,DEM,700104,1,2,33,36,
Texas,U.S. Senate,Mark Beard,IND,700104,0,0,10,10,
Texas,U.S. Senate,Sean Braddy,IND,700104,0,0,9,9,
Texas,U.S. House,Frank Lucas,REP,700104,21,8,313,342,03
Texas,U.S. House,Frankie Robbins,DEM,700104,3,3,41,47,03
Texas,State House,Casey Murdock,REP,700104,22,8,312,342,61
Texas,State House,Ashlee Renee Ortiz,DEM,700104,1,3,43,47,61
Texas,President,Donald Trump,REP,700107,7,7,144,158,
Texas,President,Gary Johnson,LIB,700107,0,0,6,6,
Texas,President,Hillary Clinton,DEM,700107,4,2,8,14,
Texas,U.S. Senate,James Lankford,REP,700107,8,7,144,159,
Texas,U.S. Senate,Robert Murphy,LIB,700107,0,0,3,3,
Texas,U.S. Senate,Mike Workman,DEM,700107,2,2,8,12,
Texas,U.S. Senate,Mark Beard,IND,700107,0,0,3,3,
Texas,U.S. Senate,Sean Braddy,IND,700107,1,0,1,2,
Texas,U.S. House,Frank Lucas,REP,700107,7,6,146,159,03
Texas,U.S. House,Frankie Robbins,DEM,700107,4,2,12,18,03
Texas,State House,Casey Murdock,REP,700107,9,7,143,159,61
Texas,State House,Ashlee Renee Ortiz,DEM,700107,2,2,14,18,61
Texas,President,Donald Trump,REP,700201,44,129,556,729,
Texas,President,Gary Johnson,LIB,700201,5,5,41,51,
Texas,President,Hillary Clinton,DEM,700201,8,28,118,154,
Texas,U.S. Senate,James Lankford,REP,700201,45,125,545,715,
Texas,U.S. Senate,Robert Murphy,LIB,700201,3,4,29,36,
Texas,U.S. Senate,Mike Workman,DEM,700201,7,25,111,143,
Texas,U.S. Senate,Mark Beard,IND,700201,0,3,14,17,
Texas,U.S. Senate,Sean Braddy,IND,700201,0,4,17,21,
Texas,U.S. House,Frank Lucas,REP,700201,45,136,591,772,03
Texas,U.S. House,Frankie Robbins,DEM,700201,10,25,125,160,03
Texas,State House,Casey Murdock,REP,700201,46,128,548,722,61
Texas,State House,Ashlee Renee Ortiz,DEM,700201,10,33,164,207,61
Texas,President,Donald Trump,REP,700202,8,59,230,297,
Texas,President,Gary Johnson,LIB,700202,0,4,21,25,
Texas,President,Hillary Clinton,DEM,700202,7,15,76,98,
Texas,U.S. Senate,James Lankford,REP,700202,9,60,239,308,
Texas,U.S. Senate,Robert Murphy,LIB,700202,0,0,14,14,
Texas,U.S. Senate,Mike Workman,DEM,700202,6,14,60,80,
Texas,U.S. Senate,Mark Beard,IND,700202,0,1,5,6,
Texas,U.S. Senate,Sean Braddy,IND,700202,0,2,5,7,
Texas,U.S. House,Frank Lucas,REP,700202,10,60,249,319,03
Texas,U.S. House,Frankie Robbins,DEM,700202,5,16,71,92,03
Texas,State House,Casey Murdock,REP,700202,9,59,239,307,61
Texas,State House,Ashlee Renee Ortiz,DEM,700202,6,18,84,108,61
Texas,President,Donald Trump,REP,700205,18,178,452,648,
Texas,President,Gary Johnson,LIB,700205,4,4,26,34,
Texas,President,Hillary Clinton,DEM,700205,12,15,53,80,
Texas,U.S. Senate,James Lankford,REP,700205,23,182,451,656,
Texas,U.S. Senate,Robert Murphy,LIB,700205,0,1,14,15,
Texas,U.S. Senate,Mike Workman,DEM,700205,11,13,47,71,
Texas,U.S. Senate,Mark Beard,IND,700205,0,0,6,6,
Texas,U.S. Senate,Sean Braddy,IND,700205,1,1,15,17,
Texas,U.S. House,Frank Lucas,REP,700205,25,179,465,669,03
Texas,U.S. House,Frankie Robbins,DEM,700205,10,16,68,94,03
Texas,State House,Casey Murdock,REP,700205,20,172,445,637,61
Texas,State House,Ashlee Renee Ortiz,DEM,700205,13,25,91,129,61
Texas,President,Donald Trump,REP,700302,5,23,115,143,
Texas,President,Gary Johnson,LIB,700302,2,0,9,11,
Texas,President,Hillary Clinton,DEM,700302,0,3,9,12,
Texas,U.S. Senate,James Lankford,REP,700302,3,19,114,136,
Texas,U.S. Senate,Robert Murphy,LIB,700302,2,1,6,9,
Texas,U.S. Senate,Mike Workman,DEM,700302,2,5,10,17,
Texas,U.S. Senate,Mark Beard,IND,700302,0,0,2,2,
Texas,U.S. Senate,Sean Braddy,IND,700302,0,0,1,1,
Texas,U.S. House,Frank Lucas,REP,700302,5,22,124,151,03
Texas,U.S. House,Frankie Robbins,DEM,700302,2,4,10,16,03
Texas,State House,Casey Murdock,REP,700302,6,22,120,148,61
Texas,State House,Ashlee Renee Ortiz,DEM,700302,1,4,13,18,61
Texas,President,Donald Trump,REP,700303,11,22,299,332,
Texas,President,Gary Johnson,LIB,700303,2,3,16,21,
Texas,President,Hillary Clinton,DEM,700303,1,0,38,39,
Texas,U.S. Senate,James Lankford,REP,700303,12,22,285,319,
Texas,U.S. Senate,Robert Murphy,LIB,700303,1,3,14,18,
Texas,U.S. Senate,Mike Workman,DEM,700303,1,0,34,35,
Texas,U.S. Senate,Mark Beard,IND,700303,0,0,4,4,
Texas,U.S. Senate,Sean Braddy,IND,700303,0,0,9,9,
Texas,U.S. House,Frank Lucas,REP,700303,11,23,308,342,03
Texas,U.S. House,Frankie Robbins,DEM,700303,3,2,41,46,03
Texas,State House,Casey Murdock,REP,700303,13,24,305,342,61
Texas,State House,Ashlee Renee Ortiz,DEM,700303,1,1,45,47,61
Texas,President,Donald Trump,REP,700304,18,30,280,328,
Texas,President,Gary Johnson,LIB,700304,2,3,23,28,
Texas,President,Hillary Clinton,DEM,700304,4,3,46,53,
Texas,U.S. Senate,James Lankford,REP,700304,18,28,271,317,
Texas,U.S. Senate,Robert Murphy,LIB,700304,0,2,19,21,
Texas,U.S. Senate,Mike Workman,DEM,700304,6,5,40,51,
Texas,U.S. Senate,Mark Beard,IND,700304,0,0,8,8,
Texas,U.S. Senate,Sean Braddy,IND,700304,0,0,13,13,
Texas,U.S. House,Frank Lucas,REP,700304,21,29,291,341,03
Texas,U.S. House,Frankie Robbins,DEM,700304,3,5,60,68,03
Texas,State House,Casey Murdock,REP,700304,20,27,287,334,61
Texas,State House,Ashlee Renee Ortiz,DEM,700304,3,8,64,75,61
Texas,President,Donald Trump,REP,700305,24,187,557,768,
Texas,President,Gary Johnson,LIB,700305,4,11,43,58,
Texas,President,Hillary Clinton,DEM,700305,1,51,121,173,
Texas,U.S. Senate,James Lankford,REP,700305,25,182,545,752,
Texas,U.S. Senate,Robert Murphy,LIB,700305,1,11,39,51,
Texas,U.S. Senate,Mike Workman,DEM,700305,2,45,106,153,
Texas,U.S. Senate,Mark Beard,IND,700305,1,2,18,21,
Texas,U.S. Senate,Sean Braddy,IND,700305,1,6,16,23,
Texas,U.S. House,Frank Lucas,REP,700305,27,191,588,806,03
Texas,U.S. House,Frankie Robbins,DEM,700305,3,55,131,189,03
Texas,State House,Casey Murdock,REP,700305,28,181,535,744,61
Texas,State House,Ashlee Renee Ortiz,DEM,700305,2,65,185,252,61
Tillman,President,Donald Trump,REP,710001,12,123,310,445,
Tillman,President,Gary Johnson,LIB,710001,1,6,18,25,
Tillman,President,Hillary Clinton,DEM,710001,11,29,78,118,
Tillman,U.S. Senate,James Lankford,REP,710001,13,136,317,466,
Tillman,U.S. Senate,Robert Murphy,LIB,710001,0,1,7,8,
Tillman,U.S. Senate,Mike Workman,DEM,710001,9,14,68,91,
Tillman,U.S. Senate,Mark Beard,IND,710001,1,1,6,8,
Tillman,U.S. Senate,Sean Braddy,IND,710001,1,3,6,10,
Tillman,U.S. House,Tom Cole,REP,710001,19,141,334,494,04
Tillman,U.S. House,Sevier White,LIB,710001,0,2,7,9,04
Tillman,U.S. House,Christina Owen,DEM,710001,5,14,66,85,04
Tillman,State Senate,Chris Kidd,REP,710001,15,132,293,440,31
Tillman,State Senate,Perry Brinegar,DEM,710001,9,23,110,142,31
Tillman,State House,Jeff Coody,REP,710001,14,114,268,396,63
Tillman,State House,Randy Batt,DEM,710001,10,43,136,189,63
Tillman,President,Donald Trump,REP,710002,2,62,187,251,
Tillman,President,Gary Johnson,LIB,710002,1,3,17,21,
Tillman,President,Hillary Clinton,DEM,710002,2,13,84,99,
Tillman,U.S. Senate,James Lankford,REP,710002,2,55,185,242,
Tillman,U.S. Senate,Robert Murphy,LIB,710002,0,2,7,9,
Tillman,U.S. Senate,Mike Workman,DEM,710002,2,17,74,93,
Tillman,U.S. Senate,Mark Beard,IND,710002,1,1,9,11,
Tillman,U.S. Senate,Sean Braddy,IND,710002,0,1,10,11,
Tillman,U.S. House,Tom Cole,REP,710002,2,62,203,267,04
Tillman,U.S. House,Sevier White,LIB,710002,0,2,10,12,04
Tillman,U.S. House,Christina Owen,DEM,710002,3,12,72,87,04
Tillman,State Senate,Chris Kidd,REP,710002,2,60,192,254,31
Tillman,State Senate,Perry Brinegar,DEM,710002,3,16,93,112,31
Tillman,State House,Jeff Coody,REP,710002,2,61,174,237,63
Tillman,State House,Randy Batt,DEM,710002,3,15,111,129,63
Tillman,President,Donald Trump,REP,710003,4,23,69,96,
Tillman,President,Gary Johnson,LIB,710003,1,2,3,6,
Tillman,President,Hillary Clinton,DEM,710003,2,14,40,56,
Tillman,U.S. Senate,James Lankford,REP,710003,5,25,63,93,
Tillman,U.S. Senate,Robert Murphy,LIB,710003,0,0,4,4,
Tillman,U.S. Senate,Mike Workman,DEM,710003,1,11,37,49,
Tillman,U.S. Senate,Mark Beard,IND,710003,0,0,1,1,
Tillman,U.S. Senate,Sean Braddy,IND,710003,0,1,2,3,
Tillman,U.S. House,Tom Cole,REP,710003,5,24,74,103,04
Tillman,U.S. House,Sevier White,LIB,710003,0,0,2,2,04
Tillman,U.S. House,Christina Owen,DEM,710003,1,13,32,46,04
Tillman,State Senate,Chris Kidd,REP,710003,4,23,65,92,31
Tillman,State Senate,Perry Brinegar,DEM,710003,2,14,43,59,31
Tillman,State House,Jeff Coody,REP,710003,5,20,64,89,63
Tillman,State House,Randy Batt,DEM,710003,2,17,46,65,63
Tillman,President,Donald Trump,REP,710004,2,35,110,147,
Tillman,President,Gary Johnson,LIB,710004,0,4,8,12,
Tillman,President,Hillary Clinton,DEM,710004,6,14,72,92,
Tillman,U.S. Senate,James Lankford,REP,710004,2,37,113,152,
Tillman,U.S. Senate,Robert Murphy,LIB,710004,0,1,5,6,
Tillman,U.S. Senate,Mike Workman,DEM,710004,6,11,63,80,
Tillman,U.S. Senate,Mark Beard,IND,710004,0,1,3,4,
Tillman,U.S. Senate,Sean Braddy,IND,710004,0,2,3,5,
Tillman,U.S. House,Tom Cole,REP,710004,2,38,120,160,04
Tillman,U.S. House,Sevier White,LIB,710004,0,2,2,4,04
Tillman,U.S. House,Christina Owen,DEM,710004,6,11,66,83,04
Tillman,State Senate,Chris Kidd,REP,710004,2,35,114,151,31
Tillman,State Senate,Perry Brinegar,DEM,710004,6,17,75,98,31
Tillman,State House,Jeff Coody,REP,710004,2,34,107,143,63
Tillman,State House,Randy Batt,DEM,710004,6,17,82,105,63
Tillman,President,Donald Trump,REP,710006,9,16,102,127,
Tillman,President,Gary Johnson,LIB,710006,1,0,2,3,
Tillman,President,Hillary Clinton,DEM,710006,1,2,17,20,
Tillman,U.S. Senate,James Lankford,REP,710006,9,18,106,133,
Tillman,U.S. Senate,Robert Murphy,LIB,710006,0,0,0,0,
Tillman,U.S. Senate,Mike Workman,DEM,710006,2,1,16,19,
Tillman,U.S. Senate,Mark Beard,IND,710006,0,0,2,2,
Tillman,U.S. Senate,Sean Braddy,IND,710006,0,0,0,0,
Tillman,U.S. House,Tom Cole,REP,710006,9,18,109,136,04
Tillman,U.S. House,Sevier White,LIB,710006,0,0,0,0,04
Tillman,U.S. House,Christina Owen,DEM,710006,2,1,15,18,04
Tillman,State Senate,Chris Kidd,REP,710006,9,15,86,110,31
Tillman,State Senate,Perry Brinegar,DEM,710006,2,4,37,43,31
Tillman,State House,Jeff Coody,REP,710006,7,10,89,106,63
Tillman,State House,Randy Batt,DEM,710006,4,8,35,47,63
Tillman,President,Donald Trump,REP,710007,8,5,302,315,
Tillman,President,Gary Johnson,LIB,710007,0,0,12,12,
Tillman,President,Hillary Clinton,DEM,710007,0,3,91,94,
Tillman,U.S. Senate,James Lankford,REP,710007,7,5,275,287,
Tillman,U.S. Senate,Robert Murphy,LIB,710007,1,0,7,8,
Tillman,U.S. Senate,Mike Workman,DEM,710007,0,3,82,85,
Tillman,U.S. Senate,Mark Beard,IND,710007,0,0,13,13,
Tillman,U.S. Senate,Sean Braddy,IND,710007,0,0,15,15,
Tillman,U.S. House,Tom Cole,REP,710007,8,6,312,326,04
Tillman,U.S. House,Sevier White,LIB,710007,0,0,9,9,04
Tillman,U.S. House,Christina Owen,DEM,710007,0,2,77,79,04
Tillman,State Senate,Chris Kidd,REP,710007,7,6,278,291,31
Tillman,State Senate,Perry Brinegar,DEM,710007,1,2,113,116,31
Tillman,State House,Jeff Coody,REP,710007,8,6,326,340,63
Tillman,State House,Randy Batt,DEM,710007,0,2,72,74,63
Tillman,President,Donald Trump,REP,710009,6,28,108,142,
Tillman,President,Gary Johnson,LIB,710009,0,1,6,7,
Tillman,President,Hillary Clinton,DEM,710009,0,11,35,46,
Tillman,U.S. Senate,James Lankford,REP,710009,5,31,101,137,
Tillman,U.S. Senate,Robert Murphy,LIB,710009,0,2,2,4,
Tillman,U.S. Senate,Mike Workman,DEM,710009,0,5,38,43,
Tillman,U.S. Senate,Mark Beard,IND,710009,0,0,4,4,
Tillman,U.S. Senate,Sean Braddy,IND,710009,0,1,3,4,
Tillman,U.S. House,Tom Cole,REP,710009,5,32,108,145,04
Tillman,U.S. House,Sevier White,LIB,710009,0,1,4,5,04
Tillman,U.S. House,Christina Owen,DEM,710009,0,6,37,43,04
Tillman,State Senate,Chris Kidd,REP,710009,4,29,100,133,31
Tillman,State Senate,Perry Brinegar,DEM,710009,0,9,49,58,31
Tillman,State House,Jeff Coody,REP,710009,4,27,101,132,63
Tillman,State House,Randy Batt,DEM,710009,2,12,46,60,63
Tillman,President,Donald Trump,REP,710010,12,25,271,308,
Tillman,President,Gary Johnson,LIB,710010,0,1,14,15,
Tillman,President,Hillary Clinton,DEM,710010,3,6,99,108,
Tillman,U.S. Senate,James Lankford,REP,710010,14,24,278,316,
Tillman,U.S. Senate,Robert Murphy,LIB,710010,0,1,5,6,
Tillman,U.S. Senate,Mike Workman,DEM,710010,3,7,89,99,
Tillman,U.S. Senate,Mark Beard,IND,710010,0,0,4,4,
Tillman,U.S. Senate,Sean Braddy,IND,710010,0,0,6,6,
Tillman,U.S. House,Tom Cole,REP,710010,14,26,291,331,04
Tillman,U.S. House,Sevier White,LIB,710010,0,1,6,7,04
Tillman,U.S. House,Christina Owen,DEM,710010,3,5,87,95,04
Tillman,State Senate,Chris Kidd,REP,710010,14,23,267,304,31
Tillman,State Senate,Perry Brinegar,DEM,710010,3,8,111,122,31
Tillman,State House,Jeff Coody,REP,710010,12,23,270,305,63
Tillman,State House,Randy Batt,DEM,710010,5,9,116,130,63
Tillman,President,Donald Trump,REP,710012,0,15,98,113,
Tillman,President,Gary Johnson,LIB,710012,0,2,2,4,
Tillman,President,Hillary Clinton,DEM,710012,2,4,18,24,
Tillman,U.S. Senate,James Lankford,REP,710012,0,19,96,115,
Tillman,U.S. Senate,Robert Murphy,LIB,710012,0,0,2,2,
Tillman,U.S. Senate,Mike Workman,DEM,710012,2,1,15,18,
Tillman,U.S. Senate,Mark Beard,IND,710012,0,0,1,1,
Tillman,U.S. Senate,Sean Braddy,IND,710012,0,0,2,2,
Tillman,U.S. House,Tom Cole,REP,710012,0,18,98,116,04
Tillman,U.S. House,Sevier White,LIB,710012,0,1,3,4,04
Tillman,U.S. House,Christina Owen,DEM,710012,2,1,16,19,04
Tillman,State Senate,Chris Kidd,REP,710012,0,14,88,102,31
Tillman,State Senate,Perry Brinegar,DEM,710012,2,4,28,34,31
Tillman,State House,Jeff Coody,REP,710012,0,14,91,105,63
Tillman,State House,Randy Batt,DEM,710012,2,5,25,32,63
Tulsa,President,Donald Trump,REP,720001,0,0,32,32,
Tulsa,President,Gary Johnson,LIB,720001,0,0,22,22,
Tulsa,President,Hillary Clinton,DEM,720001,0,0,769,769,
Tulsa,U.S. Senate,James Lankford,REP,720001,0,0,65,65,
Tulsa,U.S. Senate,Robert Murphy,LIB,720001,0,0,17,17,
Tulsa,U.S. Senate,Mike Workman,DEM,720001,0,0,676,676,
Tulsa,U.S. Senate,Mark Beard,IND,720001,0,0,23,23,
Tulsa,U.S. Senate,Sean Braddy,IND,720001,0,0,30,30,
Tulsa,State House,Leland Cole,REP,720001,0,0,40,40,73
Tulsa,State House,Regina Goodwin,DEM,720001,0,0,780,780,73
Tulsa,President,Donald Trump,REP,720002,0,0,94,94,
Tulsa,President,Gary Johnson,LIB,720002,0,0,26,26,
Tulsa,President,Hillary Clinton,DEM,720002,0,0,683,683,
Tulsa,U.S. Senate,James Lankford,REP,720002,0,0,126,126,
Tulsa,U.S. Senate,Robert Murphy,LIB,720002,0,0,26,26,
Tulsa,U.S. Senate,Mike Workman,DEM,720002,0,0,594,594,
Tulsa,U.S. Senate,Mark Beard,IND,720002,0,0,21,21,
Tulsa,U.S. Senate,Sean Braddy,IND,720002,0,0,31,31,
Tulsa,President,Donald Trump,REP,720003,0,0,180,180,
Tulsa,President,Gary Johnson,LIB,720003,0,0,15,15,
Tulsa,President,Hillary Clinton,DEM,720003,0,0,156,156,
Tulsa,U.S. Senate,James Lankford,REP,720003,0,0,175,175,
Tulsa,U.S. Senate,Robert Murphy,LIB,720003,0,0,8,8,
Tulsa,U.S. Senate,Mike Workman,DEM,720003,0,0,143,143,
Tulsa,U.S. Senate,Mark Beard,IND,720003,0,0,6,6,
Tulsa,U.S. Senate,Sean Braddy,IND,720003,0,0,15,15,
Tulsa,President,Donald Trump,REP,720004,0,0,61,61,
Tulsa,President,Gary Johnson,LIB,720004,0,0,20,20,
Tulsa,President,Hillary Clinton,DEM,720004,0,0,787,787,
Tulsa,U.S. Senate,James Lankford,REP,720004,0,0,103,103,
Tulsa,U.S. Senate,Robert Murphy,LIB,720004,0,0,15,15,
Tulsa,U.S. Senate,Mike Workman,DEM,720004,0,0,698,698,
Tulsa,U.S. Senate,Mark Beard,IND,720004,0,0,24,24,
Tulsa,U.S. Senate,Sean Braddy,IND,720004,0,0,24,24,
Tulsa,State House,Leland Cole,REP,720004,0,0,63,63,73
Tulsa,State House,Regina Goodwin,DEM,720004,0,0,809,809,73
Tulsa,President,Donald Trump,REP,720005,0,0,48,48,
Tulsa,President,Gary Johnson,LIB,720005,0,0,12,12,
Tulsa,President,Hillary Clinton,DEM,720005,0,0,398,398,
Tulsa,U.S. Senate,James Lankford,REP,720005,0,0,58,58,
Tulsa,U.S. Senate,Robert Murphy,LIB,720005,0,0,10,10,
Tulsa,U.S. Senate,Mike Workman,DEM,720005,0,0,362,362,
Tulsa,U.S. Senate,Mark Beard,IND,720005,0,0,8,8,
Tulsa,U.S. Senate,Sean Braddy,IND,720005,0,0,16,16,
Tulsa,President,Donald Trump,REP,720006,0,0,40,40,
Tulsa,President,Gary Johnson,LIB,720006,0,0,32,32,
Tulsa,President,Hillary Clinton,DEM,720006,0,0,839,839,
Tulsa,U.S. Senate,James Lankford,REP,720006,0,0,89,89,
Tulsa,U.S. Senate,Robert Murphy,LIB,720006,0,0,20,20,
Tulsa,U.S. Senate,Mike Workman,DEM,720006,0,0,757,757,
Tulsa,U.S. Senate,Mark Beard,IND,720006,0,0,28,28,
Tulsa,U.S. Senate,Sean Braddy,IND,720006,0,0,18,18,
Tulsa,State House,Leland Cole,REP,720006,0,0,48,48,73
Tulsa,State House,Regina Goodwin,DEM,720006,0,0,867,867,73
Tulsa,President,Donald Trump,REP,720007,0,0,25,25,
Tulsa,President,Gary Johnson,LIB,720007,0,0,16,16,
Tulsa,President,Hillary Clinton,DEM,720007,0,0,378,378,
Tulsa,U.S. Senate,James Lankford,REP,720007,0,0,50,50,
Tulsa,U.S. Senate,Robert Murphy,LIB,720007,0,0,8,8,
Tulsa,U.S. Senate,Mike Workman,DEM,720007,0,0,343,343,
Tulsa,U.S. Senate,Mark Beard,IND,720007,0,0,4,4,
Tulsa,U.S. Senate,Sean Braddy,IND,720007,0,0,14,14,
Tulsa,State House,Leland Cole,REP,720007,0,0,22,22,73
Tulsa,State House,Regina Goodwin,DEM,720007,0,0,399,399,73
Tulsa,President,Donald Trump,REP,720008,0,0,79,79,
Tulsa,President,Gary Johnson,LIB,720008,0,0,18,18,
Tulsa,President,Hillary Clinton,DEM,720008,0,0,424,424,
Tulsa,U.S. Senate,James Lankford,REP,720008,0,0,89,89,
Tulsa,U.S. Senate,Robert Murphy,LIB,720008,0,0,9,9,
Tulsa,U.S. Senate,Mike Workman,DEM,720008,0,0,397,397,
Tulsa,U.S. Senate,Mark Beard,IND,720008,0,0,12,12,
Tulsa,U.S. Senate,Sean Braddy,IND,720008,0,0,13,13,
Tulsa,President,Donald Trump,REP,720009,0,0,28,28,
Tulsa,President,Gary Johnson,LIB,720009,0,0,4,4,
Tulsa,President,Hillary Clinton,DEM,720009,0,0,175,175,
Tulsa,U.S. Senate,James Lankford,REP,720009,0,0,40,40,
Tulsa,U.S. Senate,Robert Murphy,LIB,720009,0,0,4,4,
Tulsa,U.S. Senate,Mike Workman,DEM,720009,0,0,149,149,
Tulsa,U.S. Senate,Mark Beard,IND,720009,0,0,5,5,
Tulsa,U.S. Senate,Sean Braddy,IND,720009,0,0,9,9,
Tulsa,President,Donald Trump,REP,720010,0,0,49,49,
Tulsa,President,Gary Johnson,LIB,720010,0,0,16,16,
Tulsa,President,Hillary Clinton,DEM,720010,0,0,515,515,
Tulsa,U.S. Senate,James Lankford,REP,720010,0,0,85,85,
Tulsa,U.S. Senate,Robert Murphy,LIB,720010,0,0,10,10,
Tulsa,U.S. Senate,Mike Workman,DEM,720010,0,0,448,448,
Tulsa,U.S. Senate,Mark Beard,IND,720010,0,0,12,12,
Tulsa,U.S. Senate,Sean Braddy,IND,720010,0,0,21,21,
Tulsa,State House,Leland Cole,REP,720010,0,0,40,40,73
Tulsa,State House,Regina Goodwin,DEM,720010,0,0,536,536,73
Tulsa,President,Donald Trump,REP,720011,0,0,194,194,
Tulsa,President,Gary Johnson,LIB,720011,0,0,31,31,
Tulsa,President,Hillary Clinton,DEM,720011,0,0,325,325,
Tulsa,U.S. Senate,James Lankford,REP,720011,0,0,192,192,
Tulsa,U.S. Senate,Robert Murphy,LIB,720011,0,0,18,18,
Tulsa,U.S. Senate,Mike Workman,DEM,720011,0,0,283,283,
Tulsa,U.S. Senate,Mark Beard,IND,720011,0,0,15,15,
Tulsa,U.S. Senate,Sean Braddy,IND,720011,0,0,33,33,
Tulsa,President,Donald Trump,REP,720012,0,0,133,133,
Tulsa,President,Gary Johnson,LIB,720012,0,0,30,30,
Tulsa,President,Hillary Clinton,DEM,720012,0,0,280,280,
Tulsa,U.S. Senate,James Lankford,REP,720012,0,0,159,159,
Tulsa,U.S. Senate,Robert Murphy,LIB,720012,0,0,10,10,
Tulsa,U.S. Senate,Mike Workman,DEM,720012,0,0,249,249,
Tulsa,U.S. Senate,Mark Beard,IND,720012,0,0,10,10,
Tulsa,U.S. Senate,Sean Braddy,IND,720012,0,0,15,15,
Tulsa,President,Donald Trump,REP,720013,0,0,34,34,
Tulsa,President,Gary Johnson,LIB,720013,0,0,28,28,
Tulsa,President,Hillary Clinton,DEM,720013,0,0,852,852,
Tulsa,U.S. Senate,James Lankford,REP,720013,0,0,88,88,
Tulsa,U.S. Senate,Robert Murphy,LIB,720013,0,0,18,18,
Tulsa,U.S. Senate,Mike Workman,DEM,720013,0,0,750,750,
Tulsa,U.S. Senate,Mark Beard,IND,720013,0,0,25,25,
Tulsa,U.S. Senate,Sean Braddy,IND,720013,0,0,33,33,
Tulsa,State House,Leland Cole,REP,720013,0,0,44,44,73
Tulsa,State House,Regina Goodwin,DEM,720013,0,0,868,868,73
Tulsa,President,Donald Trump,REP,720014,0,0,64,64,
Tulsa,President,Gary Johnson,LIB,720014,0,0,40,40,
Tulsa,President,Hillary Clinton,DEM,720014,0,0,575,575,
Tulsa,U.S. Senate,James Lankford,REP,720014,0,0,102,102,
Tulsa,U.S. Senate,Robert Murphy,LIB,720014,0,0,21,21,
Tulsa,U.S. Senate,Mike Workman,DEM,720014,0,0,491,491,
Tulsa,U.S. Senate,Mark Beard,IND,720014,0,0,23,23,
Tulsa,U.S. Senate,Sean Braddy,IND,720014,0,0,41,41,
Tulsa,State House,Leland Cole,REP,720014,0,0,70,70,73
Tulsa,State House,Regina Goodwin,DEM,720014,0,0,610,610,73
Tulsa,President,Donald Trump,REP,720015,0,0,67,67,
Tulsa,President,Gary Johnson,LIB,720015,0,0,21,21,
Tulsa,President,Hillary Clinton,DEM,720015,0,0,352,352,
Tulsa,U.S. Senate,James Lankford,REP,720015,0,0,77,77,
Tulsa,U.S. Senate,Robert Murphy,LIB,720015,0,0,15,15,
Tulsa,U.S. Senate,Mike Workman,DEM,720015,0,0,316,316,
Tulsa,U.S. Senate,Mark Beard,IND,720015,0,0,15,15,
Tulsa,U.S. Senate,Sean Braddy,IND,720015,0,0,14,14,
Tulsa,State House,Leland Cole,REP,720015,0,0,67,67,73
Tulsa,State House,Regina Goodwin,DEM,720015,0,0,367,367,73
Tulsa,President,Donald Trump,REP,720016,0,0,83,83,
Tulsa,President,Gary Johnson,LIB,720016,0,0,14,14,
Tulsa,President,Hillary Clinton,DEM,720016,0,0,103,103,
Tulsa,U.S. Senate,James Lankford,REP,720016,0,0,85,85,
Tulsa,U.S. Senate,Robert Murphy,LIB,720016,0,0,5,5,
Tulsa,U.S. Senate,Mike Workman,DEM,720016,0,0,86,86,
Tulsa,U.S. Senate,Mark Beard,IND,720016,0,0,8,8,
Tulsa,U.S. Senate,Sean Braddy,IND,720016,0,0,12,12,
Tulsa,State House,Leland Cole,REP,720016,0,0,71,71,73
Tulsa,State House,Regina Goodwin,DEM,720016,0,0,122,122,73
Tulsa,President,Donald Trump,REP,720017,0,0,132,132,
Tulsa,President,Gary Johnson,LIB,720017,0,0,16,16,
Tulsa,President,Hillary Clinton,DEM,720017,0,0,200,200,
Tulsa,U.S. Senate,James Lankford,REP,720017,0,0,132,132,
Tulsa,U.S. Senate,Robert Murphy,LIB,720017,0,0,14,14,
Tulsa,U.S. Senate,Mike Workman,DEM,720017,0,0,177,177,
Tulsa,U.S. Senate,Mark Beard,IND,720017,0,0,14,14,
Tulsa,U.S. Senate,Sean Braddy,IND,720017,0,0,14,14,
Tulsa,President,Donald Trump,REP,720018,0,0,192,192,
Tulsa,President,Gary Johnson,LIB,720018,0,0,43,43,
Tulsa,President,Hillary Clinton,DEM,720018,0,0,190,190,
Tulsa,U.S. Senate,James Lankford,REP,720018,0,0,202,202,
Tulsa,U.S. Senate,Robert Murphy,LIB,720018,0,0,18,18,
Tulsa,U.S. Senate,Mike Workman,DEM,720018,0,0,165,165,
Tulsa,U.S. Senate,Mark Beard,IND,720018,0,0,20,20,
Tulsa,U.S. Senate,Sean Braddy,IND,720018,0,0,15,15,
Tulsa,President,Donald Trump,REP,720019,0,0,258,258,
Tulsa,President,Gary Johnson,LIB,720019,0,0,32,32,
Tulsa,President,Hillary Clinton,DEM,720019,0,0,219,219,
Tulsa,U.S. Senate,James Lankford,REP,720019,0,0,260,260,
Tulsa,U.S. Senate,Robert Murphy,LIB,720019,0,0,22,22,
Tulsa,U.S. Senate,Mike Workman,DEM,720019,0,0,188,188,
Tulsa,U.S. Senate,Mark Beard,IND,720019,0,0,20,20,
Tulsa,U.S. Senate,Sean Braddy,IND,720019,0,0,14,14,
Tulsa,President,Donald Trump,REP,720020,0,0,201,201,
Tulsa,President,Gary Johnson,LIB,720020,0,0,31,31,
Tulsa,President,Hillary Clinton,DEM,720020,0,0,208,208,
Tulsa,U.S. Senate,James Lankford,REP,720020,0,0,194,194,
Tulsa,U.S. Senate,Robert Murphy,LIB,720020,0,0,13,13,
Tulsa,U.S. Senate,Mike Workman,DEM,720020,0,0,185,185,
Tulsa,U.S. Senate,Mark Beard,IND,720020,0,0,18,18,
Tulsa,U.S. Senate,Sean Braddy,IND,720020,0,0,22,22,
Tulsa,President,Donald Trump,REP,720021,0,0,41,41,
Tulsa,President,Gary Johnson,LIB,720021,0,0,1,1,
Tulsa,President,Hillary Clinton,DEM,720021,0,0,8,8,
Tulsa,U.S. Senate,James Lankford,REP,720021,0,0,40,40,
Tulsa,U.S. Senate,Robert Murphy,LIB,720021,0,0,1,1,
Tulsa,U.S. Senate,Mike Workman,DEM,720021,0,0,8,8,
Tulsa,U.S. Senate,Mark Beard,IND,720021,0,0,0,0,
Tulsa,U.S. Senate,Sean Braddy,IND,720021,0,0,0,0,
Tulsa,President,Donald Trump,REP,720022,0,0,297,297,
Tulsa,President,Gary Johnson,LIB,720022,0,0,25,25,
Tulsa,President,Hillary Clinton,DEM,720022,0,0,217,217,
Tulsa,U.S. Senate,James Lankford,REP,720022,0,0,323,323,
Tulsa,U.S. Senate,Robert Murphy,LIB,720022,0,0,15,15,
Tulsa,U.S. Senate,Mike Workman,DEM,720022,0,0,170,170,
Tulsa,U.S. Senate,Mark Beard,IND,720022,0,0,17,17,
Tulsa,U.S. Senate,Sean Braddy,IND,720022,0,0,16,16,
Tulsa,President,Donald Trump,REP,720023,0,0,194,194,
Tulsa,President,Gary Johnson,LIB,720023,0,0,15,15,
Tulsa,President,Hillary Clinton,DEM,720023,0,0,86,86,
Tulsa,U.S. Senate,James Lankford,REP,720023,0,0,193,193,
Tulsa,U.S. Senate,Robert Murphy,LIB,720023,0,0,9,9,
Tulsa,U.S. Senate,Mike Workman,DEM,720023,0,0,74,74,
Tulsa,U.S. Senate,Mark Beard,IND,720023,0,0,6,6,
Tulsa,U.S. Senate,Sean Braddy,IND,720023,0,0,10,10,
Tulsa,President,Donald Trump,REP,720024,0,0,277,277,
Tulsa,President,Gary Johnson,LIB,720024,0,0,23,23,
Tulsa,President,Hillary Clinton,DEM,720024,0,0,194,194,
Tulsa,U.S. Senate,James Lankford,REP,720024,0,0,281,281,
Tulsa,U.S. Senate,Robert Murphy,LIB,720024,0,0,16,16,
Tulsa,U.S. Senate,Mike Workman,DEM,720024,0,0,160,160,
Tulsa,U.S. Senate,Mark Beard,IND,720024,0,0,15,15,
Tulsa,U.S. Senate,Sean Braddy,IND,720024,0,0,14,14,
Tulsa,President,Donald Trump,REP,720025,0,0,187,187,
Tulsa,President,Gary Johnson,LIB,720025,0,0,25,25,
Tulsa,President,Hillary Clinton,DEM,720025,0,0,149,149,
Tulsa,U.S. Senate,James Lankford,REP,720025,0,0,183,183,
Tulsa,U.S. Senate,Robert Murphy,LIB,720025,0,0,8,8,
Tulsa,U.S. Senate,Mike Workman,DEM,720025,0,0,134,134,
Tulsa,U.S. Senate,Mark Beard,IND,720025,0,0,15,15,
Tulsa,U.S. Senate,Sean Braddy,IND,720025,0,0,10,10,
Tulsa,President,Donald Trump,REP,720026,0,0,210,210,
Tulsa,President,Gary Johnson,LIB,720026,0,0,34,34,
Tulsa,President,Hillary Clinton,DEM,720026,0,0,237,237,
Tulsa,U.S. Senate,James Lankford,REP,720026,0,0,221,221,
Tulsa,U.S. Senate,Robert Murphy,LIB,720026,0,0,18,18,
Tulsa,U.S. Senate,Mike Workman,DEM,720026,0,0,194,194,
Tulsa,U.S. Senate,Mark Beard,IND,720026,0,0,22,22,
Tulsa,U.S. Senate,Sean Braddy,IND,720026,0,0,24,24,
Tulsa,President,Donald Trump,REP,720027,0,0,216,216,
Tulsa,President,Gary Johnson,LIB,720027,0,0,37,37,
Tulsa,President,Hillary Clinton,DEM,720027,0,0,177,177,
Tulsa,U.S. Senate,James Lankford,REP,720027,0,0,224,224,
Tulsa,U.S. Senate,Robert Murphy,LIB,720027,0,0,21,21,
Tulsa,U.S. Senate,Mike Workman,DEM,720027,0,0,146,146,
Tulsa,U.S. Senate,Mark Beard,IND,720027,0,0,10,10,
Tulsa,U.S. Senate,Sean Braddy,IND,720027,0,0,26,26,
Tulsa,President,Donald Trump,REP,720028,0,0,259,259,
Tulsa,President,Gary Johnson,LIB,720028,0,0,34,34,
Tulsa,President,Hillary Clinton,DEM,720028,0,0,237,237,
Tulsa,U.S. Senate,James Lankford,REP,720028,0,0,262,262,
Tulsa,U.S. Senate,Robert Murphy,LIB,720028,0,0,24,24,
Tulsa,U.S. Senate,Mike Workman,DEM,720028,0,0,198,198,
Tulsa,U.S. Senate,Mark Beard,IND,720028,0,0,18,18,
Tulsa,U.S. Senate,Sean Braddy,IND,720028,0,0,24,24,
Tulsa,President,Donald Trump,REP,720029,0,0,249,249,
Tulsa,President,Gary Johnson,LIB,720029,0,0,23,23,
Tulsa,President,Hillary Clinton,DEM,720029,0,0,178,178,
Tulsa,U.S. Senate,James Lankford,REP,720029,0,0,255,255,
Tulsa,U.S. Senate,Robert Murphy,LIB,720029,0,0,11,11,
Tulsa,U.S. Senate,Mike Workman,DEM,720029,0,0,151,151,
Tulsa,U.S. Senate,Mark Beard,IND,720029,0,0,15,15,
Tulsa,U.S. Senate,Sean Braddy,IND,720029,0,0,16,16,
Tulsa,President,Donald Trump,REP,720030,0,0,212,212,
Tulsa,President,Gary Johnson,LIB,720030,0,0,43,43,
Tulsa,President,Hillary Clinton,DEM,720030,0,0,380,380,
Tulsa,U.S. Senate,James Lankford,REP,720030,0,0,252,252,
Tulsa,U.S. Senate,Robert Murphy,LIB,720030,0,0,39,39,
Tulsa,U.S. Senate,Mike Workman,DEM,720030,0,0,298,298,
Tulsa,U.S. Senate,Mark Beard,IND,720030,0,0,13,13,
Tulsa,U.S. Senate,Sean Braddy,IND,720030,0,0,32,32,
Tulsa,State House,Leland Cole,REP,720030,0,0,231,231,73
Tulsa,State House,Regina Goodwin,DEM,720030,0,0,393,393,73
Tulsa,President,Donald Trump,REP,720031,0,0,101,101,
Tulsa,President,Gary Johnson,LIB,720031,0,0,28,28,
Tulsa,President,Hillary Clinton,DEM,720031,0,0,182,182,
Tulsa,U.S. Senate,James Lankford,REP,720031,0,0,120,120,
Tulsa,U.S. Senate,Robert Murphy,LIB,720031,0,0,14,14,
Tulsa,U.S. Senate,Mike Workman,DEM,720031,0,0,153,153,
Tulsa,U.S. Senate,Mark Beard,IND,720031,0,0,11,11,
Tulsa,U.S. Senate,Sean Braddy,IND,720031,0,0,15,15,
Tulsa,State House,Leland Cole,REP,720031,0,0,98,98,73
Tulsa,State House,Regina Goodwin,DEM,720031,0,0,211,211,73
Tulsa,President,Donald Trump,REP,720032,0,0,143,143,
Tulsa,President,Gary Johnson,LIB,720032,0,0,43,43,
Tulsa,President,Hillary Clinton,DEM,720032,0,0,256,256,
Tulsa,U.S. Senate,James Lankford,REP,720032,0,0,164,164,
Tulsa,U.S. Senate,Robert Murphy,LIB,720032,0,0,20,20,
Tulsa,U.S. Senate,Mike Workman,DEM,720032,0,0,216,216,
Tulsa,U.S. Senate,Mark Beard,IND,720032,0,0,13,13,
Tulsa,U.S. Senate,Sean Braddy,IND,720032,0,0,26,26,
Tulsa,President,Donald Trump,REP,720033,0,0,134,134,
Tulsa,President,Gary Johnson,LIB,720033,0,0,43,43,
Tulsa,President,Hillary Clinton,DEM,720033,0,0,239,239,
Tulsa,U.S. Senate,James Lankford,REP,720033,0,0,155,155,
Tulsa,U.S. Senate,Robert Murphy,LIB,720033,0,0,33,33,
Tulsa,U.S. Senate,Mike Workman,DEM,720033,0,0,199,199,
Tulsa,U.S. Senate,Mark Beard,IND,720033,0,0,17,17,
Tulsa,U.S. Senate,Sean Braddy,IND,720033,0,0,12,12,
Tulsa,State Senate,Gary Stanislawski,REP,720033,0,0,165,165,35
Tulsa,State Senate,Frank Grove,LIB,720033,0,0,203,203,35
Tulsa,President,Donald Trump,REP,720034,0,0,131,131,
Tulsa,President,Gary Johnson,LIB,720034,0,0,26,26,
Tulsa,President,Hillary Clinton,DEM,720034,0,0,147,147,
Tulsa,U.S. Senate,James Lankford,REP,720034,0,0,146,146,
Tulsa,U.S. Senate,Robert Murphy,LIB,720034,0,0,15,15,
Tulsa,U.S. Senate,Mike Workman,DEM,720034,0,0,122,122,
Tulsa,U.S. Senate,Mark Beard,IND,720034,0,0,6,6,
Tulsa,U.S. Senate,Sean Braddy,IND,720034,0,0,13,13,
Tulsa,State Senate,Gary Stanislawski,REP,720034,0,0,143,143,35
Tulsa,State Senate,Frank Grove,LIB,720034,0,0,115,115,35
Tulsa,President,Donald Trump,REP,720035,0,0,429,429,
Tulsa,President,Gary Johnson,LIB,720035,0,0,117,117,
Tulsa,President,Hillary Clinton,DEM,720035,0,0,497,497,
Tulsa,U.S. Senate,James Lankford,REP,720035,0,0,483,483,
Tulsa,U.S. Senate,Robert Murphy,LIB,720035,0,0,65,65,
Tulsa,U.S. Senate,Mike Workman,DEM,720035,0,0,416,416,
Tulsa,U.S. Senate,Mark Beard,IND,720035,0,0,25,25,
Tulsa,U.S. Senate,Sean Braddy,IND,720035,0,0,61,61,
Tulsa,State Senate,Dave Rader,REP,720035,0,0,443,443,39
Tulsa,State Senate,John Waldron,DEM,720035,0,0,609,609,39
Tulsa,President,Donald Trump,REP,720036,0,0,413,413,
Tulsa,President,Gary Johnson,LIB,720036,0,0,59,59,
Tulsa,President,Hillary Clinton,DEM,720036,0,0,466,466,
Tulsa,U.S. Senate,James Lankford,REP,720036,0,0,459,459,
Tulsa,U.S. Senate,Robert Murphy,LIB,720036,0,0,46,46,
Tulsa,U.S. Senate,Mike Workman,DEM,720036,0,0,385,385,
Tulsa,U.S. Senate,Mark Beard,IND,720036,0,0,18,18,
Tulsa,U.S. Senate,Sean Braddy,IND,720036,0,0,35,35,
Tulsa,State Senate,Dave Rader,REP,720036,0,0,385,385,39
Tulsa,State Senate,John Waldron,DEM,720036,0,0,559,559,39
Tulsa,President,Donald Trump,REP,720037,0,0,76,76,
Tulsa,President,Gary Johnson,LIB,720037,0,0,19,19,
Tulsa,President,Hillary Clinton,DEM,720037,0,0,141,141,
Tulsa,U.S. Senate,James Lankford,REP,720037,0,0,72,72,
Tulsa,U.S. Senate,Robert Murphy,LIB,720037,0,0,11,11,
Tulsa,U.S. Senate,Mike Workman,DEM,720037,0,0,117,117,
Tulsa,U.S. Senate,Mark Beard,IND,720037,0,0,12,12,
Tulsa,U.S. Senate,Sean Braddy,IND,720037,0,0,19,19,
Tulsa,State Senate,Gary Stanislawski,REP,720037,0,0,74,74,35
Tulsa,State Senate,Frank Grove,LIB,720037,0,0,128,128,35
Tulsa,President,Donald Trump,REP,720038,0,0,276,276,
Tulsa,President,Gary Johnson,LIB,720038,0,0,36,36,
Tulsa,President,Hillary Clinton,DEM,720038,0,0,149,149,
Tulsa,U.S. Senate,James Lankford,REP,720038,0,0,282,282,
Tulsa,U.S. Senate,Robert Murphy,LIB,720038,0,0,16,16,
Tulsa,U.S. Senate,Mike Workman,DEM,720038,0,0,138,138,
Tulsa,U.S. Senate,Mark Beard,IND,720038,0,0,16,16,
Tulsa,U.S. Senate,Sean Braddy,IND,720038,0,0,9,9,
Tulsa,State Senate,Dave Rader,REP,720038,0,0,231,231,39
Tulsa,State Senate,John Waldron,DEM,720038,0,0,227,227,39
Tulsa,President,Donald Trump,REP,720039,0,0,377,377,
Tulsa,President,Gary Johnson,LIB,720039,0,0,50,50,
Tulsa,President,Hillary Clinton,DEM,720039,0,0,262,262,
Tulsa,U.S. Senate,James Lankford,REP,720039,0,0,395,395,
Tulsa,U.S. Senate,Robert Murphy,LIB,720039,0,0,28,28,
Tulsa,U.S. Senate,Mike Workman,DEM,720039,0,0,217,217,
Tulsa,U.S. Senate,Mark Beard,IND,720039,0,0,20,20,
Tulsa,U.S. Senate,Sean Braddy,IND,720039,0,0,26,26,
Tulsa,State Senate,Dave Rader,REP,720039,0,0,341,341,39
Tulsa,State Senate,John Waldron,DEM,720039,0,0,345,345,39
Tulsa,President,Donald Trump,REP,720040,0,0,97,97,
Tulsa,President,Gary Johnson,LIB,720040,0,0,19,19,
Tulsa,President,Hillary Clinton,DEM,720040,0,0,108,108,
Tulsa,U.S. Senate,James Lankford,REP,720040,0,0,107,107,
Tulsa,U.S. Senate,Robert Murphy,LIB,720040,0,0,7,7,
Tulsa,U.S. Senate,Mike Workman,DEM,720040,0,0,88,88,
Tulsa,U.S. Senate,Mark Beard,IND,720040,0,0,4,4,
Tulsa,U.S. Senate,Sean Braddy,IND,720040,0,0,11,11,
Tulsa,President,Donald Trump,REP,720041,0,0,198,198,
Tulsa,President,Gary Johnson,LIB,720041,0,0,16,16,
Tulsa,President,Hillary Clinton,DEM,720041,0,0,152,152,
Tulsa,U.S. Senate,James Lankford,REP,720041,0,0,196,196,
Tulsa,U.S. Senate,Robert Murphy,LIB,720041,0,0,11,11,
Tulsa,U.S. Senate,Mike Workman,DEM,720041,0,0,138,138,
Tulsa,U.S. Senate,Mark Beard,IND,720041,0,0,7,7,
Tulsa,U.S. Senate,Sean Braddy,IND,720041,0,0,12,12,
Tulsa,President,Donald Trump,REP,720042,0,0,310,310,
Tulsa,President,Gary Johnson,LIB,720042,0,0,32,32,
Tulsa,President,Hillary Clinton,DEM,720042,0,0,104,104,
Tulsa,U.S. Senate,James Lankford,REP,720042,0,0,322,322,
Tulsa,U.S. Senate,Robert Murphy,LIB,720042,0,0,22,22,
Tulsa,U.S. Senate,Mike Workman,DEM,720042,0,0,78,78,
Tulsa,U.S. Senate,Mark Beard,IND,720042,0,0,14,14,
Tulsa,U.S. Senate,Sean Braddy,IND,720042,0,0,8,8,
Tulsa,State House,Terry O'Donnell,REP,720042,0,0,329,329,23
Tulsa,State House,Keith Welch Sr.,DEM,720042,0,0,113,113,23
Tulsa,President,Donald Trump,REP,720043,0,0,343,343,
Tulsa,President,Gary Johnson,LIB,720043,0,0,33,33,
Tulsa,President,Hillary Clinton,DEM,720043,0,0,139,139,
Tulsa,U.S. Senate,James Lankford,REP,720043,0,0,350,350,
Tulsa,U.S. Senate,Robert Murphy,LIB,720043,0,0,26,26,
Tulsa,U.S. Senate,Mike Workman,DEM,720043,0,0,115,115,
Tulsa,U.S. Senate,Mark Beard,IND,720043,0,0,11,11,
Tulsa,U.S. Senate,Sean Braddy,IND,720043,0,0,10,10,
Tulsa,President,Donald Trump,REP,720044,0,0,456,456,
Tulsa,President,Gary Johnson,LIB,720044,0,0,42,42,
Tulsa,President,Hillary Clinton,DEM,720044,0,0,285,285,
Tulsa,U.S. Senate,James Lankford,REP,720044,0,0,452,452,
Tulsa,U.S. Senate,Robert Murphy,LIB,720044,0,0,29,29,
Tulsa,U.S. Senate,Mike Workman,DEM,720044,0,0,260,260,
Tulsa,U.S. Senate,Mark Beard,IND,720044,0,0,19,19,
Tulsa,U.S. Senate,Sean Braddy,IND,720044,0,0,14,14,
Tulsa,State House,Terry O'Donnell,REP,720044,0,0,473,473,23
Tulsa,State House,Keith Welch Sr.,DEM,720044,0,0,293,293,23
Tulsa,President,Donald Trump,REP,720045,0,0,3,3,
Tulsa,President,Gary Johnson,LIB,720045,0,0,0,0,
Tulsa,President,Hillary Clinton,DEM,720045,0,0,0,0,
Tulsa,U.S. Senate,James Lankford,REP,720045,0,0,3,3,
Tulsa,U.S. Senate,Robert Murphy,LIB,720045,0,0,0,0,
Tulsa,U.S. Senate,Mike Workman,DEM,720045,0,0,0,0,
Tulsa,U.S. Senate,Mark Beard,IND,720045,0,0,0,0,
Tulsa,U.S. Senate,Sean Braddy,IND,720045,0,0,0,0,
Tulsa,State House,Terry O'Donnell,REP,720045,0,0,3,3,23
Tulsa,State House,Keith Welch Sr.,DEM,720045,0,0,0,0,23
Tulsa,President,Donald Trump,REP,720046,0,0,363,363,
Tulsa,President,Gary Johnson,LIB,720046,0,0,112,112,
Tulsa,President,Hillary Clinton,DEM,720046,0,0,729,729,
Tulsa,U.S. Senate,James Lankford,REP,720046,0,0,442,442,
Tulsa,U.S. Senate,Robert Murphy,LIB,720046,0,0,59,59,
Tulsa,U.S. Senate,Mike Workman,DEM,720046,0,0,602,602,
Tulsa,U.S. Senate,Mark Beard,IND,720046,0,0,39,39,
Tulsa,U.S. Senate,Sean Braddy,IND,720046,0,0,49,49,
Tulsa,State Senate,Gary Stanislawski,REP,720046,0,0,497,497,35
Tulsa,State Senate,Frank Grove,LIB,720046,0,0,527,527,35
Tulsa,State House,Jadine Nollan,REP,720046,0,0,449,449,66
Tulsa,State House,Dianna Phillips,DEM,720046,0,0,728,728,66
Tulsa,President,Donald Trump,REP,720047,0,0,37,37,
Tulsa,President,Gary Johnson,LIB,720047,0,0,17,17,
Tulsa,President,Hillary Clinton,DEM,720047,0,0,112,112,
Tulsa,U.S. Senate,James Lankford,REP,720047,0,0,44,44,
Tulsa,U.S. Senate,Robert Murphy,LIB,720047,0,0,11,11,
Tulsa,U.S. Senate,Mike Workman,DEM,720047,0,0,94,94,
Tulsa,U.S. Senate,Mark Beard,IND,720047,0,0,2,2,
Tulsa,U.S. Senate,Sean Braddy,IND,720047,0,0,11,11,
Tulsa,State House,Molly Mckay,REP,720047,0,0,38,38,78
Tulsa,State House,Eugene Bell,LIB,720047,0,0,18,18,78
Tulsa,State House,Meloyde Blancett,DEM,720047,0,0,104,104,78
Tulsa,President,Donald Trump,REP,720048,0,0,286,286,
Tulsa,President,Gary Johnson,LIB,720048,0,0,90,90,
Tulsa,President,Hillary Clinton,DEM,720048,0,0,507,507,
Tulsa,U.S. Senate,James Lankford,REP,720048,0,0,368,368,
Tulsa,U.S. Senate,Robert Murphy,LIB,720048,0,0,49,49,
Tulsa,U.S. Senate,Mike Workman,DEM,720048,0,0,412,412,
Tulsa,U.S. Senate,Mark Beard,IND,720048,0,0,14,14,
Tulsa,U.S. Senate,Sean Braddy,IND,720048,0,0,37,37,
Tulsa,State Senate,Gary Stanislawski,REP,720048,0,0,405,405,35
Tulsa,State Senate,Frank Grove,LIB,720048,0,0,337,337,35
Tulsa,State House,Molly Mckay,REP,720048,0,0,288,288,78
Tulsa,State House,Eugene Bell,LIB,720048,0,0,71,71,78
Tulsa,State House,Meloyde Blancett,DEM,720048,0,0,519,519,78
Tulsa,President,Donald Trump,REP,720049,0,0,113,113,
Tulsa,President,Gary Johnson,LIB,720049,0,0,40,40,
Tulsa,President,Hillary Clinton,DEM,720049,0,0,268,268,
Tulsa,U.S. Senate,James Lankford,REP,720049,0,0,123,123,
Tulsa,U.S. Senate,Robert Murphy,LIB,720049,0,0,30,30,
Tulsa,U.S. Senate,Mike Workman,DEM,720049,0,0,229,229,
Tulsa,U.S. Senate,Mark Beard,IND,720049,0,0,17,17,
Tulsa,U.S. Senate,Sean Braddy,IND,720049,0,0,22,22,
Tulsa,President,Donald Trump,REP,720050,0,0,163,163,
Tulsa,President,Gary Johnson,LIB,720050,0,0,41,41,
Tulsa,President,Hillary Clinton,DEM,720050,0,0,323,323,
Tulsa,U.S. Senate,James Lankford,REP,720050,0,0,200,200,
Tulsa,U.S. Senate,Robert Murphy,LIB,720050,0,0,37,37,
Tulsa,U.S. Senate,Mike Workman,DEM,720050,0,0,266,266,
Tulsa,U.S. Senate,Mark Beard,IND,720050,0,0,11,11,
Tulsa,U.S. Senate,Sean Braddy,IND,720050,0,0,15,15,
Tulsa,State Senate,Gary Stanislawski,REP,720050,0,0,214,214,35
Tulsa,State Senate,Frank Grove,LIB,720050,0,0,237,237,35
Tulsa,State House,Molly Mckay,REP,720050,0,0,183,183,78
Tulsa,State House,Eugene Bell,LIB,720050,0,0,32,32,78
Tulsa,State House,Meloyde Blancett,DEM,720050,0,0,312,312,78
Tulsa,President,Donald Trump,REP,720051,0,0,278,278,
Tulsa,President,Gary Johnson,LIB,720051,0,0,65,65,
Tulsa,President,Hillary Clinton,DEM,720051,0,0,387,387,
Tulsa,U.S. Senate,James Lankford,REP,720051,0,0,301,301,
Tulsa,U.S. Senate,Robert Murphy,LIB,720051,0,0,43,43,
Tulsa,U.S. Senate,Mike Workman,DEM,720051,0,0,329,329,
Tulsa,U.S. Senate,Mark Beard,IND,720051,0,0,18,18,
Tulsa,U.S. Senate,Sean Braddy,IND,720051,0,0,34,34,
Tulsa,State Senate,Gary Stanislawski,REP,720051,0,0,314,314,35
Tulsa,State Senate,Frank Grove,LIB,720051,0,0,315,315,35
Tulsa,State House,Molly Mckay,REP,720051,0,0,260,260,78
Tulsa,State House,Eugene Bell,LIB,720051,0,0,63,63,78
Tulsa,State House,Meloyde Blancett,DEM,720051,0,0,399,399,78
Tulsa,President,Donald Trump,REP,720052,0,0,493,493,
Tulsa,President,Gary Johnson,LIB,720052,0,0,104,104,
Tulsa,President,Hillary Clinton,DEM,720052,0,0,655,655,
Tulsa,U.S. Senate,James Lankford,REP,720052,0,0,600,600,
Tulsa,U.S. Senate,Robert Murphy,LIB,720052,0,0,66,66,
Tulsa,U.S. Senate,Mike Workman,DEM,720052,0,0,530,530,
Tulsa,U.S. Senate,Mark Beard,IND,720052,0,0,23,23,
Tulsa,U.S. Senate,Sean Braddy,IND,720052,0,0,30,30,
Tulsa,State Senate,Gary Stanislawski,REP,720052,0,0,640,640,35
Tulsa,State Senate,Frank Grove,LIB,720052,0,0,465,465,35
Tulsa,State House,Molly Mckay,REP,720052,0,0,520,520,78
Tulsa,State House,Eugene Bell,LIB,720052,0,0,76,76,78
Tulsa,State House,Meloyde Blancett,DEM,720052,0,0,645,645,78
Tulsa,President,Donald Trump,REP,720053,0,0,550,550,
Tulsa,President,Gary Johnson,LIB,720053,0,0,63,63,
Tulsa,President,Hillary Clinton,DEM,720053,0,0,476,476,
Tulsa,U.S. Senate,James Lankford,REP,720053,0,0,573,573,
Tulsa,U.S. Senate,Robert Murphy,LIB,720053,0,0,36,36,
Tulsa,U.S. Senate,Mike Workman,DEM,720053,0,0,412,412,
Tulsa,U.S. Senate,Mark Beard,IND,720053,0,0,33,33,
Tulsa,U.S. Senate,Sean Braddy,IND,720053,0,0,34,34,
Tulsa,State House,Terry O'Donnell,REP,720053,0,0,608,608,23
Tulsa,State House,Keith Welch Sr.,DEM,720053,0,0,466,466,23
Tulsa,President,Donald Trump,REP,720054,0,0,540,540,
Tulsa,President,Gary Johnson,LIB,720054,0,0,88,88,
Tulsa,President,Hillary Clinton,DEM,720054,0,0,666,666,
Tulsa,U.S. Senate,James Lankford,REP,720054,0,0,592,592,
Tulsa,U.S. Senate,Robert Murphy,LIB,720054,0,0,60,60,
Tulsa,U.S. Senate,Mike Workman,DEM,720054,0,0,544,544,
Tulsa,U.S. Senate,Mark Beard,IND,720054,0,0,33,33,
Tulsa,U.S. Senate,Sean Braddy,IND,720054,0,0,52,52,
Tulsa,State Senate,Dave Rader,REP,720054,0,0,551,551,39
Tulsa,State Senate,John Waldron,DEM,720054,0,0,749,749,39
Tulsa,State House,Molly Mckay,REP,720054,0,0,523,523,78
Tulsa,State House,Eugene Bell,LIB,720054,0,0,75,75,78
Tulsa,State House,Meloyde Blancett,DEM,720054,0,0,684,684,78
Tulsa,President,Donald Trump,REP,720055,0,0,330,330,
Tulsa,President,Gary Johnson,LIB,720055,0,0,55,55,
Tulsa,President,Hillary Clinton,DEM,720055,0,0,306,306,
Tulsa,U.S. Senate,James Lankford,REP,720055,0,0,358,358,
Tulsa,U.S. Senate,Robert Murphy,LIB,720055,0,0,23,23,
Tulsa,U.S. Senate,Mike Workman,DEM,720055,0,0,267,267,
Tulsa,U.S. Senate,Mark Beard,IND,720055,0,0,12,12,
Tulsa,U.S. Senate,Sean Braddy,IND,720055,0,0,25,25,
Tulsa,State Senate,Dave Rader,REP,720055,0,0,322,322,39
Tulsa,State Senate,John Waldron,DEM,720055,0,0,364,364,39
Tulsa,State House,Molly Mckay,REP,720055,0,0,318,318,78
Tulsa,State House,Eugene Bell,LIB,720055,0,0,50,50,78
Tulsa,State House,Meloyde Blancett,DEM,720055,0,0,316,316,78
Tulsa,President,Donald Trump,REP,720056,0,0,380,380,
Tulsa,President,Gary Johnson,LIB,720056,0,0,54,54,
Tulsa,President,Hillary Clinton,DEM,720056,0,0,371,371,
Tulsa,U.S. Senate,James Lankford,REP,720056,0,0,401,401,
Tulsa,U.S. Senate,Robert Murphy,LIB,720056,0,0,34,34,
Tulsa,U.S. Senate,Mike Workman,DEM,720056,0,0,318,318,
Tulsa,U.S. Senate,Mark Beard,IND,720056,0,0,17,17,
Tulsa,U.S. Senate,Sean Braddy,IND,720056,0,0,27,27,
Tulsa,State Senate,Dave Rader,REP,720056,0,0,375,375,39
Tulsa,State Senate,John Waldron,DEM,720056,0,0,415,415,39
Tulsa,State House,Molly Mckay,REP,720056,0,0,376,376,78
Tulsa,State House,Eugene Bell,LIB,720056,0,0,54,54,78
Tulsa,State House,Meloyde Blancett,DEM,720056,0,0,351,351,78
Tulsa,President,Donald Trump,REP,720057,0,0,209,209,
Tulsa,President,Gary Johnson,LIB,720057,0,0,22,22,
Tulsa,President,Hillary Clinton,DEM,720057,0,0,110,110,
Tulsa,U.S. Senate,James Lankford,REP,720057,0,0,219,219,
Tulsa,U.S. Senate,Robert Murphy,LIB,720057,0,0,13,13,
Tulsa,U.S. Senate,Mike Workman,DEM,720057,0,0,84,84,
Tulsa,U.S. Senate,Mark Beard,IND,720057,0,0,9,9,
Tulsa,U.S. Senate,Sean Braddy,IND,720057,0,0,17,17,
Tulsa,State Senate,Dave Rader,REP,720057,0,0,186,186,39
Tulsa,State Senate,John Waldron,DEM,720057,0,0,153,153,39
Tulsa,State House,Molly Mckay,REP,720057,0,0,189,189,78
Tulsa,State House,Eugene Bell,LIB,720057,0,0,22,22,78
Tulsa,State House,Meloyde Blancett,DEM,720057,0,0,126,126,78
Tulsa,President,Donald Trump,REP,720058,0,0,263,263,
Tulsa,President,Gary Johnson,LIB,720058,0,0,14,14,
Tulsa,President,Hillary Clinton,DEM,720058,0,0,142,142,
Tulsa,U.S. Senate,James Lankford,REP,720058,0,0,262,262,
Tulsa,U.S. Senate,Robert Murphy,LIB,720058,0,0,12,12,
Tulsa,U.S. Senate,Mike Workman,DEM,720058,0,0,125,125,
Tulsa,U.S. Senate,Mark Beard,IND,720058,0,0,11,11,
Tulsa,U.S. Senate,Sean Braddy,IND,720058,0,0,10,10,
Tulsa,State House,Molly Mckay,REP,720058,0,0,242,242,78
Tulsa,State House,Eugene Bell,LIB,720058,0,0,22,22,78
Tulsa,State House,Meloyde Blancett,DEM,720058,0,0,158,158,78
Tulsa,President,Donald Trump,REP,720059,0,0,239,239,
Tulsa,President,Gary Johnson,LIB,720059,0,0,27,27,
Tulsa,President,Hillary Clinton,DEM,720059,0,0,211,211,
Tulsa,U.S. Senate,James Lankford,REP,720059,0,0,268,268,
Tulsa,U.S. Senate,Robert Murphy,LIB,720059,0,0,12,12,
Tulsa,U.S. Senate,Mike Workman,DEM,720059,0,0,168,168,
Tulsa,U.S. Senate,Mark Beard,IND,720059,0,0,14,14,
Tulsa,U.S. Senate,Sean Braddy,IND,720059,0,0,16,16,
Tulsa,State House,Molly Mckay,REP,720059,0,0,238,238,78
Tulsa,State House,Eugene Bell,LIB,720059,0,0,23,23,78
Tulsa,State House,Meloyde Blancett,DEM,720059,0,0,219,219,78
Tulsa,President,Donald Trump,REP,720060,0,0,332,332,
Tulsa,President,Gary Johnson,LIB,720060,0,0,33,33,
Tulsa,President,Hillary Clinton,DEM,720060,0,0,316,316,
Tulsa,U.S. Senate,James Lankford,REP,720060,0,0,331,331,
Tulsa,U.S. Senate,Robert Murphy,LIB,720060,0,0,21,21,
Tulsa,U.S. Senate,Mike Workman,DEM,720060,0,0,277,277,
Tulsa,U.S. Senate,Mark Beard,IND,720060,0,0,23,23,
Tulsa,U.S. Senate,Sean Braddy,IND,720060,0,0,24,24,
Tulsa,State House,Terry O'Donnell,REP,720060,0,0,346,346,23
Tulsa,State House,Keith Welch Sr.,DEM,720060,0,0,325,325,23
Tulsa,President,Donald Trump,REP,720061,0,0,409,409,
Tulsa,President,Gary Johnson,LIB,720061,0,0,50,50,
Tulsa,President,Hillary Clinton,DEM,720061,0,0,421,421,
Tulsa,U.S. Senate,James Lankford,REP,720061,0,0,431,431,
Tulsa,U.S. Senate,Robert Murphy,LIB,720061,0,0,39,39,
Tulsa,U.S. Senate,Mike Workman,DEM,720061,0,0,354,354,
Tulsa,U.S. Senate,Mark Beard,IND,720061,0,0,23,23,
Tulsa,U.S. Senate,Sean Braddy,IND,720061,0,0,30,30,
Tulsa,State House,Terry O'Donnell,REP,720061,0,0,445,445,23
Tulsa,State House,Keith Welch Sr.,DEM,720061,0,0,418,418,23
Tulsa,President,Donald Trump,REP,720062,0,0,595,595,
Tulsa,President,Gary Johnson,LIB,720062,0,0,104,104,
Tulsa,President,Hillary Clinton,DEM,720062,0,0,714,714,
Tulsa,U.S. Senate,James Lankford,REP,720062,0,0,749,749,
Tulsa,U.S. Senate,Robert Murphy,LIB,720062,0,0,56,56,
Tulsa,U.S. Senate,Mike Workman,DEM,720062,0,0,553,553,
Tulsa,U.S. Senate,Mark Beard,IND,720062,0,0,21,21,
Tulsa,U.S. Senate,Sean Braddy,IND,720062,0,0,25,25,
Tulsa,State Senate,Gary Stanislawski,REP,720062,0,0,774,774,35
Tulsa,State Senate,Frank Grove,LIB,720062,0,0,452,452,35
Tulsa,State House,Katie Henke,REP,720062,0,0,823,823,71
Tulsa,State House,Millie Hardesty York,DEM,720062,0,0,587,587,71
Tulsa,President,Donald Trump,REP,720063,0,0,215,215,
Tulsa,President,Gary Johnson,LIB,720063,0,0,52,52,
Tulsa,President,Hillary Clinton,DEM,720063,0,0,286,286,
Tulsa,U.S. Senate,James Lankford,REP,720063,0,0,247,247,
Tulsa,U.S. Senate,Robert Murphy,LIB,720063,0,0,34,34,
Tulsa,U.S. Senate,Mike Workman,DEM,720063,0,0,232,232,
Tulsa,U.S. Senate,Mark Beard,IND,720063,0,0,18,18,
Tulsa,U.S. Senate,Sean Braddy,IND,720063,0,0,17,17,
Tulsa,State Senate,Gary Stanislawski,REP,720063,0,0,276,276,35
Tulsa,State Senate,Frank Grove,LIB,720063,0,0,217,217,35
Tulsa,State House,Katie Henke,REP,720063,0,0,272,272,71
Tulsa,State House,Millie Hardesty York,DEM,720063,0,0,279,279,71
Tulsa,President,Donald Trump,REP,720064,0,0,361,361,
Tulsa,President,Gary Johnson,LIB,720064,0,0,87,87,
Tulsa,President,Hillary Clinton,DEM,720064,0,0,439,439,
Tulsa,U.S. Senate,James Lankford,REP,720064,0,0,404,404,
Tulsa,U.S. Senate,Robert Murphy,LIB,720064,0,0,45,45,
Tulsa,U.S. Senate,Mike Workman,DEM,720064,0,0,358,358,
Tulsa,U.S. Senate,Mark Beard,IND,720064,0,0,31,31,
Tulsa,U.S. Senate,Sean Braddy,IND,720064,0,0,42,42,
Tulsa,State Senate,Gary Stanislawski,REP,720064,0,0,410,410,35
Tulsa,State Senate,Frank Grove,LIB,720064,0,0,368,368,35
Tulsa,State House,Katie Henke,REP,720064,0,0,449,449,71
Tulsa,State House,Millie Hardesty York,DEM,720064,0,0,426,426,71
Tulsa,President,Donald Trump,REP,720065,0,0,496,496,
Tulsa,President,Gary Johnson,LIB,720065,0,0,55,55,
Tulsa,President,Hillary Clinton,DEM,720065,0,0,393,393,
Tulsa,U.S. Senate,James Lankford,REP,720065,0,0,610,610,
Tulsa,U.S. Senate,Robert Murphy,LIB,720065,0,0,36,36,
Tulsa,U.S. Senate,Mike Workman,DEM,720065,0,0,269,269,
Tulsa,U.S. Senate,Mark Beard,IND,720065,0,0,11,11,
Tulsa,U.S. Senate,Sean Braddy,IND,720065,0,0,14,14,
Tulsa,State Senate,Dave Rader,REP,720065,0,0,499,499,39
Tulsa,State Senate,John Waldron,DEM,720065,0,0,454,454,39
Tulsa,State House,Katie Henke,REP,720065,0,0,675,675,71
Tulsa,State House,Millie Hardesty York,DEM,720065,0,0,263,263,71
Tulsa,President,Donald Trump,REP,720066,0,0,402,402,
Tulsa,President,Gary Johnson,LIB,720066,0,0,45,45,
Tulsa,President,Hillary Clinton,DEM,720066,0,0,413,413,
Tulsa,U.S. Senate,James Lankford,REP,720066,0,0,526,526,
Tulsa,U.S. Senate,Robert Murphy,LIB,720066,0,0,32,32,
Tulsa,U.S. Senate,Mike Workman,DEM,720066,0,0,274,274,
Tulsa,U.S. Senate,Mark Beard,IND,720066,0,0,12,12,
Tulsa,U.S. Senate,Sean Braddy,IND,720066,0,0,12,12,
Tulsa,State Senate,Gary Stanislawski,REP,720066,0,0,546,546,35
Tulsa,State Senate,Frank Grove,LIB,720066,0,0,220,220,35
Tulsa,State House,Katie Henke,REP,720066,0,0,591,591,71
Tulsa,State House,Millie Hardesty York,DEM,720066,0,0,262,262,71
Tulsa,President,Donald Trump,REP,720067,0,0,386,386,
Tulsa,President,Gary Johnson,LIB,720067,0,0,67,67,
Tulsa,President,Hillary Clinton,DEM,720067,0,0,422,422,
Tulsa,U.S. Senate,James Lankford,REP,720067,0,0,498,498,
Tulsa,U.S. Senate,Robert Murphy,LIB,720067,0,0,43,43,
Tulsa,U.S. Senate,Mike Workman,DEM,720067,0,0,300,300,
Tulsa,U.S. Senate,Mark Beard,IND,720067,0,0,12,12,
Tulsa,U.S. Senate,Sean Braddy,IND,720067,0,0,26,26,
Tulsa,State Senate,Gary Stanislawski,REP,720067,0,0,510,510,35
Tulsa,State Senate,Frank Grove,LIB,720067,0,0,283,283,35
Tulsa,State House,Katie Henke,REP,720067,0,0,545,545,71
Tulsa,State House,Millie Hardesty York,DEM,720067,0,0,330,330,71
Tulsa,President,Donald Trump,REP,720068,0,0,309,309,
Tulsa,President,Gary Johnson,LIB,720068,0,0,71,71,
Tulsa,President,Hillary Clinton,DEM,720068,0,0,380,380,
Tulsa,U.S. Senate,James Lankford,REP,720068,0,0,338,338,
Tulsa,U.S. Senate,Robert Murphy,LIB,720068,0,0,44,44,
Tulsa,U.S. Senate,Mike Workman,DEM,720068,0,0,308,308,
Tulsa,U.S. Senate,Mark Beard,IND,720068,0,0,25,25,
Tulsa,U.S. Senate,Sean Braddy,IND,720068,0,0,34,34,
Tulsa,State Senate,Gary Stanislawski,REP,720068,0,0,359,359,35
Tulsa,State Senate,Frank Grove,LIB,720068,0,0,304,304,35
Tulsa,State House,Katie Henke,REP,720068,0,0,374,374,71
Tulsa,State House,Millie Hardesty York,DEM,720068,0,0,367,367,71
Tulsa,President,Donald Trump,REP,720069,0,0,600,600,
Tulsa,President,Gary Johnson,LIB,720069,0,0,111,111,
Tulsa,President,Hillary Clinton,DEM,720069,0,0,578,578,
Tulsa,U.S. Senate,James Lankford,REP,720069,0,0,703,703,
Tulsa,U.S. Senate,Robert Murphy,LIB,720069,0,0,74,74,
Tulsa,U.S. Senate,Mike Workman,DEM,720069,0,0,446,446,
Tulsa,U.S. Senate,Mark Beard,IND,720069,0,0,23,23,
Tulsa,U.S. Senate,Sean Braddy,IND,720069,0,0,39,39,
Tulsa,State Senate,Gary Stanislawski,REP,720069,0,0,715,715,35
Tulsa,State Senate,Frank Grove,LIB,720069,0,0,433,433,35
Tulsa,State House,Katie Henke,REP,720069,0,0,741,741,71
Tulsa,State House,Millie Hardesty York,DEM,720069,0,0,533,533,71
Tulsa,President,Donald Trump,REP,720070,0,0,152,152,
Tulsa,President,Gary Johnson,LIB,720070,0,0,18,18,
Tulsa,President,Hillary Clinton,DEM,720070,0,0,114,114,
Tulsa,U.S. Senate,James Lankford,REP,720070,0,0,156,156,
Tulsa,U.S. Senate,Robert Murphy,LIB,720070,0,0,11,11,
Tulsa,U.S. Senate,Mike Workman,DEM,720070,0,0,98,98,
Tulsa,U.S. Senate,Mark Beard,IND,720070,0,0,6,6,
Tulsa,U.S. Senate,Sean Braddy,IND,720070,0,0,10,10,
Tulsa,State House,Molly Mckay,REP,720070,0,0,140,140,78
Tulsa,State House,Eugene Bell,LIB,720070,0,0,18,18,78
Tulsa,State House,Meloyde Blancett,DEM,720070,0,0,121,121,78
Tulsa,President,Donald Trump,REP,720071,0,0,805,805,
Tulsa,President,Gary Johnson,LIB,720071,0,0,112,112,
Tulsa,President,Hillary Clinton,DEM,720071,0,0,757,757,
Tulsa,U.S. Senate,James Lankford,REP,720071,0,0,1038,1038,
Tulsa,U.S. Senate,Robert Murphy,LIB,720071,0,0,46,46,
Tulsa,U.S. Senate,Mike Workman,DEM,720071,0,0,549,549,
Tulsa,U.S. Senate,Mark Beard,IND,720071,0,0,16,16,
Tulsa,U.S. Senate,Sean Braddy,IND,720071,0,0,32,32,
Tulsa,State Senate,Dave Rader,REP,720071,0,0,844,844,39
Tulsa,State Senate,John Waldron,DEM,720071,0,0,850,850,39
Tulsa,State House,Carol Bush,REP,720071,0,0,1102,1102,70
Tulsa,State House,Tamara Morton,LIB,720071,0,0,54,54,70
Tulsa,State House,Joe Jennings,DEM,720071,0,0,507,507,70
Tulsa,President,Donald Trump,REP,720072,0,0,329,329,
Tulsa,President,Gary Johnson,LIB,720072,0,0,30,30,
Tulsa,President,Hillary Clinton,DEM,720072,0,0,261,261,
Tulsa,U.S. Senate,James Lankford,REP,720072,0,0,387,387,
Tulsa,U.S. Senate,Robert Murphy,LIB,720072,0,0,17,17,
Tulsa,U.S. Senate,Mike Workman,DEM,720072,0,0,206,206,
Tulsa,U.S. Senate,Mark Beard,IND,720072,0,0,6,6,
Tulsa,U.S. Senate,Sean Braddy,IND,720072,0,0,8,8,
Tulsa,State Senate,Gary Stanislawski,REP,720072,0,0,404,404,35
Tulsa,State Senate,Frank Grove,LIB,720072,0,0,169,169,35
Tulsa,State House,Carol Bush,REP,720072,0,0,410,410,70
Tulsa,State House,Tamara Morton,LIB,720072,0,0,30,30,70
Tulsa,State House,Joe Jennings,DEM,720072,0,0,173,173,70
Tulsa,President,Donald Trump,REP,720073,0,0,387,387,
Tulsa,President,Gary Johnson,LIB,720073,0,0,35,35,
Tulsa,President,Hillary Clinton,DEM,720073,0,0,243,243,
Tulsa,U.S. Senate,James Lankford,REP,720073,0,0,468,468,
Tulsa,U.S. Senate,Robert Murphy,LIB,720073,0,0,17,17,
Tulsa,U.S. Senate,Mike Workman,DEM,720073,0,0,169,169,
Tulsa,U.S. Senate,Mark Beard,IND,720073,0,0,10,10,
Tulsa,U.S. Senate,Sean Braddy,IND,720073,0,0,13,13,
Tulsa,State Senate,Gary Stanislawski,REP,720073,0,0,479,479,35
Tulsa,State Senate,Frank Grove,LIB,720073,0,0,141,141,35
Tulsa,State House,Carol Bush,REP,720073,0,0,521,521,70
Tulsa,State House,Tamara Morton,LIB,720073,0,0,22,22,70
Tulsa,State House,Joe Jennings,DEM,720073,0,0,131,131,70
Tulsa,President,Donald Trump,REP,720074,0,0,539,539,
Tulsa,President,Gary Johnson,LIB,720074,0,0,64,64,
Tulsa,President,Hillary Clinton,DEM,720074,0,0,365,365,
Tulsa,U.S. Senate,James Lankford,REP,720074,0,0,634,634,
Tulsa,U.S. Senate,Robert Murphy,LIB,720074,0,0,29,29,
Tulsa,U.S. Senate,Mike Workman,DEM,720074,0,0,274,274,
Tulsa,U.S. Senate,Mark Beard,IND,720074,0,0,12,12,
Tulsa,U.S. Senate,Sean Braddy,IND,720074,0,0,16,16,
Tulsa,State Senate,Gary Stanislawski,REP,720074,0,0,664,664,35
Tulsa,State Senate,Frank Grove,LIB,720074,0,0,243,243,35
Tulsa,State House,Carol Bush,REP,720074,0,0,664,664,70
Tulsa,State House,Tamara Morton,LIB,720074,0,0,43,43,70
Tulsa,State House,Joe Jennings,DEM,720074,0,0,249,249,70
Tulsa,President,Donald Trump,REP,720075,0,0,240,240,
Tulsa,President,Gary Johnson,LIB,720075,0,0,45,45,
Tulsa,President,Hillary Clinton,DEM,720075,0,0,284,284,
Tulsa,U.S. Senate,James Lankford,REP,720075,0,0,261,261,
Tulsa,U.S. Senate,Robert Murphy,LIB,720075,0,0,21,21,
Tulsa,U.S. Senate,Mike Workman,DEM,720075,0,0,247,247,
Tulsa,U.S. Senate,Mark Beard,IND,720075,0,0,17,17,
Tulsa,U.S. Senate,Sean Braddy,IND,720075,0,0,18,18,
Tulsa,State Senate,Dave Rader,REP,720075,0,0,230,230,39
Tulsa,State Senate,John Waldron,DEM,720075,0,0,336,336,39
Tulsa,State House,Carol Bush,REP,720075,0,0,259,259,70
Tulsa,State House,Tamara Morton,LIB,720075,0,0,35,35,70
Tulsa,State House,Joe Jennings,DEM,720075,0,0,262,262,70
Tulsa,President,Donald Trump,REP,720076,0,0,382,382,
Tulsa,President,Gary Johnson,LIB,720076,0,0,82,82,
Tulsa,President,Hillary Clinton,DEM,720076,0,0,396,396,
Tulsa,U.S. Senate,James Lankford,REP,720076,0,0,424,424,
Tulsa,U.S. Senate,Robert Murphy,LIB,720076,0,0,51,51,
Tulsa,U.S. Senate,Mike Workman,DEM,720076,0,0,334,334,
Tulsa,U.S. Senate,Mark Beard,IND,720076,0,0,21,21,
Tulsa,U.S. Senate,Sean Braddy,IND,720076,0,0,26,26,
Tulsa,State Senate,Dave Rader,REP,720076,0,0,374,374,39
Tulsa,State Senate,John Waldron,DEM,720076,0,0,485,485,39
Tulsa,State House,Carol Bush,REP,720076,0,0,428,428,70
Tulsa,State House,Tamara Morton,LIB,720076,0,0,73,73,70
Tulsa,State House,Joe Jennings,DEM,720076,0,0,346,346,70
Tulsa,President,Donald Trump,REP,720077,0,0,426,426,
Tulsa,President,Gary Johnson,LIB,720077,0,0,70,70,
Tulsa,President,Hillary Clinton,DEM,720077,0,0,438,438,
Tulsa,U.S. Senate,James Lankford,REP,720077,0,0,467,467,
Tulsa,U.S. Senate,Robert Murphy,LIB,720077,0,0,40,40,
Tulsa,U.S. Senate,Mike Workman,DEM,720077,0,0,360,360,
Tulsa,U.S. Senate,Mark Beard,IND,720077,0,0,17,17,
Tulsa,U.S. Senate,Sean Braddy,IND,720077,0,0,34,34,
Tulsa,State Senate,Dave Rader,REP,720077,0,0,437,437,39
Tulsa,State Senate,John Waldron,DEM,720077,0,0,492,492,39
Tulsa,State House,Molly Mckay,REP,720077,0,0,426,426,78
Tulsa,State House,Eugene Bell,LIB,720077,0,0,48,48,78
Tulsa,State House,Meloyde Blancett,DEM,720077,0,0,439,439,78
Tulsa,President,Donald Trump,REP,720078,0,0,550,550,
Tulsa,President,Gary Johnson,LIB,720078,0,0,66,66,
Tulsa,President,Hillary Clinton,DEM,720078,0,0,424,424,
Tulsa,U.S. Senate,James Lankford,REP,720078,0,0,598,598,
Tulsa,U.S. Senate,Robert Murphy,LIB,720078,0,0,41,41,
Tulsa,U.S. Senate,Mike Workman,DEM,720078,0,0,337,337,
Tulsa,U.S. Senate,Mark Beard,IND,720078,0,0,24,24,
Tulsa,U.S. Senate,Sean Braddy,IND,720078,0,0,42,42,
Tulsa,State Senate,Dave Rader,REP,720078,0,0,541,541,39
Tulsa,State Senate,John Waldron,DEM,720078,0,0,499,499,39
Tulsa,State House,Molly Mckay,REP,720078,0,0,540,540,78
Tulsa,State House,Eugene Bell,LIB,720078,0,0,59,59,78
Tulsa,State House,Meloyde Blancett,DEM,720078,0,0,431,431,78
Tulsa,President,Donald Trump,REP,720079,0,0,490,490,
Tulsa,President,Gary Johnson,LIB,720079,0,0,76,76,
Tulsa,President,Hillary Clinton,DEM,720079,0,0,451,451,
Tulsa,U.S. Senate,James Lankford,REP,720079,0,0,552,552,
Tulsa,U.S. Senate,Robert Murphy,LIB,720079,0,0,39,39,
Tulsa,U.S. Senate,Mike Workman,DEM,720079,0,0,365,365,
Tulsa,U.S. Senate,Mark Beard,IND,720079,0,0,22,22,
Tulsa,U.S. Senate,Sean Braddy,IND,720079,0,0,36,36,
Tulsa,State Senate,Dave Rader,REP,720079,0,0,495,495,39
Tulsa,State Senate,John Waldron,DEM,720079,0,0,521,521,39
Tulsa,State House,Molly Mckay,REP,720079,0,0,491,491,78
Tulsa,State House,Eugene Bell,LIB,720079,0,0,80,80,78
Tulsa,State House,Meloyde Blancett,DEM,720079,0,0,436,436,78
Tulsa,President,Donald Trump,REP,720080,0,0,106,106,
Tulsa,President,Gary Johnson,LIB,720080,0,0,20,20,
Tulsa,President,Hillary Clinton,DEM,720080,0,0,90,90,
Tulsa,U.S. Senate,James Lankford,REP,720080,0,0,115,115,
Tulsa,U.S. Senate,Robert Murphy,LIB,720080,0,0,8,8,
Tulsa,U.S. Senate,Mike Workman,DEM,720080,0,0,78,78,
Tulsa,U.S. Senate,Mark Beard,IND,720080,0,0,2,2,
Tulsa,U.S. Senate,Sean Braddy,IND,720080,0,0,10,10,
Tulsa,State Senate,Dave Rader,REP,720080,0,0,108,108,39
Tulsa,State Senate,John Waldron,DEM,720080,0,0,106,106,39
Tulsa,State House,Carol Bush,REP,720080,0,0,114,114,70
Tulsa,State House,Tamara Morton,LIB,720080,0,0,19,19,70
Tulsa,State House,Joe Jennings,DEM,720080,0,0,79,79,70
Tulsa,President,Donald Trump,REP,720081,0,0,572,572,
Tulsa,President,Gary Johnson,LIB,720081,0,0,86,86,
Tulsa,President,Hillary Clinton,DEM,720081,0,0,469,469,
Tulsa,U.S. Senate,James Lankford,REP,720081,0,0,619,619,
Tulsa,U.S. Senate,Robert Murphy,LIB,720081,0,0,42,42,
Tulsa,U.S. Senate,Mike Workman,DEM,720081,0,0,401,401,
Tulsa,U.S. Senate,Mark Beard,IND,720081,0,0,24,24,
Tulsa,U.S. Senate,Sean Braddy,IND,720081,0,0,22,22,
Tulsa,State Senate,Dave Rader,REP,720081,0,0,563,563,39
Tulsa,State Senate,John Waldron,DEM,720081,0,0,549,549,39
Tulsa,State House,Carol Bush,REP,720081,0,0,615,615,70
Tulsa,State House,Tamara Morton,LIB,720081,0,0,70,70,70
Tulsa,State House,Joe Jennings,DEM,720081,0,0,414,414,70
Tulsa,President,Donald Trump,REP,720082,0,0,378,378,
Tulsa,President,Gary Johnson,LIB,720082,0,0,55,55,
Tulsa,President,Hillary Clinton,DEM,720082,0,0,306,306,
Tulsa,U.S. Senate,James Lankford,REP,720082,0,0,418,418,
Tulsa,U.S. Senate,Robert Murphy,LIB,720082,0,0,32,32,
Tulsa,U.S. Senate,Mike Workman,DEM,720082,0,0,243,243,
Tulsa,U.S. Senate,Mark Beard,IND,720082,0,0,22,22,
Tulsa,U.S. Senate,Sean Braddy,IND,720082,0,0,22,22,
Tulsa,State Senate,Dave Rader,REP,720082,0,0,369,369,39
Tulsa,State Senate,John Waldron,DEM,720082,0,0,372,372,39
Tulsa,State House,Carol Bush,REP,720082,0,0,418,418,70
Tulsa,State House,Tamara Morton,LIB,720082,0,0,49,49,70
Tulsa,State House,Joe Jennings,DEM,720082,0,0,265,265,70
Tulsa,President,Donald Trump,REP,720083,0,0,324,324,
Tulsa,President,Gary Johnson,LIB,720083,0,0,72,72,
Tulsa,President,Hillary Clinton,DEM,720083,0,0,341,341,
Tulsa,U.S. Senate,James Lankford,REP,720083,0,0,365,365,
Tulsa,U.S. Senate,Robert Murphy,LIB,720083,0,0,54,54,
Tulsa,U.S. Senate,Mike Workman,DEM,720083,0,0,281,281,
Tulsa,U.S. Senate,Mark Beard,IND,720083,0,0,9,9,
Tulsa,U.S. Senate,Sean Braddy,IND,720083,0,0,25,25,
Tulsa,State Senate,Dave Rader,REP,720083,0,0,360,360,39
Tulsa,State Senate,John Waldron,DEM,720083,0,0,369,369,39
Tulsa,State House,Carol Bush,REP,720083,0,0,371,371,70
Tulsa,State House,Tamara Morton,LIB,720083,0,0,69,69,70
Tulsa,State House,Joe Jennings,DEM,720083,0,0,288,288,70
Tulsa,President,Donald Trump,REP,720084,0,0,333,333,
Tulsa,President,Gary Johnson,LIB,720084,0,0,56,56,
Tulsa,President,Hillary Clinton,DEM,720084,0,0,256,256,
Tulsa,U.S. Senate,James Lankford,REP,720084,0,0,388,388,
Tulsa,U.S. Senate,Robert Murphy,LIB,720084,0,0,25,25,
Tulsa,U.S. Senate,Mike Workman,DEM,720084,0,0,202,202,
Tulsa,U.S. Senate,Mark Beard,IND,720084,0,0,11,11,
Tulsa,U.S. Senate,Sean Braddy,IND,720084,0,0,10,10,
Tulsa,State Senate,Dave Rader,REP,720084,0,0,340,340,39
Tulsa,State Senate,John Waldron,DEM,720084,0,0,305,305,39
Tulsa,State House,Carol Bush,REP,720084,0,0,401,401,70
Tulsa,State House,Tamara Morton,LIB,720084,0,0,34,34,70
Tulsa,State House,Joe Jennings,DEM,720084,0,0,194,194,70
Tulsa,President,Donald Trump,REP,720085,0,0,150,150,
Tulsa,President,Gary Johnson,LIB,720085,0,0,28,28,
Tulsa,President,Hillary Clinton,DEM,720085,0,0,163,163,
Tulsa,U.S. Senate,James Lankford,REP,720085,0,0,173,173,
Tulsa,U.S. Senate,Robert Murphy,LIB,720085,0,0,8,8,
Tulsa,U.S. Senate,Mike Workman,DEM,720085,0,0,143,143,
Tulsa,U.S. Senate,Mark Beard,IND,720085,0,0,8,8,
Tulsa,U.S. Senate,Sean Braddy,IND,720085,0,0,12,12,
Tulsa,State Senate,Dave Rader,REP,720085,0,0,154,154,39
Tulsa,State Senate,John Waldron,DEM,720085,0,0,192,192,39
Tulsa,State House,Carol Bush,REP,720085,0,0,150,150,70
Tulsa,State House,Tamara Morton,LIB,720085,0,0,24,24,70
Tulsa,State House,Joe Jennings,DEM,720085,0,0,162,162,70
Tulsa,President,Donald Trump,REP,720086,0,0,526,526,
Tulsa,President,Gary Johnson,LIB,720086,0,0,61,61,
Tulsa,President,Hillary Clinton,DEM,720086,0,0,322,322,
Tulsa,U.S. Senate,James Lankford,REP,720086,0,0,550,550,
Tulsa,U.S. Senate,Robert Murphy,LIB,720086,0,0,33,33,
Tulsa,U.S. Senate,Mike Workman,DEM,720086,0,0,252,252,
Tulsa,U.S. Senate,Mark Beard,IND,720086,0,0,35,35,
Tulsa,U.S. Senate,Sean Braddy,IND,720086,0,0,25,25,
Tulsa,State Senate,Nathan Dahm,REP,720086,0,0,520,520,33
Tulsa,State Senate,Kimberly Fobbs,DEM,720086,0,0,361,361,33
Tulsa,State House,Dan Kirby,REP,720086,0,0,503,503,75
Tulsa,State House,Karen Gaddis,DEM,720086,0,0,384,384,75
Tulsa,President,Donald Trump,REP,720087,0,0,448,448,
Tulsa,President,Gary Johnson,LIB,720087,0,0,61,61,
Tulsa,President,Hillary Clinton,DEM,720087,0,0,412,412,
Tulsa,U.S. Senate,James Lankford,REP,720087,0,0,507,507,
Tulsa,U.S. Senate,Robert Murphy,LIB,720087,0,0,32,32,
Tulsa,U.S. Senate,Mike Workman,DEM,720087,0,0,336,336,
Tulsa,U.S. Senate,Mark Beard,IND,720087,0,0,16,16,
Tulsa,U.S. Senate,Sean Braddy,IND,720087,0,0,26,26,
Tulsa,State Senate,Dave Rader,REP,720087,0,0,466,466,39
Tulsa,State Senate,John Waldron,DEM,720087,0,0,452,452,39
Tulsa,State House,Weldon Watson,REP,720087,0,0,500,500,79
Tulsa,State House,Teresa Marler,IND,720087,0,0,337,337,79
Tulsa,President,Donald Trump,REP,720088,0,0,106,106,
Tulsa,President,Gary Johnson,LIB,720088,0,0,27,27,
Tulsa,President,Hillary Clinton,DEM,720088,0,0,107,107,
Tulsa,U.S. Senate,James Lankford,REP,720088,0,0,117,117,
Tulsa,U.S. Senate,Robert Murphy,LIB,720088,0,0,13,13,
Tulsa,U.S. Senate,Mike Workman,DEM,720088,0,0,96,96,
Tulsa,U.S. Senate,Mark Beard,IND,720088,0,0,6,6,
Tulsa,U.S. Senate,Sean Braddy,IND,720088,0,0,10,10,
Tulsa,State Senate,Joe Newhouse,REP,720088,0,0,120,120,25
Tulsa,State Senate,Robert Founds,DEM,720088,0,0,119,119,25
Tulsa,State House,Dan Kirby,REP,720088,0,0,115,115,75
Tulsa,State House,Karen Gaddis,DEM,720088,0,0,121,121,75
Tulsa,President,Donald Trump,REP,720089,0,0,209,209,
Tulsa,President,Gary Johnson,LIB,720089,0,0,32,32,
Tulsa,President,Hillary Clinton,DEM,720089,0,0,188,188,
Tulsa,U.S. Senate,James Lankford,REP,720089,0,0,219,219,
Tulsa,U.S. Senate,Robert Murphy,LIB,720089,0,0,31,31,
Tulsa,U.S. Senate,Mike Workman,DEM,720089,0,0,148,148,
Tulsa,U.S. Senate,Mark Beard,IND,720089,0,0,15,15,
Tulsa,U.S. Senate,Sean Braddy,IND,720089,0,0,11,11,
Tulsa,State Senate,Dave Rader,REP,720089,0,0,210,210,39
Tulsa,State Senate,John Waldron,DEM,720089,0,0,215,215,39
Tulsa,State House,Carol Bush,REP,720089,0,0,209,209,70
Tulsa,State House,Tamara Morton,LIB,720089,0,0,42,42,70
Tulsa,State House,Joe Jennings,DEM,720089,0,0,167,167,70
Tulsa,President,Donald Trump,REP,720090,0,0,151,151,
Tulsa,President,Gary Johnson,LIB,720090,0,0,20,20,
Tulsa,President,Hillary Clinton,DEM,720090,0,0,177,177,
Tulsa,U.S. Senate,James Lankford,REP,720090,0,0,144,144,
Tulsa,U.S. Senate,Robert Murphy,LIB,720090,0,0,21,21,
Tulsa,U.S. Senate,Mike Workman,DEM,720090,0,0,153,153,
Tulsa,U.S. Senate,Mark Beard,IND,720090,0,0,10,10,
Tulsa,U.S. Senate,Sean Braddy,IND,720090,0,0,15,15,
Tulsa,State House,Dan Kirby,REP,720090,0,0,150,150,75
Tulsa,State House,Karen Gaddis,DEM,720090,0,0,193,193,75
Tulsa,President,Donald Trump,REP,720091,0,0,268,268,
Tulsa,President,Gary Johnson,LIB,720091,0,0,44,44,
Tulsa,President,Hillary Clinton,DEM,720091,0,0,275,275,
Tulsa,U.S. Senate,James Lankford,REP,720091,0,0,271,271,
Tulsa,U.S. Senate,Robert Murphy,LIB,720091,0,0,32,32,
Tulsa,U.S. Senate,Mike Workman,DEM,720091,0,0,247,247,
Tulsa,U.S. Senate,Mark Beard,IND,720091,0,0,13,13,
Tulsa,U.S. Senate,Sean Braddy,IND,720091,0,0,28,28,
Tulsa,State Senate,Joe Newhouse,REP,720091,0,0,292,292,25
Tulsa,State Senate,Robert Founds,DEM,720091,0,0,290,290,25
Tulsa,State House,Weldon Watson,REP,720091,0,0,270,270,79
Tulsa,State House,Teresa Marler,IND,720091,0,0,266,266,79
Tulsa,President,Donald Trump,REP,720092,0,0,240,240,
Tulsa,President,Gary Johnson,LIB,720092,0,0,28,28,
Tulsa,President,Hillary Clinton,DEM,720092,0,0,219,219,
Tulsa,U.S. Senate,James Lankford,REP,720092,0,0,247,247,
Tulsa,U.S. Senate,Robert Murphy,LIB,720092,0,0,20,20,
Tulsa,U.S. Senate,Mike Workman,DEM,720092,0,0,185,185,
Tulsa,U.S. Senate,Mark Beard,IND,720092,0,0,11,11,
Tulsa,U.S. Senate,Sean Braddy,IND,720092,0,0,22,22,
Tulsa,State Senate,Dave Rader,REP,720092,0,0,225,225,39
Tulsa,State Senate,John Waldron,DEM,720092,0,0,261,261,39
Tulsa,State House,Molly Mckay,REP,720092,0,0,226,226,78
Tulsa,State House,Eugene Bell,LIB,720092,0,0,35,35,78
Tulsa,State House,Meloyde Blancett,DEM,720092,0,0,222,222,78
Tulsa,President,Donald Trump,REP,720093,0,0,271,271,
Tulsa,President,Gary Johnson,LIB,720093,0,0,38,38,
Tulsa,President,Hillary Clinton,DEM,720093,0,0,172,172,
Tulsa,U.S. Senate,James Lankford,REP,720093,0,0,292,292,
Tulsa,U.S. Senate,Robert Murphy,LIB,720093,0,0,24,24,
Tulsa,U.S. Senate,Mike Workman,DEM,720093,0,0,140,140,
Tulsa,U.S. Senate,Mark Beard,IND,720093,0,0,12,12,
Tulsa,U.S. Senate,Sean Braddy,IND,720093,0,0,7,7,
Tulsa,State Senate,Dave Rader,REP,720093,0,0,260,260,39
Tulsa,State Senate,John Waldron,DEM,720093,0,0,212,212,39
Tulsa,State House,Molly Mckay,REP,720093,0,0,245,245,78
Tulsa,State House,Eugene Bell,LIB,720093,0,0,31,31,78
Tulsa,State House,Meloyde Blancett,DEM,720093,0,0,191,191,78
Tulsa,President,Donald Trump,REP,720094,0,0,443,443,
Tulsa,President,Gary Johnson,LIB,720094,0,0,46,46,
Tulsa,President,Hillary Clinton,DEM,720094,0,0,301,301,
Tulsa,U.S. Senate,James Lankford,REP,720094,0,0,484,484,
Tulsa,U.S. Senate,Robert Murphy,LIB,720094,0,0,25,25,
Tulsa,U.S. Senate,Mike Workman,DEM,720094,0,0,230,230,
Tulsa,U.S. Senate,Mark Beard,IND,720094,0,0,18,18,
Tulsa,U.S. Senate,Sean Braddy,IND,720094,0,0,23,23,
Tulsa,State Senate,Joe Newhouse,REP,720094,0,0,497,497,25
Tulsa,State Senate,Robert Founds,DEM,720094,0,0,276,276,25
Tulsa,State House,Molly Mckay,REP,720094,0,0,405,405,78
Tulsa,State House,Eugene Bell,LIB,720094,0,0,44,44,78
Tulsa,State House,Meloyde Blancett,DEM,720094,0,0,320,320,78
Tulsa,President,Donald Trump,REP,720095,0,0,438,438,
Tulsa,President,Gary Johnson,LIB,720095,0,0,55,55,
Tulsa,President,Hillary Clinton,DEM,720095,0,0,261,261,
Tulsa,U.S. Senate,James Lankford,REP,720095,0,0,460,460,
Tulsa,U.S. Senate,Robert Murphy,LIB,720095,0,0,31,31,
Tulsa,U.S. Senate,Mike Workman,DEM,720095,0,0,227,227,
Tulsa,U.S. Senate,Mark Beard,IND,720095,0,0,13,13,
Tulsa,U.S. Senate,Sean Braddy,IND,720095,0,0,19,19,
Tulsa,State Senate,Joe Newhouse,REP,720095,0,0,480,480,25
Tulsa,State Senate,Robert Founds,DEM,720095,0,0,265,265,25
Tulsa,State House,Molly Mckay,REP,720095,0,0,423,423,78
Tulsa,State House,Eugene Bell,LIB,720095,0,0,39,39,78
Tulsa,State House,Meloyde Blancett,DEM,720095,0,0,289,289,78
Tulsa,President,Donald Trump,REP,720096,0,0,307,307,
Tulsa,President,Gary Johnson,LIB,720096,0,0,32,32,
Tulsa,President,Hillary Clinton,DEM,720096,0,0,248,248,
Tulsa,U.S. Senate,James Lankford,REP,720096,0,0,325,325,
Tulsa,U.S. Senate,Robert Murphy,LIB,720096,0,0,17,17,
Tulsa,U.S. Senate,Mike Workman,DEM,720096,0,0,197,197,
Tulsa,U.S. Senate,Mark Beard,IND,720096,0,0,21,21,
Tulsa,U.S. Senate,Sean Braddy,IND,720096,0,0,27,27,
Tulsa,State Senate,Nathan Dahm,REP,720096,0,0,321,321,33
Tulsa,State Senate,Kimberly Fobbs,DEM,720096,0,0,261,261,33
Tulsa,State House,Dan Kirby,REP,720096,0,0,296,296,75
Tulsa,State House,Karen Gaddis,DEM,720096,0,0,285,285,75
Tulsa,President,Donald Trump,REP,720097,0,0,414,414,
Tulsa,President,Gary Johnson,LIB,720097,0,0,43,43,
Tulsa,President,Hillary Clinton,DEM,720097,0,0,408,408,
Tulsa,U.S. Senate,James Lankford,REP,720097,0,0,440,440,
Tulsa,U.S. Senate,Robert Murphy,LIB,720097,0,0,24,24,
Tulsa,U.S. Senate,Mike Workman,DEM,720097,0,0,341,341,
Tulsa,U.S. Senate,Mark Beard,IND,720097,0,0,22,22,
Tulsa,U.S. Senate,Sean Braddy,IND,720097,0,0,39,39,
Tulsa,State Senate,Joe Newhouse,REP,720097,0,0,451,451,25
Tulsa,State Senate,Robert Founds,DEM,720097,0,0,413,413,25
Tulsa,State House,Terry O'Donnell,REP,720097,0,0,459,459,23
Tulsa,State House,Keith Welch Sr.,DEM,720097,0,0,400,400,23
Tulsa,President,Donald Trump,REP,720098,0,0,299,299,
Tulsa,President,Gary Johnson,LIB,720098,0,0,38,38,
Tulsa,President,Hillary Clinton,DEM,720098,0,0,278,278,
Tulsa,U.S. Senate,James Lankford,REP,720098,0,0,304,304,
Tulsa,U.S. Senate,Robert Murphy,LIB,720098,0,0,29,29,
Tulsa,U.S. Senate,Mike Workman,DEM,720098,0,0,234,234,
Tulsa,U.S. Senate,Mark Beard,IND,720098,0,0,18,18,
Tulsa,U.S. Senate,Sean Braddy,IND,720098,0,0,27,27,
Tulsa,State House,Terry O'Donnell,REP,720098,0,0,298,298,23
Tulsa,State House,Keith Welch Sr.,DEM,720098,0,0,308,308,23
Tulsa,President,Donald Trump,REP,720099,0,0,245,245,
Tulsa,President,Gary Johnson,LIB,720099,0,0,48,48,
Tulsa,President,Hillary Clinton,DEM,720099,0,0,229,229,
Tulsa,U.S. Senate,James Lankford,REP,720099,0,0,249,249,
Tulsa,U.S. Senate,Robert Murphy,LIB,720099,0,0,18,18,
Tulsa,U.S. Senate,Mike Workman,DEM,720099,0,0,201,201,
Tulsa,U.S. Senate,Mark Beard,IND,720099,0,0,16,16,
Tulsa,U.S. Senate,Sean Braddy,IND,720099,0,0,34,34,
Tulsa,State House,Terry O'Donnell,REP,720099,0,0,269,269,23
Tulsa,State House,Keith Welch Sr.,DEM,720099,0,0,245,245,23
Tulsa,President,Donald Trump,REP,720100,0,0,162,162,
Tulsa,President,Gary Johnson,LIB,720100,0,0,14,14,
Tulsa,President,Hillary Clinton,DEM,720100,0,0,116,116,
Tulsa,U.S. Senate,James Lankford,REP,720100,0,0,163,163,
Tulsa,U.S. Senate,Robert Murphy,LIB,720100,0,0,9,9,
Tulsa,U.S. Senate,Mike Workman,DEM,720100,0,0,96,96,
Tulsa,U.S. Senate,Mark Beard,IND,720100,0,0,12,12,
Tulsa,U.S. Senate,Sean Braddy,IND,720100,0,0,11,11,
Tulsa,State Senate,Joe Newhouse,REP,720100,0,0,160,160,25
Tulsa,State Senate,Robert Founds,DEM,720100,0,0,125,125,25
Tulsa,State House,Dan Kirby,REP,720100,0,0,148,148,75
Tulsa,State House,Karen Gaddis,DEM,720100,0,0,136,136,75
Tulsa,President,Donald Trump,REP,720101,0,0,486,486,
Tulsa,President,Gary Johnson,LIB,720101,0,0,69,69,
Tulsa,President,Hillary Clinton,DEM,720101,0,0,443,443,
Tulsa,U.S. Senate,James Lankford,REP,720101,0,0,504,504,
Tulsa,U.S. Senate,Robert Murphy,LIB,720101,0,0,38,38,
Tulsa,U.S. Senate,Mike Workman,DEM,720101,0,0,376,376,
Tulsa,U.S. Senate,Mark Beard,IND,720101,0,0,30,30,
Tulsa,U.S. Senate,Sean Braddy,IND,720101,0,0,43,43,
Tulsa,State House,Dan Kirby,REP,720101,0,0,485,485,75
Tulsa,State House,Karen Gaddis,DEM,720101,0,0,500,500,75
Tulsa,President,Donald Trump,REP,720102,0,0,399,399,
Tulsa,President,Gary Johnson,LIB,720102,0,0,57,57,
Tulsa,President,Hillary Clinton,DEM,720102,0,0,367,367,
Tulsa,U.S. Senate,James Lankford,REP,720102,0,0,421,421,
Tulsa,U.S. Senate,Robert Murphy,LIB,720102,0,0,42,42,
Tulsa,U.S. Senate,Mike Workman,DEM,720102,0,0,307,307,
Tulsa,U.S. Senate,Mark Beard,IND,720102,0,0,25,25,
Tulsa,U.S. Senate,Sean Braddy,IND,720102,0,0,26,26,
Tulsa,State House,Dan Kirby,REP,720102,0,0,402,402,75
Tulsa,State House,Karen Gaddis,DEM,720102,0,0,415,415,75
Tulsa,President,Donald Trump,REP,720103,0,0,247,247,
Tulsa,President,Gary Johnson,LIB,720103,0,0,26,26,
Tulsa,President,Hillary Clinton,DEM,720103,0,0,167,167,
Tulsa,U.S. Senate,James Lankford,REP,720103,0,0,250,250,
Tulsa,U.S. Senate,Robert Murphy,LIB,720103,0,0,19,19,
Tulsa,U.S. Senate,Mike Workman,DEM,720103,0,0,151,151,
Tulsa,U.S. Senate,Mark Beard,IND,720103,0,0,7,7,
Tulsa,U.S. Senate,Sean Braddy,IND,720103,0,0,9,9,
Tulsa,State House,Dan Kirby,REP,720103,0,0,255,255,75
Tulsa,State House,Karen Gaddis,DEM,720103,0,0,179,179,75
Tulsa,President,Donald Trump,REP,720104,0,0,294,294,
Tulsa,President,Gary Johnson,LIB,720104,0,0,35,35,
Tulsa,President,Hillary Clinton,DEM,720104,0,0,246,246,
Tulsa,U.S. Senate,James Lankford,REP,720104,0,0,304,304,
Tulsa,U.S. Senate,Robert Murphy,LIB,720104,0,0,19,19,
Tulsa,U.S. Senate,Mike Workman,DEM,720104,0,0,217,217,
Tulsa,U.S. Senate,Mark Beard,IND,720104,0,0,13,13,
Tulsa,U.S. Senate,Sean Braddy,IND,720104,0,0,14,14,
Tulsa,State House,Dan Kirby,REP,720104,0,0,286,286,75
Tulsa,State House,Karen Gaddis,DEM,720104,0,0,281,281,75
Tulsa,President,Donald Trump,REP,720105,0,0,417,417,
Tulsa,President,Gary Johnson,LIB,720105,0,0,52,52,
Tulsa,President,Hillary Clinton,DEM,720105,0,0,363,363,
Tulsa,U.S. Senate,James Lankford,REP,720105,0,0,441,441,
Tulsa,U.S. Senate,Robert Murphy,LIB,720105,0,0,24,24,
Tulsa,U.S. Senate,Mike Workman,DEM,720105,0,0,304,304,
Tulsa,U.S. Senate,Mark Beard,IND,720105,0,0,26,26,
Tulsa,U.S. Senate,Sean Braddy,IND,720105,0,0,31,31,
Tulsa,State House,Dan Kirby,REP,720105,0,0,407,407,75
Tulsa,State House,Karen Gaddis,DEM,720105,0,0,410,410,75
Tulsa,President,Donald Trump,REP,720106,0,0,260,260,
Tulsa,President,Gary Johnson,LIB,720106,0,0,28,28,
Tulsa,President,Hillary Clinton,DEM,720106,0,0,234,234,
Tulsa,U.S. Senate,James Lankford,REP,720106,0,0,278,278,
Tulsa,U.S. Senate,Robert Murphy,LIB,720106,0,0,16,16,
Tulsa,U.S. Senate,Mike Workman,DEM,720106,0,0,181,181,
Tulsa,U.S. Senate,Mark Beard,IND,720106,0,0,17,17,
Tulsa,U.S. Senate,Sean Braddy,IND,720106,0,0,21,21,
Tulsa,State House,Dan Kirby,REP,720106,0,0,279,279,75
Tulsa,State House,Karen Gaddis,DEM,720106,0,0,229,229,75
Tulsa,President,Donald Trump,REP,720107,0,0,435,435,
Tulsa,President,Gary Johnson,LIB,720107,0,0,64,64,
Tulsa,President,Hillary Clinton,DEM,720107,0,0,440,440,
Tulsa,U.S. Senate,James Lankford,REP,720107,0,0,483,483,
Tulsa,U.S. Senate,Robert Murphy,LIB,720107,0,0,32,32,
Tulsa,U.S. Senate,Mike Workman,DEM,720107,0,0,360,360,
Tulsa,U.S. Senate,Mark Beard,IND,720107,0,0,28,28,
Tulsa,U.S. Senate,Sean Braddy,IND,720107,0,0,22,22,
Tulsa,State Senate,Gary Stanislawski,REP,720107,0,0,495,495,35
Tulsa,State Senate,Frank Grove,LIB,720107,0,0,304,304,35
Tulsa,State House,Katie Henke,REP,720107,0,0,500,500,71
Tulsa,State House,Millie Hardesty York,DEM,720107,0,0,412,412,71
Tulsa,President,Donald Trump,REP,720108,0,0,297,297,
Tulsa,President,Gary Johnson,LIB,720108,0,0,45,45,
Tulsa,President,Hillary Clinton,DEM,720108,0,0,277,277,
Tulsa,U.S. Senate,James Lankford,REP,720108,0,0,316,316,
Tulsa,U.S. Senate,Robert Murphy,LIB,720108,0,0,33,33,
Tulsa,U.S. Senate,Mike Workman,DEM,720108,0,0,227,227,
Tulsa,U.S. Senate,Mark Beard,IND,720108,0,0,18,18,
Tulsa,U.S. Senate,Sean Braddy,IND,720108,0,0,17,17,
Tulsa,State Senate,Gary Stanislawski,REP,720108,0,0,321,321,35
Tulsa,State Senate,Frank Grove,LIB,720108,0,0,232,232,35
Tulsa,State House,Katie Henke,REP,720108,0,0,335,335,71
Tulsa,State House,Millie Hardesty York,DEM,720108,0,0,278,278,71
Tulsa,President,Donald Trump,REP,720109,0,0,193,193,
Tulsa,President,Gary Johnson,LIB,720109,0,0,36,36,
Tulsa,President,Hillary Clinton,DEM,720109,0,0,247,247,
Tulsa,U.S. Senate,James Lankford,REP,720109,0,0,210,210,
Tulsa,U.S. Senate,Robert Murphy,LIB,720109,0,0,20,20,
Tulsa,U.S. Senate,Mike Workman,DEM,720109,0,0,207,207,
Tulsa,U.S. Senate,Mark Beard,IND,720109,0,0,9,9,
Tulsa,U.S. Senate,Sean Braddy,IND,720109,0,0,24,24,
Tulsa,State Senate,Gary Stanislawski,REP,720109,0,0,217,217,35
Tulsa,State Senate,Frank Grove,LIB,720109,0,0,189,189,35
Tulsa,State House,Katie Henke,REP,720109,0,0,234,234,71
Tulsa,State House,Millie Hardesty York,DEM,720109,0,0,236,236,71
Tulsa,President,Donald Trump,REP,720110,0,0,335,335,
Tulsa,President,Gary Johnson,LIB,720110,0,0,50,50,
Tulsa,President,Hillary Clinton,DEM,720110,0,0,354,354,
Tulsa,U.S. Senate,James Lankford,REP,720110,0,0,346,346,
Tulsa,U.S. Senate,Robert Murphy,LIB,720110,0,0,29,29,
Tulsa,U.S. Senate,Mike Workman,DEM,720110,0,0,300,300,
Tulsa,U.S. Senate,Mark Beard,IND,720110,0,0,21,21,
Tulsa,U.S. Senate,Sean Braddy,IND,720110,0,0,31,31,
Tulsa,State Senate,Gary Stanislawski,REP,720110,0,0,386,386,35
Tulsa,State Senate,Frank Grove,LIB,720110,0,0,274,274,35
Tulsa,State House,Katie Henke,REP,720110,0,0,362,362,71
Tulsa,State House,Millie Hardesty York,DEM,720110,0,0,361,361,71
Tulsa,President,Donald Trump,REP,720111,0,0,251,251,
Tulsa,President,Gary Johnson,LIB,720111,0,0,40,40,
Tulsa,President,Hillary Clinton,DEM,720111,0,0,301,301,
Tulsa,U.S. Senate,James Lankford,REP,720111,0,0,278,278,
Tulsa,U.S. Senate,Robert Murphy,LIB,720111,0,0,21,21,
Tulsa,U.S. Senate,Mike Workman,DEM,720111,0,0,243,243,
Tulsa,U.S. Senate,Mark Beard,IND,720111,0,0,18,18,
Tulsa,U.S. Senate,Sean Braddy,IND,720111,0,0,32,32,
Tulsa,State Senate,Gary Stanislawski,REP,720111,0,0,279,279,35
Tulsa,State Senate,Frank Grove,LIB,720111,0,0,241,241,35
Tulsa,State House,Katie Henke,REP,720111,0,0,296,296,71
Tulsa,State House,Millie Hardesty York,DEM,720111,0,0,290,290,71
Tulsa,President,Donald Trump,REP,720112,0,0,362,362,
Tulsa,President,Gary Johnson,LIB,720112,0,0,66,66,
Tulsa,President,Hillary Clinton,DEM,720112,0,0,340,340,
Tulsa,U.S. Senate,James Lankford,REP,720112,0,0,378,378,
Tulsa,U.S. Senate,Robert Murphy,LIB,720112,0,0,32,32,
Tulsa,U.S. Senate,Mike Workman,DEM,720112,0,0,302,302,
Tulsa,U.S. Senate,Mark Beard,IND,720112,0,0,21,21,
Tulsa,U.S. Senate,Sean Braddy,IND,720112,0,0,28,28,
Tulsa,State Senate,Gary Stanislawski,REP,720112,0,0,412,412,35
Tulsa,State Senate,Frank Grove,LIB,720112,0,0,268,268,35
Tulsa,State House,Katie Henke,REP,720112,0,0,396,396,71
Tulsa,State House,Millie Hardesty York,DEM,720112,0,0,360,360,71
Tulsa,President,Donald Trump,REP,720113,0,0,382,382,
Tulsa,President,Gary Johnson,LIB,720113,0,0,80,80,
Tulsa,President,Hillary Clinton,DEM,720113,0,0,304,304,
Tulsa,U.S. Senate,James Lankford,REP,720113,0,0,437,437,
Tulsa,U.S. Senate,Robert Murphy,LIB,720113,0,0,47,47,
Tulsa,U.S. Senate,Mike Workman,DEM,720113,0,0,225,225,
Tulsa,U.S. Senate,Mark Beard,IND,720113,0,0,26,26,
Tulsa,U.S. Senate,Sean Braddy,IND,720113,0,0,26,26,
Tulsa,State Senate,Gary Stanislawski,REP,720113,0,0,423,423,35
Tulsa,State Senate,Frank Grove,LIB,720113,0,0,265,265,35
Tulsa,State House,Chuck Strohm,REP,720113,0,0,397,397,69
Tulsa,State House,Paul Sullivan,DEM,720113,0,0,339,339,69
Tulsa,President,Donald Trump,REP,720114,0,0,244,244,
Tulsa,President,Gary Johnson,LIB,720114,0,0,44,44,
Tulsa,President,Hillary Clinton,DEM,720114,0,0,204,204,
Tulsa,U.S. Senate,James Lankford,REP,720114,0,0,278,278,
Tulsa,U.S. Senate,Robert Murphy,LIB,720114,0,0,24,24,
Tulsa,U.S. Senate,Mike Workman,DEM,720114,0,0,156,156,
Tulsa,U.S. Senate,Mark Beard,IND,720114,0,0,12,12,
Tulsa,U.S. Senate,Sean Braddy,IND,720114,0,0,19,19,
Tulsa,State Senate,Gary Stanislawski,REP,720114,0,0,285,285,35
Tulsa,State Senate,Frank Grove,LIB,720114,0,0,155,155,35
Tulsa,State House,Carol Bush,REP,720114,0,0,253,253,70
Tulsa,State House,Tamara Morton,LIB,720114,0,0,36,36,70
Tulsa,State House,Joe Jennings,DEM,720114,0,0,202,202,70
Tulsa,President,Donald Trump,REP,720115,0,0,363,363,
Tulsa,President,Gary Johnson,LIB,720115,0,0,26,26,
Tulsa,President,Hillary Clinton,DEM,720115,0,0,172,172,
Tulsa,U.S. Senate,James Lankford,REP,720115,0,0,417,417,
Tulsa,U.S. Senate,Robert Murphy,LIB,720115,0,0,11,11,
Tulsa,U.S. Senate,Mike Workman,DEM,720115,0,0,120,120,
Tulsa,U.S. Senate,Mark Beard,IND,720115,0,0,6,6,
Tulsa,U.S. Senate,Sean Braddy,IND,720115,0,0,8,8,
Tulsa,State Senate,Gary Stanislawski,REP,720115,0,0,400,400,35
Tulsa,State Senate,Frank Grove,LIB,720115,0,0,124,124,35
Tulsa,State House,Carol Bush,REP,720115,0,0,409,409,70
Tulsa,State House,Tamara Morton,LIB,720115,0,0,17,17,70
Tulsa,State House,Joe Jennings,DEM,720115,0,0,133,133,70
Tulsa,President,Donald Trump,REP,720116,0,0,551,551,
Tulsa,President,Gary Johnson,LIB,720116,0,0,25,25,
Tulsa,President,Hillary Clinton,DEM,720116,0,0,235,235,
Tulsa,U.S. Senate,James Lankford,REP,720116,0,0,607,607,
Tulsa,U.S. Senate,Robert Murphy,LIB,720116,0,0,14,14,
Tulsa,U.S. Senate,Mike Workman,DEM,720116,0,0,167,167,
Tulsa,U.S. Senate,Mark Beard,IND,720116,0,0,9,9,
Tulsa,U.S. Senate,Sean Braddy,IND,720116,0,0,11,11,
Tulsa,State Senate,Gary Stanislawski,REP,720116,0,0,617,617,35
Tulsa,State Senate,Frank Grove,LIB,720116,0,0,123,123,35
Tulsa,State House,Chuck Strohm,REP,720116,0,0,557,557,69
Tulsa,State House,Paul Sullivan,DEM,720116,0,0,240,240,69
Tulsa,President,Donald Trump,REP,720117,0,0,988,988,
Tulsa,President,Gary Johnson,LIB,720117,0,0,110,110,
Tulsa,President,Hillary Clinton,DEM,720117,0,0,484,484,
Tulsa,U.S. Senate,James Lankford,REP,720117,0,0,1101,1101,
Tulsa,U.S. Senate,Robert Murphy,LIB,720117,0,0,53,53,
Tulsa,U.S. Senate,Mike Workman,DEM,720117,0,0,377,377,
Tulsa,U.S. Senate,Mark Beard,IND,720117,0,0,25,25,
Tulsa,U.S. Senate,Sean Braddy,IND,720117,0,0,27,27,
Tulsa,State Senate,Gary Stanislawski,REP,720117,0,0,1125,1125,35
Tulsa,State Senate,Frank Grove,LIB,720117,0,0,334,334,35
Tulsa,State House,Scott Mceachin,REP,720117,0,0,1021,1021,67
Tulsa,State House,Zac Davis,LIB,720117,0,0,95,95,67
Tulsa,State House,Lori Decter Wright,DEM,720117,0,0,444,444,67
Tulsa,President,Donald Trump,REP,720118,0,0,879,879,
Tulsa,President,Gary Johnson,LIB,720118,0,0,76,76,
Tulsa,President,Hillary Clinton,DEM,720118,0,0,325,325,
Tulsa,U.S. Senate,James Lankford,REP,720118,0,0,953,953,
Tulsa,U.S. Senate,Robert Murphy,LIB,720118,0,0,47,47,
Tulsa,U.S. Senate,Mike Workman,DEM,720118,0,0,241,241,
Tulsa,U.S. Senate,Mark Beard,IND,720118,0,0,17,17,
Tulsa,U.S. Senate,Sean Braddy,IND,720118,0,0,18,18,
Tulsa,State Senate,Dave Rader,REP,720118,0,0,958,958,39
Tulsa,State Senate,John Waldron,DEM,720118,0,0,318,318,39
Tulsa,State House,Scott Mceachin,REP,720118,0,0,921,921,67
Tulsa,State House,Zac Davis,LIB,720118,0,0,58,58,67
Tulsa,State House,Lori Decter Wright,DEM,720118,0,0,284,284,67
Tulsa,President,Donald Trump,REP,720119,0,0,573,573,
Tulsa,President,Gary Johnson,LIB,720119,0,0,36,36,
Tulsa,President,Hillary Clinton,DEM,720119,0,0,219,219,
Tulsa,U.S. Senate,James Lankford,REP,720119,0,0,625,625,
Tulsa,U.S. Senate,Robert Murphy,LIB,720119,0,0,18,18,
Tulsa,U.S. Senate,Mike Workman,DEM,720119,0,0,167,167,
Tulsa,U.S. Senate,Mark Beard,IND,720119,0,0,11,11,
Tulsa,U.S. Senate,Sean Braddy,IND,720119,0,0,5,5,
Tulsa,State Senate,Gary Stanislawski,REP,720119,0,0,648,648,35
Tulsa,State Senate,Frank Grove,LIB,720119,0,0,131,131,35
Tulsa,State House,Chuck Strohm,REP,720119,0,0,585,585,69
Tulsa,State House,Paul Sullivan,DEM,720119,0,0,223,223,69
Tulsa,President,Donald Trump,REP,720120,0,0,389,389,
Tulsa,President,Gary Johnson,LIB,720120,0,0,52,52,
Tulsa,President,Hillary Clinton,DEM,720120,0,0,217,217,
Tulsa,U.S. Senate,James Lankford,REP,720120,0,0,436,436,
Tulsa,U.S. Senate,Robert Murphy,LIB,720120,0,0,23,23,
Tulsa,U.S. Senate,Mike Workman,DEM,720120,0,0,166,166,
Tulsa,U.S. Senate,Mark Beard,IND,720120,0,0,16,16,
Tulsa,U.S. Senate,Sean Braddy,IND,720120,0,0,15,15,
Tulsa,State Senate,Nathan Dahm,REP,720120,0,0,424,424,33
Tulsa,State Senate,Kimberly Fobbs,DEM,720120,0,0,227,227,33
Tulsa,State House,Weldon Watson,REP,720120,0,0,423,423,79
Tulsa,State House,Teresa Marler,IND,720120,0,0,195,195,79
Tulsa,President,Donald Trump,REP,720121,0,0,434,434,
Tulsa,President,Gary Johnson,LIB,720121,0,0,66,66,
Tulsa,President,Hillary Clinton,DEM,720121,0,0,410,410,
Tulsa,U.S. Senate,James Lankford,REP,720121,0,0,511,511,
Tulsa,U.S. Senate,Robert Murphy,LIB,720121,0,0,48,48,
Tulsa,U.S. Senate,Mike Workman,DEM,720121,0,0,297,297,
Tulsa,U.S. Senate,Mark Beard,IND,720121,0,0,13,13,
Tulsa,U.S. Senate,Sean Braddy,IND,720121,0,0,27,27,
Tulsa,State Senate,Dave Rader,REP,720121,0,0,482,482,39
Tulsa,State Senate,John Waldron,DEM,720121,0,0,422,422,39
Tulsa,State House,Carol Bush,REP,720121,0,0,511,511,70
Tulsa,State House,Tamara Morton,LIB,720121,0,0,61,61,70
Tulsa,State House,Joe Jennings,DEM,720121,0,0,312,312,70
Tulsa,President,Donald Trump,REP,720122,0,0,284,284,
Tulsa,President,Gary Johnson,LIB,720122,0,0,25,25,
Tulsa,President,Hillary Clinton,DEM,720122,0,0,136,136,
Tulsa,U.S. Senate,James Lankford,REP,720122,0,0,305,305,
Tulsa,U.S. Senate,Robert Murphy,LIB,720122,0,0,11,11,
Tulsa,U.S. Senate,Mike Workman,DEM,720122,0,0,109,109,
Tulsa,U.S. Senate,Mark Beard,IND,720122,0,0,8,8,
Tulsa,U.S. Senate,Sean Braddy,IND,720122,0,0,13,13,
Tulsa,State Senate,Dave Rader,REP,720122,0,0,287,287,39
Tulsa,State Senate,John Waldron,DEM,720122,0,0,156,156,39
Tulsa,State House,Scott Mceachin,REP,720122,0,0,288,288,67
Tulsa,State House,Zac Davis,LIB,720122,0,0,18,18,67
Tulsa,State House,Lori Decter Wright,DEM,720122,0,0,133,133,67
Tulsa,President,Donald Trump,REP,720123,0,0,606,606,
Tulsa,President,Gary Johnson,LIB,720123,0,0,68,68,
Tulsa,President,Hillary Clinton,DEM,720123,0,0,375,375,
Tulsa,U.S. Senate,James Lankford,REP,720123,0,0,682,682,
Tulsa,U.S. Senate,Robert Murphy,LIB,720123,0,0,29,29,
Tulsa,U.S. Senate,Mike Workman,DEM,720123,0,0,284,284,
Tulsa,U.S. Senate,Mark Beard,IND,720123,0,0,17,17,
Tulsa,U.S. Senate,Sean Braddy,IND,720123,0,0,35,35,
Tulsa,State Senate,Dave Rader,REP,720123,0,0,650,650,39
Tulsa,State Senate,John Waldron,DEM,720123,0,0,403,403,39
Tulsa,State House,Carol Bush,REP,720123,0,0,683,683,70
Tulsa,State House,Tamara Morton,LIB,720123,0,0,60,60,70
Tulsa,State House,Joe Jennings,DEM,720123,0,0,294,294,70
Tulsa,President,Donald Trump,REP,720124,0,0,580,580,
Tulsa,President,Gary Johnson,LIB,720124,0,0,47,47,
Tulsa,President,Hillary Clinton,DEM,720124,0,0,305,305,
Tulsa,U.S. Senate,James Lankford,REP,720124,0,0,632,632,
Tulsa,U.S. Senate,Robert Murphy,LIB,720124,0,0,29,29,
Tulsa,U.S. Senate,Mike Workman,DEM,720124,0,0,233,233,
Tulsa,U.S. Senate,Mark Beard,IND,720124,0,0,14,14,
Tulsa,U.S. Senate,Sean Braddy,IND,720124,0,0,26,26,
Tulsa,State Senate,Dave Rader,REP,720124,0,0,615,615,39
Tulsa,State Senate,John Waldron,DEM,720124,0,0,319,319,39
Tulsa,State House,Carol Bush,REP,720124,0,0,612,612,70
Tulsa,State House,Tamara Morton,LIB,720124,0,0,53,53,70
Tulsa,State House,Joe Jennings,DEM,720124,0,0,260,260,70
Tulsa,President,Donald Trump,REP,720125,0,0,465,465,
Tulsa,President,Gary Johnson,LIB,720125,0,0,53,53,
Tulsa,President,Hillary Clinton,DEM,720125,0,0,301,301,
Tulsa,U.S. Senate,James Lankford,REP,720125,0,0,534,534,
Tulsa,U.S. Senate,Robert Murphy,LIB,720125,0,0,30,30,
Tulsa,U.S. Senate,Mike Workman,DEM,720125,0,0,241,241,
Tulsa,U.S. Senate,Mark Beard,IND,720125,0,0,9,9,
Tulsa,U.S. Senate,Sean Braddy,IND,720125,0,0,17,17,
Tulsa,State Senate,Dave Rader,REP,720125,0,0,513,513,39
Tulsa,State Senate,John Waldron,DEM,720125,0,0,308,308,39
Tulsa,State House,Weldon Watson,REP,720125,0,0,515,515,79
Tulsa,State House,Teresa Marler,IND,720125,0,0,241,241,79
Tulsa,President,Donald Trump,REP,720126,0,0,481,481,
Tulsa,President,Gary Johnson,LIB,720126,0,0,44,44,
Tulsa,President,Hillary Clinton,DEM,720126,0,0,237,237,
Tulsa,U.S. Senate,James Lankford,REP,720126,0,0,541,541,
Tulsa,U.S. Senate,Robert Murphy,LIB,720126,0,0,20,20,
Tulsa,U.S. Senate,Mike Workman,DEM,720126,0,0,173,173,
Tulsa,U.S. Senate,Mark Beard,IND,720126,0,0,14,14,
Tulsa,U.S. Senate,Sean Braddy,IND,720126,0,0,12,12,
Tulsa,State Senate,Dave Rader,REP,720126,0,0,508,508,39
Tulsa,State Senate,John Waldron,DEM,720126,0,0,252,252,39
Tulsa,State House,Weldon Watson,REP,720126,0,0,519,519,79
Tulsa,State House,Teresa Marler,IND,720126,0,0,189,189,79
Tulsa,President,Donald Trump,REP,720127,0,0,381,381,
Tulsa,President,Gary Johnson,LIB,720127,0,0,49,49,
Tulsa,President,Hillary Clinton,DEM,720127,0,0,190,190,
Tulsa,U.S. Senate,James Lankford,REP,720127,0,0,405,405,
Tulsa,U.S. Senate,Robert Murphy,LIB,720127,0,0,28,28,
Tulsa,U.S. Senate,Mike Workman,DEM,720127,0,0,162,162,
Tulsa,U.S. Senate,Mark Beard,IND,720127,0,0,9,9,
Tulsa,U.S. Senate,Sean Braddy,IND,720127,0,0,18,18,
Tulsa,State Senate,Dave Rader,REP,720127,0,0,407,407,39
Tulsa,State Senate,John Waldron,DEM,720127,0,0,211,211,39
Tulsa,State House,Weldon Watson,REP,720127,0,0,406,406,79
Tulsa,State House,Teresa Marler,IND,720127,0,0,168,168,79
Tulsa,President,Donald Trump,REP,720128,0,0,513,513,
Tulsa,President,Gary Johnson,LIB,720128,0,0,61,61,
Tulsa,President,Hillary Clinton,DEM,720128,0,0,340,340,
Tulsa,U.S. Senate,James Lankford,REP,720128,0,0,574,574,
Tulsa,U.S. Senate,Robert Murphy,LIB,720128,0,0,30,30,
Tulsa,U.S. Senate,Mike Workman,DEM,720128,0,0,270,270,
Tulsa,U.S. Senate,Mark Beard,IND,720128,0,0,7,7,
Tulsa,U.S. Senate,Sean Braddy,IND,720128,0,0,32,32,
Tulsa,State Senate,Dave Rader,REP,720128,0,0,540,540,39
Tulsa,State Senate,John Waldron,DEM,720128,0,0,369,369,39
Tulsa,State House,Weldon Watson,REP,720128,0,0,562,562,79
Tulsa,State House,Teresa Marler,IND,720128,0,0,289,289,79
Tulsa,President,Donald Trump,REP,720129,0,0,477,477,
Tulsa,President,Gary Johnson,LIB,720129,0,0,60,60,
Tulsa,President,Hillary Clinton,DEM,720129,0,0,265,265,
Tulsa,U.S. Senate,James Lankford,REP,720129,0,0,524,524,
Tulsa,U.S. Senate,Robert Murphy,LIB,720129,0,0,26,26,
Tulsa,U.S. Senate,Mike Workman,DEM,720129,0,0,215,215,
Tulsa,U.S. Senate,Mark Beard,IND,720129,0,0,11,11,
Tulsa,U.S. Senate,Sean Braddy,IND,720129,0,0,19,19,
Tulsa,State Senate,Joe Newhouse,REP,720129,0,0,534,534,25
Tulsa,State Senate,Robert Founds,DEM,720129,0,0,251,251,25
Tulsa,State House,Weldon Watson,REP,720129,0,0,497,497,79
Tulsa,State House,Teresa Marler,IND,720129,0,0,234,234,79
Tulsa,President,Donald Trump,REP,720130,0,0,493,493,
Tulsa,President,Gary Johnson,LIB,720130,0,0,65,65,
Tulsa,President,Hillary Clinton,DEM,720130,0,0,388,388,
Tulsa,U.S. Senate,James Lankford,REP,720130,0,0,543,543,
Tulsa,U.S. Senate,Robert Murphy,LIB,720130,0,0,34,34,
Tulsa,U.S. Senate,Mike Workman,DEM,720130,0,0,321,321,
Tulsa,U.S. Senate,Mark Beard,IND,720130,0,0,17,17,
Tulsa,U.S. Senate,Sean Braddy,IND,720130,0,0,27,27,
Tulsa,State Senate,Joe Newhouse,REP,720130,0,0,552,552,25
Tulsa,State Senate,Robert Founds,DEM,720130,0,0,361,361,25
Tulsa,State House,Weldon Watson,REP,720130,0,0,518,518,79
Tulsa,State House,Teresa Marler,IND,720130,0,0,332,332,79
Tulsa,President,Donald Trump,REP,720131,0,0,123,123,
Tulsa,President,Gary Johnson,LIB,720131,0,0,21,21,
Tulsa,President,Hillary Clinton,DEM,720131,0,0,105,105,
Tulsa,U.S. Senate,James Lankford,REP,720131,0,0,118,118,
Tulsa,U.S. Senate,Robert Murphy,LIB,720131,0,0,11,11,
Tulsa,U.S. Senate,Mike Workman,DEM,720131,0,0,88,88,
Tulsa,U.S. Senate,Mark Beard,IND,720131,0,0,15,15,
Tulsa,U.S. Senate,Sean Braddy,IND,720131,0,0,11,11,
Tulsa,State House,Weldon Watson,REP,720131,0,0,112,112,79
Tulsa,State House,Teresa Marler,IND,720131,0,0,118,118,79
Tulsa,President,Donald Trump,REP,720132,0,0,463,463,
Tulsa,President,Gary Johnson,LIB,720132,0,0,43,43,
Tulsa,President,Hillary Clinton,DEM,720132,0,0,269,269,
Tulsa,U.S. Senate,James Lankford,REP,720132,0,0,535,535,
Tulsa,U.S. Senate,Robert Murphy,LIB,720132,0,0,25,25,
Tulsa,U.S. Senate,Mike Workman,DEM,720132,0,0,204,204,
Tulsa,U.S. Senate,Mark Beard,IND,720132,0,0,20,20,
Tulsa,U.S. Senate,Sean Braddy,IND,720132,0,0,10,10,
Tulsa,State Senate,Joe Newhouse,REP,720132,0,0,541,541,25
Tulsa,State Senate,Robert Founds,DEM,720132,0,0,245,245,25
Tulsa,State House,Weldon Watson,REP,720132,0,0,515,515,79
Tulsa,State House,Teresa Marler,IND,720132,0,0,238,238,79
Tulsa,President,Donald Trump,REP,720133,0,0,497,497,
Tulsa,President,Gary Johnson,LIB,720133,0,0,52,52,
Tulsa,President,Hillary Clinton,DEM,720133,0,0,306,306,
Tulsa,U.S. Senate,James Lankford,REP,720133,0,0,553,553,
Tulsa,U.S. Senate,Robert Murphy,LIB,720133,0,0,16,16,
Tulsa,U.S. Senate,Mike Workman,DEM,720133,0,0,241,241,
Tulsa,U.S. Senate,Mark Beard,IND,720133,0,0,22,22,
Tulsa,U.S. Senate,Sean Braddy,IND,720133,0,0,20,20,
Tulsa,State Senate,Joe Newhouse,REP,720133,0,0,565,565,25
Tulsa,State Senate,Robert Founds,DEM,720133,0,0,283,283,25
Tulsa,State House,Weldon Watson,REP,720133,0,0,540,540,79
Tulsa,State House,Teresa Marler,IND,720133,0,0,254,254,79
Tulsa,President,Donald Trump,REP,720134,0,0,569,569,
Tulsa,President,Gary Johnson,LIB,720134,0,0,59,59,
Tulsa,President,Hillary Clinton,DEM,720134,0,0,297,297,
Tulsa,U.S. Senate,James Lankford,REP,720134,0,0,614,614,
Tulsa,U.S. Senate,Robert Murphy,LIB,720134,0,0,25,25,
Tulsa,U.S. Senate,Mike Workman,DEM,720134,0,0,250,250,
Tulsa,U.S. Senate,Mark Beard,IND,720134,0,0,12,12,
Tulsa,U.S. Senate,Sean Braddy,IND,720134,0,0,18,18,
Tulsa,State Senate,Joe Newhouse,REP,720134,0,0,634,634,25
Tulsa,State Senate,Robert Founds,DEM,720134,0,0,281,281,25
Tulsa,State House,Scott Mceachin,REP,720134,0,0,582,582,67
Tulsa,State House,Zac Davis,LIB,720134,0,0,51,51,67
Tulsa,State House,Lori Decter Wright,DEM,720134,0,0,276,276,67
Tulsa,President,Donald Trump,REP,720135,0,0,862,862,
Tulsa,President,Gary Johnson,LIB,720135,0,0,82,82,
Tulsa,President,Hillary Clinton,DEM,720135,0,0,407,407,
Tulsa,U.S. Senate,James Lankford,REP,720135,0,0,921,921,
Tulsa,U.S. Senate,Robert Murphy,LIB,720135,0,0,43,43,
Tulsa,U.S. Senate,Mike Workman,DEM,720135,0,0,338,338,
Tulsa,U.S. Senate,Mark Beard,IND,720135,0,0,21,21,
Tulsa,U.S. Senate,Sean Braddy,IND,720135,0,0,33,33,
Tulsa,State Senate,Joe Newhouse,REP,720135,0,0,941,941,25
Tulsa,State Senate,Robert Founds,DEM,720135,0,0,402,402,25
Tulsa,State House,Scott Mceachin,REP,720135,0,0,859,859,67
Tulsa,State House,Zac Davis,LIB,720135,0,0,76,76,67
Tulsa,State House,Lori Decter Wright,DEM,720135,0,0,399,399,67
Tulsa,President,Donald Trump,REP,720136,0,0,571,571,
Tulsa,President,Gary Johnson,LIB,720136,0,0,56,56,
Tulsa,President,Hillary Clinton,DEM,720136,0,0,240,240,
Tulsa,U.S. Senate,James Lankford,REP,720136,0,0,644,644,
Tulsa,U.S. Senate,Robert Murphy,LIB,720136,0,0,27,27,
Tulsa,U.S. Senate,Mike Workman,DEM,720136,0,0,178,178,
Tulsa,U.S. Senate,Mark Beard,IND,720136,0,0,20,20,
Tulsa,U.S. Senate,Sean Braddy,IND,720136,0,0,9,9,
Tulsa,State Senate,Joe Newhouse,REP,720136,0,0,646,646,25
Tulsa,State Senate,Robert Founds,DEM,720136,0,0,218,218,25
Tulsa,State House,Scott Mceachin,REP,720136,0,0,583,583,67
Tulsa,State House,Zac Davis,LIB,720136,0,0,38,38,67
Tulsa,State House,Lori Decter Wright,DEM,720136,0,0,241,241,67
Tulsa,President,Donald Trump,REP,720137,0,0,285,285,
Tulsa,President,Gary Johnson,LIB,720137,0,0,44,44,
Tulsa,President,Hillary Clinton,DEM,720137,0,0,258,258,
Tulsa,U.S. Senate,James Lankford,REP,720137,0,0,310,310,
Tulsa,U.S. Senate,Robert Murphy,LIB,720137,0,0,22,22,
Tulsa,U.S. Senate,Mike Workman,DEM,720137,0,0,219,219,
Tulsa,U.S. Senate,Mark Beard,IND,720137,0,0,18,18,
Tulsa,U.S. Senate,Sean Braddy,IND,720137,0,0,17,17,
Tulsa,State Senate,Nathan Dahm,REP,720137,0,0,300,300,33
Tulsa,State Senate,Kimberly Fobbs,DEM,720137,0,0,280,280,33
Tulsa,State House,Weldon Watson,REP,720137,0,0,301,301,79
Tulsa,State House,Teresa Marler,IND,720137,0,0,230,230,79
Tulsa,President,Donald Trump,REP,720138,0,0,84,84,
Tulsa,President,Gary Johnson,LIB,720138,0,0,12,12,
Tulsa,President,Hillary Clinton,DEM,720138,0,0,51,51,
Tulsa,U.S. Senate,James Lankford,REP,720138,0,0,88,88,
Tulsa,U.S. Senate,Robert Murphy,LIB,720138,0,0,6,6,
Tulsa,U.S. Senate,Mike Workman,DEM,720138,0,0,43,43,
Tulsa,U.S. Senate,Mark Beard,IND,720138,0,0,7,7,
Tulsa,U.S. Senate,Sean Braddy,IND,720138,0,0,3,3,
Tulsa,State Senate,Nathan Dahm,REP,720138,0,0,81,81,33
Tulsa,State Senate,Kimberly Fobbs,DEM,720138,0,0,64,64,33
Tulsa,State House,Weldon Watson,REP,720138,0,0,84,84,79
Tulsa,State House,Teresa Marler,IND,720138,0,0,52,52,79
Tulsa,President,Donald Trump,REP,720139,0,0,166,166,
Tulsa,President,Gary Johnson,LIB,720139,0,0,44,44,
Tulsa,President,Hillary Clinton,DEM,720139,0,0,336,336,
Tulsa,U.S. Senate,James Lankford,REP,720139,0,0,184,184,
Tulsa,U.S. Senate,Robert Murphy,LIB,720139,0,0,33,33,
Tulsa,U.S. Senate,Mike Workman,DEM,720139,0,0,295,295,
Tulsa,U.S. Senate,Mark Beard,IND,720139,0,0,7,7,
Tulsa,U.S. Senate,Sean Braddy,IND,720139,0,0,25,25,
Tulsa,State Senate,Dan Newberry,REP,720139,0,0,177,177,37
Tulsa,State Senate,Lloyd Snow,DEM,720139,0,0,328,328,37
Tulsa,State Senate,Shawn Ketcher,IND,720139,0,0,36,36,37
Tulsa,President,Donald Trump,REP,720140,0,0,114,114,
Tulsa,President,Gary Johnson,LIB,720140,0,0,34,34,
Tulsa,President,Hillary Clinton,DEM,720140,0,0,225,225,
Tulsa,U.S. Senate,James Lankford,REP,720140,0,0,116,116,
Tulsa,U.S. Senate,Robert Murphy,LIB,720140,0,0,29,29,
Tulsa,U.S. Senate,Mike Workman,DEM,720140,0,0,188,188,
Tulsa,U.S. Senate,Mark Beard,IND,720140,0,0,16,16,
Tulsa,U.S. Senate,Sean Braddy,IND,720140,0,0,21,21,
Tulsa,State House,Jadine Nollan,REP,720140,0,0,140,140,66
Tulsa,State House,Dianna Phillips,DEM,720140,0,0,226,226,66
Tulsa,President,Donald Trump,REP,720141,0,0,743,743,
Tulsa,President,Gary Johnson,LIB,720141,0,0,66,66,
Tulsa,President,Hillary Clinton,DEM,720141,0,0,331,331,
Tulsa,U.S. Senate,James Lankford,REP,720141,0,0,732,732,
Tulsa,U.S. Senate,Robert Murphy,LIB,720141,0,0,39,39,
Tulsa,U.S. Senate,Mike Workman,DEM,720141,0,0,303,303,
Tulsa,U.S. Senate,Mark Beard,IND,720141,0,0,30,30,
Tulsa,U.S. Senate,Sean Braddy,IND,720141,0,0,33,33,
Tulsa,State Senate,Dan Newberry,REP,720141,0,0,658,658,37
Tulsa,State Senate,Lloyd Snow,DEM,720141,0,0,414,414,37
Tulsa,State Senate,Shawn Ketcher,IND,720141,0,0,62,62,37
Tulsa,President,Donald Trump,REP,720142,0,0,527,527,
Tulsa,President,Gary Johnson,LIB,720142,0,0,37,37,
Tulsa,President,Hillary Clinton,DEM,720142,0,0,150,150,
Tulsa,U.S. Senate,James Lankford,REP,720142,0,0,520,520,
Tulsa,U.S. Senate,Robert Murphy,LIB,720142,0,0,21,21,
Tulsa,U.S. Senate,Mike Workman,DEM,720142,0,0,129,129,
Tulsa,U.S. Senate,Mark Beard,IND,720142,0,0,16,16,
Tulsa,U.S. Senate,Sean Braddy,IND,720142,0,0,20,20,
Tulsa,State Senate,Dan Newberry,REP,720142,0,0,374,374,37
Tulsa,State Senate,Lloyd Snow,DEM,720142,0,0,305,305,37
Tulsa,State Senate,Shawn Ketcher,IND,720142,0,0,32,32,37
Tulsa,President,Donald Trump,REP,720143,0,0,416,416,
Tulsa,President,Gary Johnson,LIB,720143,0,0,42,42,
Tulsa,President,Hillary Clinton,DEM,720143,0,0,166,166,
Tulsa,U.S. Senate,James Lankford,REP,720143,0,0,419,419,
Tulsa,U.S. Senate,Robert Murphy,LIB,720143,0,0,23,23,
Tulsa,U.S. Senate,Mike Workman,DEM,720143,0,0,141,141,
Tulsa,U.S. Senate,Mark Beard,IND,720143,0,0,15,15,
Tulsa,U.S. Senate,Sean Braddy,IND,720143,0,0,12,12,
Tulsa,State Senate,Dan Newberry,REP,720143,0,0,349,349,37
Tulsa,State Senate,Lloyd Snow,DEM,720143,0,0,235,235,37
Tulsa,State Senate,Shawn Ketcher,IND,720143,0,0,27,27,37
Tulsa,President,Donald Trump,REP,720144,0,0,725,725,
Tulsa,President,Gary Johnson,LIB,720144,0,0,104,104,
Tulsa,President,Hillary Clinton,DEM,720144,0,0,486,486,
Tulsa,U.S. Senate,James Lankford,REP,720144,0,0,763,763,
Tulsa,U.S. Senate,Robert Murphy,LIB,720144,0,0,40,40,
Tulsa,U.S. Senate,Mike Workman,DEM,720144,0,0,411,411,
Tulsa,U.S. Senate,Mark Beard,IND,720144,0,0,37,37,
Tulsa,U.S. Senate,Sean Braddy,IND,720144,0,0,53,53,
Tulsa,State Senate,Dan Newberry,REP,720144,0,0,662,662,37
Tulsa,State Senate,Lloyd Snow,DEM,720144,0,0,562,562,37
Tulsa,State Senate,Shawn Ketcher,IND,720144,0,0,75,75,37
Tulsa,President,Donald Trump,REP,720145,0,0,840,840,
Tulsa,President,Gary Johnson,LIB,720145,0,0,62,62,
Tulsa,President,Hillary Clinton,DEM,720145,0,0,271,271,
Tulsa,U.S. Senate,James Lankford,REP,720145,0,0,900,900,
Tulsa,U.S. Senate,Robert Murphy,LIB,720145,0,0,28,28,
Tulsa,U.S. Senate,Mike Workman,DEM,720145,0,0,207,207,
Tulsa,U.S. Senate,Mark Beard,IND,720145,0,0,17,17,
Tulsa,U.S. Senate,Sean Braddy,IND,720145,0,0,19,19,
Tulsa,State Senate,Dan Newberry,REP,720145,0,0,818,818,37
Tulsa,State Senate,Lloyd Snow,DEM,720145,0,0,297,297,37
Tulsa,State Senate,Shawn Ketcher,IND,720145,0,0,52,52,37
Tulsa,President,Donald Trump,REP,720146,0,0,658,658,
Tulsa,President,Gary Johnson,LIB,720146,0,0,84,84,
Tulsa,President,Hillary Clinton,DEM,720146,0,0,301,301,
Tulsa,U.S. Senate,James Lankford,REP,720146,0,0,704,704,
Tulsa,U.S. Senate,Robert Murphy,LIB,720146,0,0,43,43,
Tulsa,U.S. Senate,Mike Workman,DEM,720146,0,0,239,239,
Tulsa,U.S. Senate,Mark Beard,IND,720146,0,0,19,19,
Tulsa,U.S. Senate,Sean Braddy,IND,720146,0,0,42,42,
Tulsa,State Senate,Dan Newberry,REP,720146,0,0,610,610,37
Tulsa,State Senate,Lloyd Snow,DEM,720146,0,0,383,383,37
Tulsa,State Senate,Shawn Ketcher,IND,720146,0,0,49,49,37
Tulsa,President,Donald Trump,REP,720147,0,0,114,114,
Tulsa,President,Gary Johnson,LIB,720147,0,0,22,22,
Tulsa,President,Hillary Clinton,DEM,720147,0,0,183,183,
Tulsa,U.S. Senate,James Lankford,REP,720147,0,0,106,106,
Tulsa,U.S. Senate,Robert Murphy,LIB,720147,0,0,15,15,
Tulsa,U.S. Senate,Mike Workman,DEM,720147,0,0,155,155,
Tulsa,U.S. Senate,Mark Beard,IND,720147,0,0,11,11,
Tulsa,U.S. Senate,Sean Braddy,IND,720147,0,0,30,30,
Tulsa,State Senate,Dan Newberry,REP,720147,0,0,85,85,37
Tulsa,State Senate,Lloyd Snow,DEM,720147,0,0,192,192,37
Tulsa,State Senate,Shawn Ketcher,IND,720147,0,0,40,40,37
Tulsa,State House,Jadine Nollan,REP,720147,0,0,102,102,66
Tulsa,State House,Dianna Phillips,DEM,720147,0,0,212,212,66
Tulsa,President,Donald Trump,REP,720148,0,0,354,354,
Tulsa,President,Gary Johnson,LIB,720148,0,0,41,41,
Tulsa,President,Hillary Clinton,DEM,720148,0,0,203,203,
Tulsa,U.S. Senate,James Lankford,REP,720148,0,0,350,350,
Tulsa,U.S. Senate,Robert Murphy,LIB,720148,0,0,15,15,
Tulsa,U.S. Senate,Mike Workman,DEM,720148,0,0,193,193,
Tulsa,U.S. Senate,Mark Beard,IND,720148,0,0,25,25,
Tulsa,U.S. Senate,Sean Braddy,IND,720148,0,0,15,15,
Tulsa,State Senate,Dan Newberry,REP,720148,0,0,296,296,37
Tulsa,State Senate,Lloyd Snow,DEM,720148,0,0,259,259,37
Tulsa,State Senate,Shawn Ketcher,IND,720148,0,0,40,40,37
Tulsa,State House,Jadine Nollan,REP,720148,0,0,362,362,66
Tulsa,State House,Dianna Phillips,DEM,720148,0,0,233,233,66
Tulsa,President,Donald Trump,REP,720149,0,0,318,318,
Tulsa,President,Gary Johnson,LIB,720149,0,0,39,39,
Tulsa,President,Hillary Clinton,DEM,720149,0,0,171,171,
Tulsa,U.S. Senate,James Lankford,REP,720149,0,0,306,306,
Tulsa,U.S. Senate,Robert Murphy,LIB,720149,0,0,30,30,
Tulsa,U.S. Senate,Mike Workman,DEM,720149,0,0,151,151,
Tulsa,U.S. Senate,Mark Beard,IND,720149,0,0,24,24,
Tulsa,U.S. Senate,Sean Braddy,IND,720149,0,0,19,19,
Tulsa,State Senate,Dan Newberry,REP,720149,0,0,233,233,37
Tulsa,State Senate,Lloyd Snow,DEM,720149,0,0,242,242,37
Tulsa,State Senate,Shawn Ketcher,IND,720149,0,0,54,54,37
Tulsa,State House,Jadine Nollan,REP,720149,0,0,299,299,66
Tulsa,State House,Dianna Phillips,DEM,720149,0,0,219,219,66
Tulsa,President,Donald Trump,REP,720150,0,0,1369,1369,
Tulsa,President,Gary Johnson,LIB,720150,0,0,84,84,
Tulsa,President,Hillary Clinton,DEM,720150,0,0,411,411,
Tulsa,U.S. Senate,James Lankford,REP,720150,0,0,1473,1473,
Tulsa,U.S. Senate,Robert Murphy,LIB,720150,0,0,39,39,
Tulsa,U.S. Senate,Mike Workman,DEM,720150,0,0,310,310,
Tulsa,U.S. Senate,Mark Beard,IND,720150,0,0,20,20,
Tulsa,U.S. Senate,Sean Braddy,IND,720150,0,0,26,26,
Tulsa,State House,Dan Kirby,REP,720150,0,0,1378,1378,75
Tulsa,State House,Karen Gaddis,DEM,720150,0,0,471,471,75
Tulsa,President,Donald Trump,REP,720151,0,0,234,234,
Tulsa,President,Gary Johnson,LIB,720151,0,0,33,33,
Tulsa,President,Hillary Clinton,DEM,720151,0,0,131,131,
Tulsa,U.S. Senate,James Lankford,REP,720151,0,0,258,258,
Tulsa,U.S. Senate,Robert Murphy,LIB,720151,0,0,12,12,
Tulsa,U.S. Senate,Mike Workman,DEM,720151,0,0,108,108,
Tulsa,U.S. Senate,Mark Beard,IND,720151,0,0,6,6,
Tulsa,U.S. Senate,Sean Braddy,IND,720151,0,0,10,10,
Tulsa,State Senate,Nathan Dahm,REP,720151,0,0,239,239,33
Tulsa,State Senate,Kimberly Fobbs,DEM,720151,0,0,151,151,33
Tulsa,State House,Weldon Watson,REP,720151,0,0,256,256,79
Tulsa,State House,Teresa Marler,IND,720151,0,0,97,97,79
Tulsa,President,Donald Trump,REP,720152,0,0,764,764,
Tulsa,President,Gary Johnson,LIB,720152,0,0,81,81,
Tulsa,President,Hillary Clinton,DEM,720152,0,0,285,285,
Tulsa,U.S. Senate,James Lankford,REP,720152,0,0,829,829,
Tulsa,U.S. Senate,Robert Murphy,LIB,720152,0,0,32,32,
Tulsa,U.S. Senate,Mike Workman,DEM,720152,0,0,234,234,
Tulsa,U.S. Senate,Mark Beard,IND,720152,0,0,10,10,
Tulsa,U.S. Senate,Sean Braddy,IND,720152,0,0,23,23,
Tulsa,State House,Dan Kirby,REP,720152,0,0,781,781,75
Tulsa,State House,Karen Gaddis,DEM,720152,0,0,342,342,75
Tulsa,President,Donald Trump,REP,720153,0,0,703,703,
Tulsa,President,Gary Johnson,LIB,720153,0,0,64,64,
Tulsa,President,Hillary Clinton,DEM,720153,0,0,323,323,
Tulsa,U.S. Senate,James Lankford,REP,720153,0,0,767,767,
Tulsa,U.S. Senate,Robert Murphy,LIB,720153,0,0,31,31,
Tulsa,U.S. Senate,Mike Workman,DEM,720153,0,0,256,256,
Tulsa,U.S. Senate,Mark Beard,IND,720153,0,0,14,14,
Tulsa,U.S. Senate,Sean Braddy,IND,720153,0,0,25,25,
Tulsa,State Senate,Joe Newhouse,REP,720153,0,0,760,760,25
Tulsa,State Senate,Robert Founds,DEM,720153,0,0,320,320,25
Tulsa,State House,Scott Mceachin,REP,720153,0,0,704,704,67
Tulsa,State House,Zac Davis,LIB,720153,0,0,57,57,67
Tulsa,State House,Lori Decter Wright,DEM,720153,0,0,323,323,67
Tulsa,President,Donald Trump,REP,720154,0,0,872,872,
Tulsa,President,Gary Johnson,LIB,720154,0,0,78,78,
Tulsa,President,Hillary Clinton,DEM,720154,0,0,378,378,
Tulsa,U.S. Senate,James Lankford,REP,720154,0,0,914,914,
Tulsa,U.S. Senate,Robert Murphy,LIB,720154,0,0,39,39,
Tulsa,U.S. Senate,Mike Workman,DEM,720154,0,0,303,303,
Tulsa,U.S. Senate,Mark Beard,IND,720154,0,0,26,26,
Tulsa,U.S. Senate,Sean Braddy,IND,720154,0,0,38,38,
Tulsa,State Senate,Joe Newhouse,REP,720154,0,0,950,950,25
Tulsa,State Senate,Robert Founds,DEM,720154,0,0,360,360,25
Tulsa,State House,Scott Mceachin,REP,720154,0,0,873,873,67
Tulsa,State House,Zac Davis,LIB,720154,0,0,74,74,67
Tulsa,State House,Lori Decter Wright,DEM,720154,0,0,358,358,67
Tulsa,President,Donald Trump,REP,720155,0,0,1188,1188,
Tulsa,President,Gary Johnson,LIB,720155,0,0,94,94,
Tulsa,President,Hillary Clinton,DEM,720155,0,0,365,365,
Tulsa,U.S. Senate,James Lankford,REP,720155,0,0,1350,1350,
Tulsa,U.S. Senate,Robert Murphy,LIB,720155,0,0,44,44,
Tulsa,U.S. Senate,Mike Workman,DEM,720155,0,0,247,247,
Tulsa,U.S. Senate,Mark Beard,IND,720155,0,0,16,16,
Tulsa,U.S. Senate,Sean Braddy,IND,720155,0,0,12,12,
Tulsa,State Senate,Joe Newhouse,REP,720155,0,0,1364,1364,25
Tulsa,State Senate,Robert Founds,DEM,720155,0,0,302,302,25
Tulsa,State House,Scott Mceachin,REP,720155,0,0,1300,1300,67
Tulsa,State House,Zac Davis,LIB,720155,0,0,61,61,67
Tulsa,State House,Lori Decter Wright,DEM,720155,0,0,300,300,67
Tulsa,President,Donald Trump,REP,720156,0,0,217,217,
Tulsa,President,Gary Johnson,LIB,720156,0,0,36,36,
Tulsa,President,Hillary Clinton,DEM,720156,0,0,185,185,
Tulsa,U.S. Senate,James Lankford,REP,720156,0,0,240,240,
Tulsa,U.S. Senate,Robert Murphy,LIB,720156,0,0,26,26,
Tulsa,U.S. Senate,Mike Workman,DEM,720156,0,0,148,148,
Tulsa,U.S. Senate,Mark Beard,IND,720156,0,0,14,14,
Tulsa,U.S. Senate,Sean Braddy,IND,720156,0,0,7,7,
Tulsa,State Senate,Nathan Dahm,REP,720156,0,0,239,239,33
Tulsa,State Senate,Kimberly Fobbs,DEM,720156,0,0,192,192,33
Tulsa,State House,Weldon Watson,REP,720156,0,0,230,230,79
Tulsa,State House,Teresa Marler,IND,720156,0,0,167,167,79
Tulsa,President,Donald Trump,REP,720157,0,0,1144,1144,
Tulsa,President,Gary Johnson,LIB,720157,0,0,98,98,
Tulsa,President,Hillary Clinton,DEM,720157,0,0,346,346,
Tulsa,U.S. Senate,James Lankford,REP,720157,0,0,1253,1253,
Tulsa,U.S. Senate,Robert Murphy,LIB,720157,0,0,43,43,
Tulsa,U.S. Senate,Mike Workman,DEM,720157,0,0,259,259,
Tulsa,U.S. Senate,Mark Beard,IND,720157,0,0,23,23,
Tulsa,U.S. Senate,Sean Braddy,IND,720157,0,0,21,21,
Tulsa,State Senate,Gary Stanislawski,REP,720157,0,0,1244,1244,35
Tulsa,State Senate,Frank Grove,LIB,720157,0,0,267,267,35
Tulsa,State House,Chuck Strohm,REP,720157,0,0,1183,1183,69
Tulsa,State House,Paul Sullivan,DEM,720157,0,0,378,378,69
Tulsa,President,Donald Trump,REP,720158,0,0,643,643,
Tulsa,President,Gary Johnson,LIB,720158,0,0,59,59,
Tulsa,President,Hillary Clinton,DEM,720158,0,0,276,276,
Tulsa,U.S. Senate,James Lankford,REP,720158,0,0,713,713,
Tulsa,U.S. Senate,Robert Murphy,LIB,720158,0,0,28,28,
Tulsa,U.S. Senate,Mike Workman,DEM,720158,0,0,217,217,
Tulsa,U.S. Senate,Mark Beard,IND,720158,0,0,9,9,
Tulsa,U.S. Senate,Sean Braddy,IND,720158,0,0,19,19,
Tulsa,State Senate,Joe Newhouse,REP,720158,0,0,713,713,25
Tulsa,State Senate,Robert Founds,DEM,720158,0,0,261,261,25
Tulsa,State House,Scott Mceachin,REP,720158,0,0,653,653,67
Tulsa,State House,Zac Davis,LIB,720158,0,0,49,49,67
Tulsa,State House,Lori Decter Wright,DEM,720158,0,0,268,268,67
Tulsa,President,Donald Trump,REP,720159,0,0,666,666,
Tulsa,President,Gary Johnson,LIB,720159,0,0,64,64,
Tulsa,President,Hillary Clinton,DEM,720159,0,0,318,318,
Tulsa,U.S. Senate,James Lankford,REP,720159,0,0,712,712,
Tulsa,U.S. Senate,Robert Murphy,LIB,720159,0,0,28,28,
Tulsa,U.S. Senate,Mike Workman,DEM,720159,0,0,266,266,
Tulsa,U.S. Senate,Mark Beard,IND,720159,0,0,16,16,
Tulsa,U.S. Senate,Sean Braddy,IND,720159,0,0,19,19,
Tulsa,State Senate,Joe Newhouse,REP,720159,0,0,733,733,25
Tulsa,State Senate,Robert Founds,DEM,720159,0,0,300,300,25
Tulsa,State House,Scott Mceachin,REP,720159,0,0,693,693,67
Tulsa,State House,Zac Davis,LIB,720159,0,0,46,46,67
Tulsa,State House,Lori Decter Wright,DEM,720159,0,0,295,295,67
Tulsa,President,Donald Trump,REP,720160,0,0,591,591,
Tulsa,President,Gary Johnson,LIB,720160,0,0,94,94,
Tulsa,President,Hillary Clinton,DEM,720160,0,0,578,578,
Tulsa,U.S. Senate,James Lankford,REP,720160,0,0,691,691,
Tulsa,U.S. Senate,Robert Murphy,LIB,720160,0,0,49,49,
Tulsa,U.S. Senate,Mike Workman,DEM,720160,0,0,466,466,
Tulsa,U.S. Senate,Mark Beard,IND,720160,0,0,24,24,
Tulsa,U.S. Senate,Sean Braddy,IND,720160,0,0,41,41,
Tulsa,State Senate,Dave Rader,REP,720160,0,0,641,641,39
Tulsa,State Senate,John Waldron,DEM,720160,0,0,634,634,39
Tulsa,State House,Carol Bush,REP,720160,0,0,677,677,70
Tulsa,State House,Tamara Morton,LIB,720160,0,0,84,84,70
Tulsa,State House,Joe Jennings,DEM,720160,0,0,497,497,70
Tulsa,President,Donald Trump,REP,720161,0,0,201,201,
Tulsa,President,Gary Johnson,LIB,720161,0,0,42,42,
Tulsa,President,Hillary Clinton,DEM,720161,0,0,367,367,
Tulsa,U.S. Senate,James Lankford,REP,720161,0,0,226,226,
Tulsa,U.S. Senate,Robert Murphy,LIB,720161,0,0,38,38,
Tulsa,U.S. Senate,Mike Workman,DEM,720161,0,0,291,291,
Tulsa,U.S. Senate,Mark Beard,IND,720161,0,0,17,17,
Tulsa,U.S. Senate,Sean Braddy,IND,720161,0,0,31,31,
Tulsa,State Senate,Gary Stanislawski,REP,720161,0,0,232,232,35
Tulsa,State Senate,Frank Grove,LIB,720161,0,0,300,300,35
Tulsa,State House,Katie Henke,REP,720161,0,0,244,244,71
Tulsa,State House,Millie Hardesty York,DEM,720161,0,0,352,352,71
Tulsa,President,Donald Trump,REP,720162,0,0,128,128,
Tulsa,President,Gary Johnson,LIB,720162,0,0,12,12,
Tulsa,President,Hillary Clinton,DEM,720162,0,0,28,28,
Tulsa,U.S. Senate,James Lankford,REP,720162,0,0,124,124,
Tulsa,U.S. Senate,Robert Murphy,LIB,720162,0,0,2,2,
Tulsa,U.S. Senate,Mike Workman,DEM,720162,0,0,26,26,
Tulsa,U.S. Senate,Mark Beard,IND,720162,0,0,6,6,
Tulsa,U.S. Senate,Sean Braddy,IND,720162,0,0,7,7,
Tulsa,State Senate,Gary Stanislawski,REP,720162,0,0,130,130,35
Tulsa,State Senate,Frank Grove,LIB,720162,0,0,27,27,35
Tulsa,State House,Chuck Strohm,REP,720162,0,0,130,130,69
Tulsa,State House,Paul Sullivan,DEM,720162,0,0,34,34,69
Tulsa,President,Donald Trump,REP,720163,0,0,508,508,
Tulsa,President,Gary Johnson,LIB,720163,0,0,57,57,
Tulsa,President,Hillary Clinton,DEM,720163,0,0,312,312,
Tulsa,U.S. Senate,James Lankford,REP,720163,0,0,582,582,
Tulsa,U.S. Senate,Robert Murphy,LIB,720163,0,0,27,27,
Tulsa,U.S. Senate,Mike Workman,DEM,720163,0,0,242,242,
Tulsa,U.S. Senate,Mark Beard,IND,720163,0,0,13,13,
Tulsa,U.S. Senate,Sean Braddy,IND,720163,0,0,16,16,
Tulsa,State Senate,Gary Stanislawski,REP,720163,0,0,584,584,35
Tulsa,State Senate,Frank Grove,LIB,720163,0,0,207,207,35
Tulsa,State House,Carol Bush,REP,720163,0,0,551,551,70
Tulsa,State House,Tamara Morton,LIB,720163,0,0,42,42,70
Tulsa,State House,Joe Jennings,DEM,720163,0,0,269,269,70
Tulsa,President,Donald Trump,REP,720164,0,0,220,220,
Tulsa,President,Gary Johnson,LIB,720164,0,0,19,19,
Tulsa,President,Hillary Clinton,DEM,720164,0,0,121,121,
Tulsa,U.S. Senate,James Lankford,REP,720164,0,0,250,250,
Tulsa,U.S. Senate,Robert Murphy,LIB,720164,0,0,6,6,
Tulsa,U.S. Senate,Mike Workman,DEM,720164,0,0,97,97,
Tulsa,U.S. Senate,Mark Beard,IND,720164,0,0,4,4,
Tulsa,U.S. Senate,Sean Braddy,IND,720164,0,0,7,7,
Tulsa,State Senate,Dave Rader,REP,720164,0,0,218,218,39
Tulsa,State Senate,John Waldron,DEM,720164,0,0,143,143,39
Tulsa,State House,Carol Bush,REP,720164,0,0,244,244,70
Tulsa,State House,Tamara Morton,LIB,720164,0,0,8,8,70
Tulsa,State House,Joe Jennings,DEM,720164,0,0,109,109,70
Tulsa,President,Donald Trump,REP,720165,0,0,303,303,
Tulsa,President,Gary Johnson,LIB,720165,0,0,49,49,
Tulsa,President,Hillary Clinton,DEM,720165,0,0,120,120,
Tulsa,U.S. Senate,James Lankford,REP,720165,0,0,336,336,
Tulsa,U.S. Senate,Robert Murphy,LIB,720165,0,0,25,25,
Tulsa,U.S. Senate,Mike Workman,DEM,720165,0,0,96,96,
Tulsa,U.S. Senate,Mark Beard,IND,720165,0,0,8,8,
Tulsa,U.S. Senate,Sean Braddy,IND,720165,0,0,11,11,
Tulsa,State Senate,Dave Rader,REP,720165,0,0,345,345,39
Tulsa,State Senate,John Waldron,DEM,720165,0,0,126,126,39
Tulsa,State House,Carol Bush,REP,720165,0,0,338,338,70
Tulsa,State House,Tamara Morton,LIB,720165,0,0,34,34,70
Tulsa,State House,Joe Jennings,DEM,720165,0,0,94,94,70
Tulsa,President,Donald Trump,REP,720166,0,0,791,791,
Tulsa,President,Gary Johnson,LIB,720166,0,0,80,80,
Tulsa,President,Hillary Clinton,DEM,720166,0,0,333,333,
Tulsa,U.S. Senate,James Lankford,REP,720166,0,0,865,865,
Tulsa,U.S. Senate,Robert Murphy,LIB,720166,0,0,34,34,
Tulsa,U.S. Senate,Mike Workman,DEM,720166,0,0,266,266,
Tulsa,U.S. Senate,Mark Beard,IND,720166,0,0,17,17,
Tulsa,U.S. Senate,Sean Braddy,IND,720166,0,0,25,25,
Tulsa,State Senate,Dave Rader,REP,720166,0,0,863,863,39
Tulsa,State Senate,John Waldron,DEM,720166,0,0,342,342,39
Tulsa,State House,Scott Mceachin,REP,720166,0,0,808,808,67
Tulsa,State House,Zac Davis,LIB,720166,0,0,56,56,67
Tulsa,State House,Lori Decter Wright,DEM,720166,0,0,327,327,67
Tulsa,President,Donald Trump,REP,720167,0,0,808,808,
Tulsa,President,Gary Johnson,LIB,720167,0,0,49,49,
Tulsa,President,Hillary Clinton,DEM,720167,0,0,211,211,
Tulsa,U.S. Senate,James Lankford,REP,720167,0,0,883,883,
Tulsa,U.S. Senate,Robert Murphy,LIB,720167,0,0,21,21,
Tulsa,U.S. Senate,Mike Workman,DEM,720167,0,0,158,158,
Tulsa,U.S. Senate,Mark Beard,IND,720167,0,0,9,9,
Tulsa,U.S. Senate,Sean Braddy,IND,720167,0,0,11,11,
Tulsa,State Senate,Joe Newhouse,REP,720167,0,0,867,867,25
Tulsa,State Senate,Robert Founds,DEM,720167,0,0,206,206,25
Tulsa,State House,Chuck Strohm,REP,720167,0,0,818,818,69
Tulsa,State House,Paul Sullivan,DEM,720167,0,0,246,246,69
Tulsa,President,Donald Trump,REP,720168,0,0,530,530,
Tulsa,President,Gary Johnson,LIB,720168,0,0,44,44,
Tulsa,President,Hillary Clinton,DEM,720168,0,0,296,296,
Tulsa,U.S. Senate,James Lankford,REP,720168,0,0,588,588,
Tulsa,U.S. Senate,Robert Murphy,LIB,720168,0,0,31,31,
Tulsa,U.S. Senate,Mike Workman,DEM,720168,0,0,224,224,
Tulsa,U.S. Senate,Mark Beard,IND,720168,0,0,18,18,
Tulsa,U.S. Senate,Sean Braddy,IND,720168,0,0,16,16,
Tulsa,State Senate,Joe Newhouse,REP,720168,0,0,605,605,25
Tulsa,State Senate,Robert Founds,DEM,720168,0,0,268,268,25
Tulsa,State House,Weldon Watson,REP,720168,0,0,572,572,79
Tulsa,State House,Teresa Marler,IND,720168,0,0,243,243,79
Tulsa,President,Donald Trump,REP,720169,0,0,419,419,
Tulsa,President,Gary Johnson,LIB,720169,0,0,46,46,
Tulsa,President,Hillary Clinton,DEM,720169,0,0,338,338,
Tulsa,U.S. Senate,James Lankford,REP,720169,0,0,472,472,
Tulsa,U.S. Senate,Robert Murphy,LIB,720169,0,0,22,22,
Tulsa,U.S. Senate,Mike Workman,DEM,720169,0,0,257,257,
Tulsa,U.S. Senate,Mark Beard,IND,720169,0,0,17,17,
Tulsa,U.S. Senate,Sean Braddy,IND,720169,0,0,28,28,
Tulsa,State Senate,Nathan Dahm,REP,720169,0,0,446,446,33
Tulsa,State Senate,Kimberly Fobbs,DEM,720169,0,0,338,338,33
Tulsa,State House,Weldon Watson,REP,720169,0,0,460,460,79
Tulsa,State House,Teresa Marler,IND,720169,0,0,253,253,79
Tulsa,President,Donald Trump,REP,720170,0,0,518,518,
Tulsa,President,Gary Johnson,LIB,720170,0,0,30,30,
Tulsa,President,Hillary Clinton,DEM,720170,0,0,119,119,
Tulsa,U.S. Senate,James Lankford,REP,720170,0,0,549,549,
Tulsa,U.S. Senate,Robert Murphy,LIB,720170,0,0,19,19,
Tulsa,U.S. Senate,Mike Workman,DEM,720170,0,0,84,84,
Tulsa,U.S. Senate,Mark Beard,IND,720170,0,0,9,9,
Tulsa,U.S. Senate,Sean Braddy,IND,720170,0,0,3,3,
Tulsa,State Senate,Joe Newhouse,REP,720170,0,0,554,554,25
Tulsa,State Senate,Robert Founds,DEM,720170,0,0,106,106,25
Tulsa,State House,Scott Mceachin,REP,720170,0,0,519,519,67
Tulsa,State House,Zac Davis,LIB,720170,0,0,25,25,67
Tulsa,State House,Lori Decter Wright,DEM,720170,0,0,113,113,67
Tulsa,President,Donald Trump,REP,720171,0,0,410,410,
Tulsa,President,Gary Johnson,LIB,720171,0,0,60,60,
Tulsa,President,Hillary Clinton,DEM,720171,0,0,218,218,
Tulsa,U.S. Senate,James Lankford,REP,720171,0,0,456,456,
Tulsa,U.S. Senate,Robert Murphy,LIB,720171,0,0,29,29,
Tulsa,U.S. Senate,Mike Workman,DEM,720171,0,0,183,183,
Tulsa,U.S. Senate,Mark Beard,IND,720171,0,0,11,11,
Tulsa,U.S. Senate,Sean Braddy,IND,720171,0,0,12,12,
Tulsa,State Senate,Gary Stanislawski,REP,720171,0,0,454,454,35
Tulsa,State Senate,Frank Grove,LIB,720171,0,0,185,185,35
Tulsa,State House,Chuck Strohm,REP,720171,0,0,437,437,69
Tulsa,State House,Paul Sullivan,DEM,720171,0,0,241,241,69
Tulsa,President,Donald Trump,REP,720172,0,0,535,535,
Tulsa,President,Gary Johnson,LIB,720172,0,0,59,59,
Tulsa,President,Hillary Clinton,DEM,720172,0,0,324,324,
Tulsa,U.S. Senate,James Lankford,REP,720172,0,0,588,588,
Tulsa,U.S. Senate,Robert Murphy,LIB,720172,0,0,31,31,
Tulsa,U.S. Senate,Mike Workman,DEM,720172,0,0,262,262,
Tulsa,U.S. Senate,Mark Beard,IND,720172,0,0,12,12,
Tulsa,U.S. Senate,Sean Braddy,IND,720172,0,0,20,20,
Tulsa,State Senate,Nathan Dahm,REP,720172,0,0,562,562,33
Tulsa,State Senate,Kimberly Fobbs,DEM,720172,0,0,345,345,33
Tulsa,State House,Weldon Watson,REP,720172,0,0,572,572,79
Tulsa,State House,Teresa Marler,IND,720172,0,0,260,260,79
Tulsa,President,Donald Trump,REP,720173,0,0,666,666,
Tulsa,President,Gary Johnson,LIB,720173,0,0,54,54,
Tulsa,President,Hillary Clinton,DEM,720173,0,0,325,325,
Tulsa,U.S. Senate,James Lankford,REP,720173,0,0,744,744,
Tulsa,U.S. Senate,Robert Murphy,LIB,720173,0,0,27,27,
Tulsa,U.S. Senate,Mike Workman,DEM,720173,0,0,256,256,
Tulsa,U.S. Senate,Mark Beard,IND,720173,0,0,13,13,
Tulsa,U.S. Senate,Sean Braddy,IND,720173,0,0,13,13,
Tulsa,State Senate,Gary Stanislawski,REP,720173,0,0,752,752,35
Tulsa,State Senate,Frank Grove,LIB,720173,0,0,217,217,35
Tulsa,State House,Chuck Strohm,REP,720173,0,0,690,690,69
Tulsa,State House,Paul Sullivan,DEM,720173,0,0,348,348,69
Tulsa,President,Donald Trump,REP,720174,0,0,0,0,
Tulsa,President,Gary Johnson,LIB,720174,0,0,0,0,
Tulsa,President,Hillary Clinton,DEM,720174,0,0,0,0,
Tulsa,U.S. Senate,James Lankford,REP,720174,0,0,0,0,
Tulsa,U.S. Senate,Robert Murphy,LIB,720174,0,0,0,0,
Tulsa,U.S. Senate,Mike Workman,DEM,720174,0,0,0,0,
Tulsa,U.S. Senate,Mark Beard,IND,720174,0,0,0,0,
Tulsa,U.S. Senate,Sean Braddy,IND,720174,0,0,0,0,
Tulsa,President,Donald Trump,REP,720175,0,0,0,0,
Tulsa,President,Gary Johnson,LIB,720175,0,0,0,0,
Tulsa,President,Hillary Clinton,DEM,720175,0,0,0,0,
Tulsa,U.S. Senate,James Lankford,REP,720175,0,0,0,0,
Tulsa,U.S. Senate,Robert Murphy,LIB,720175,0,0,0,0,
Tulsa,U.S. Senate,Mike Workman,DEM,720175,0,0,0,0,
Tulsa,U.S. Senate,Mark Beard,IND,720175,0,0,0,0,
Tulsa,U.S. Senate,Sean Braddy,IND,720175,0,0,0,0,
Tulsa,President,Donald Trump,REP,720176,0,0,0,0,
Tulsa,President,Gary Johnson,LIB,720176,0,0,0,0,
Tulsa,President,Hillary Clinton,DEM,720176,0,0,0,0,
Tulsa,U.S. Senate,James Lankford,REP,720176,0,0,0,0,
Tulsa,U.S. Senate,Robert Murphy,LIB,720176,0,0,0,0,
Tulsa,U.S. Senate,Mike Workman,DEM,720176,0,0,0,0,
Tulsa,U.S. Senate,Mark Beard,IND,720176,0,0,0,0,
Tulsa,U.S. Senate,Sean Braddy,IND,720176,0,0,0,0,
Tulsa,State Senate,Joe Newhouse,REP,720176,0,0,0,0,25
Tulsa,State Senate,Robert Founds,DEM,720176,0,0,0,0,25
Tulsa,State House,Molly Mckay,REP,720176,0,0,0,0,78
Tulsa,State House,Eugene Bell,LIB,720176,0,0,0,0,78
Tulsa,State House,Meloyde Blancett,DEM,720176,0,0,0,0,78
Tulsa,President,Donald Trump,REP,720351,0,0,1395,1395,
Tulsa,President,Gary Johnson,LIB,720351,0,0,96,96,
Tulsa,President,Hillary Clinton,DEM,720351,0,0,377,377,
Tulsa,U.S. Senate,James Lankford,REP,720351,0,0,1430,1430,
Tulsa,U.S. Senate,Robert Murphy,LIB,720351,0,0,48,48,
Tulsa,U.S. Senate,Mike Workman,DEM,720351,0,0,303,303,
Tulsa,U.S. Senate,Mark Beard,IND,720351,0,0,29,29,
Tulsa,U.S. Senate,Sean Braddy,IND,720351,0,0,43,43,
Tulsa,State Senate,Joe Newhouse,REP,720351,0,0,1424,1424,25
Tulsa,State Senate,Robert Founds,DEM,720351,0,0,421,421,25
Tulsa,State House,Chuck Strohm,REP,720351,0,0,1293,1293,69
Tulsa,State House,Paul Sullivan,DEM,720351,0,0,528,528,69
Tulsa,President,Donald Trump,REP,720352,0,0,743,743,
Tulsa,President,Gary Johnson,LIB,720352,0,0,45,45,
Tulsa,President,Hillary Clinton,DEM,720352,0,0,161,161,
Tulsa,U.S. Senate,James Lankford,REP,720352,0,0,734,734,
Tulsa,U.S. Senate,Robert Murphy,LIB,720352,0,0,35,35,
Tulsa,U.S. Senate,Mike Workman,DEM,720352,0,0,135,135,
Tulsa,U.S. Senate,Mark Beard,IND,720352,0,0,20,20,
Tulsa,U.S. Senate,Sean Braddy,IND,720352,0,0,20,20,
Tulsa,State Senate,Nathan Dahm,REP,720352,0,0,717,717,33
Tulsa,State Senate,Kimberly Fobbs,DEM,720352,0,0,215,215,33
Tulsa,President,Donald Trump,REP,720353,0,0,138,138,
Tulsa,President,Gary Johnson,LIB,720353,0,0,11,11,
Tulsa,President,Hillary Clinton,DEM,720353,0,0,22,22,
Tulsa,U.S. Senate,James Lankford,REP,720353,0,0,140,140,
Tulsa,U.S. Senate,Robert Murphy,LIB,720353,0,0,6,6,
Tulsa,U.S. Senate,Mike Workman,DEM,720353,0,0,20,20,
Tulsa,U.S. Senate,Mark Beard,IND,720353,0,0,4,4,
Tulsa,U.S. Senate,Sean Braddy,IND,720353,0,0,4,4,
Tulsa,State Senate,Nathan Dahm,REP,720353,0,0,131,131,33
Tulsa,State Senate,Kimberly Fobbs,DEM,720353,0,0,38,38,33
Tulsa,State House,Scott Fetgatter,REP,720353,0,0,135,135,16
Tulsa,State House,Ronnie Kell,DEM,720353,0,0,32,32,16
Tulsa,President,Donald Trump,REP,720354,0,0,135,135,
Tulsa,President,Gary Johnson,LIB,720354,0,0,6,6,
Tulsa,President,Hillary Clinton,DEM,720354,0,0,29,29,
Tulsa,U.S. Senate,James Lankford,REP,720354,0,0,128,128,
Tulsa,U.S. Senate,Robert Murphy,LIB,720354,0,0,5,5,
Tulsa,U.S. Senate,Mike Workman,DEM,720354,0,0,25,25,
Tulsa,U.S. Senate,Mark Beard,IND,720354,0,0,4,4,
Tulsa,U.S. Senate,Sean Braddy,IND,720354,0,0,5,5,
Tulsa,State Senate,Nathan Dahm,REP,720354,0,0,129,129,33
Tulsa,State Senate,Kimberly Fobbs,DEM,720354,0,0,38,38,33
Tulsa,State House,Mike Ritze,REP,720354,0,0,128,128,80
Tulsa,State House,Tom Bates,DEM,720354,0,0,40,40,80
Tulsa,President,Donald Trump,REP,720355,0,0,168,168,
Tulsa,President,Gary Johnson,LIB,720355,0,0,7,7,
Tulsa,President,Hillary Clinton,DEM,720355,0,0,61,61,
Tulsa,U.S. Senate,James Lankford,REP,720355,0,0,164,164,
Tulsa,U.S. Senate,Robert Murphy,LIB,720355,0,0,7,7,
Tulsa,U.S. Senate,Mike Workman,DEM,720355,0,0,56,56,
Tulsa,U.S. Senate,Mark Beard,IND,720355,0,0,4,4,
Tulsa,U.S. Senate,Sean Braddy,IND,720355,0,0,4,4,
Tulsa,State Senate,Joe Newhouse,REP,720355,0,0,167,167,25
Tulsa,State Senate,Robert Founds,DEM,720355,0,0,68,68,25
Tulsa,State House,Mike Ritze,REP,720355,0,0,157,157,80
Tulsa,State House,Tom Bates,DEM,720355,0,0,76,76,80
Tulsa,President,Donald Trump,REP,720356,0,0,224,224,
Tulsa,President,Gary Johnson,LIB,720356,0,0,16,16,
Tulsa,President,Hillary Clinton,DEM,720356,0,0,41,41,
Tulsa,U.S. Senate,James Lankford,REP,720356,0,0,235,235,
Tulsa,U.S. Senate,Robert Murphy,LIB,720356,0,0,12,12,
Tulsa,U.S. Senate,Mike Workman,DEM,720356,0,0,32,32,
Tulsa,U.S. Senate,Mark Beard,IND,720356,0,0,2,2,
Tulsa,U.S. Senate,Sean Braddy,IND,720356,0,0,1,1,
Tulsa,State Senate,Joe Newhouse,REP,720356,0,0,231,231,25
Tulsa,State Senate,Robert Founds,DEM,720356,0,0,51,51,25
Tulsa,President,Donald Trump,REP,720400,0,0,1204,1204,
Tulsa,President,Gary Johnson,LIB,720400,0,0,76,76,
Tulsa,President,Hillary Clinton,DEM,720400,0,0,311,311,
Tulsa,U.S. Senate,James Lankford,REP,720400,0,0,1279,1279,
Tulsa,U.S. Senate,Robert Murphy,LIB,720400,0,0,40,40,
Tulsa,U.S. Senate,Mike Workman,DEM,720400,0,0,216,216,
Tulsa,U.S. Senate,Mark Beard,IND,720400,0,0,25,25,
Tulsa,U.S. Senate,Sean Braddy,IND,720400,0,0,25,25,
Tulsa,State Senate,Joe Newhouse,REP,720400,0,0,1279,1279,25
Tulsa,State Senate,Robert Founds,DEM,720400,0,0,302,302,25
Tulsa,State House,Chuck Strohm,REP,720400,0,0,1212,1212,69
Tulsa,State House,Paul Sullivan,DEM,720400,0,0,358,358,69
Tulsa,President,Donald Trump,REP,720401,0,0,1085,1085,
Tulsa,President,Gary Johnson,LIB,720401,0,0,76,76,
Tulsa,President,Hillary Clinton,DEM,720401,0,0,308,308,
Tulsa,U.S. Senate,James Lankford,REP,720401,0,0,1163,1163,
Tulsa,U.S. Senate,Robert Murphy,LIB,720401,0,0,43,43,
Tulsa,U.S. Senate,Mike Workman,DEM,720401,0,0,221,221,
Tulsa,U.S. Senate,Mark Beard,IND,720401,0,0,27,27,
Tulsa,U.S. Senate,Sean Braddy,IND,720401,0,0,10,10,
Tulsa,State Senate,Joe Newhouse,REP,720401,0,0,1166,1166,25
Tulsa,State Senate,Robert Founds,DEM,720401,0,0,294,294,25
Tulsa,State House,Scott Mceachin,REP,720401,0,0,1109,1109,67
Tulsa,State House,Zac Davis,LIB,720401,0,0,56,56,67
Tulsa,State House,Lori Decter Wright,DEM,720401,0,0,293,293,67
Tulsa,President,Donald Trump,REP,720402,0,0,741,741,
Tulsa,President,Gary Johnson,LIB,720402,0,0,64,64,
Tulsa,President,Hillary Clinton,DEM,720402,0,0,187,187,
Tulsa,U.S. Senate,James Lankford,REP,720402,0,0,744,744,
Tulsa,U.S. Senate,Robert Murphy,LIB,720402,0,0,48,48,
Tulsa,U.S. Senate,Mike Workman,DEM,720402,0,0,153,153,
Tulsa,U.S. Senate,Mark Beard,IND,720402,0,0,27,27,
Tulsa,U.S. Senate,Sean Braddy,IND,720402,0,0,16,16,
Tulsa,State Senate,Joe Newhouse,REP,720402,0,0,764,764,25
Tulsa,State Senate,Robert Founds,DEM,720402,0,0,214,214,25
Tulsa,State House,Chuck Strohm,REP,720402,0,0,697,697,69
Tulsa,State House,Paul Sullivan,DEM,720402,0,0,266,266,69
Tulsa,President,Donald Trump,REP,720403,0,0,1424,1424,
Tulsa,President,Gary Johnson,LIB,720403,0,0,105,105,
Tulsa,President,Hillary Clinton,DEM,720403,0,0,423,423,
Tulsa,U.S. Senate,James Lankford,REP,720403,0,0,1422,1422,
Tulsa,U.S. Senate,Robert Murphy,LIB,720403,0,0,82,82,
Tulsa,U.S. Senate,Mike Workman,DEM,720403,0,0,361,361,
Tulsa,U.S. Senate,Mark Beard,IND,720403,0,0,39,39,
Tulsa,U.S. Senate,Sean Braddy,IND,720403,0,0,37,37,
Tulsa,State Senate,Nathan Dahm,REP,720403,0,0,1405,1405,33
Tulsa,State Senate,Kimberly Fobbs,DEM,720403,0,0,530,530,33
Tulsa,State House,Mike Ritze,REP,720403,0,0,1349,1349,80
Tulsa,State House,Tom Bates,DEM,720403,0,0,574,574,80
Tulsa,President,Donald Trump,REP,720404,0,0,775,775,
Tulsa,President,Gary Johnson,LIB,720404,0,0,37,37,
Tulsa,President,Hillary Clinton,DEM,720404,0,0,211,211,
Tulsa,U.S. Senate,James Lankford,REP,720404,0,0,815,815,
Tulsa,U.S. Senate,Robert Murphy,LIB,720404,0,0,17,17,
Tulsa,U.S. Senate,Mike Workman,DEM,720404,0,0,160,160,
Tulsa,U.S. Senate,Mark Beard,IND,720404,0,0,20,20,
Tulsa,U.S. Senate,Sean Braddy,IND,720404,0,0,7,7,
Tulsa,State Senate,Nathan Dahm,REP,720404,0,0,775,775,33
Tulsa,State Senate,Kimberly Fobbs,DEM,720404,0,0,239,239,33
Tulsa,State House,Mike Ritze,REP,720404,0,0,739,739,80
Tulsa,State House,Tom Bates,DEM,720404,0,0,279,279,80
Tulsa,President,Donald Trump,REP,720405,0,0,116,116,
Tulsa,President,Gary Johnson,LIB,720405,0,0,7,7,
Tulsa,President,Hillary Clinton,DEM,720405,0,0,34,34,
Tulsa,U.S. Senate,James Lankford,REP,720405,0,0,125,125,
Tulsa,U.S. Senate,Robert Murphy,LIB,720405,0,0,3,3,
Tulsa,U.S. Senate,Mike Workman,DEM,720405,0,0,23,23,
Tulsa,U.S. Senate,Mark Beard,IND,720405,0,0,1,1,
Tulsa,U.S. Senate,Sean Braddy,IND,720405,0,0,3,3,
Tulsa,State House,Mike Ritze,REP,720405,0,0,112,112,80
Tulsa,State House,Tom Bates,DEM,720405,0,0,43,43,80
Tulsa,President,Donald Trump,REP,720406,0,0,898,898,
Tulsa,President,Gary Johnson,LIB,720406,0,0,52,52,
Tulsa,President,Hillary Clinton,DEM,720406,0,0,244,244,
Tulsa,U.S. Senate,James Lankford,REP,720406,0,0,944,944,
Tulsa,U.S. Senate,Robert Murphy,LIB,720406,0,0,27,27,
Tulsa,U.S. Senate,Mike Workman,DEM,720406,0,0,191,191,
Tulsa,U.S. Senate,Mark Beard,IND,720406,0,0,11,11,
Tulsa,U.S. Senate,Sean Braddy,IND,720406,0,0,21,21,
Tulsa,State Senate,Joe Newhouse,REP,720406,0,0,931,931,25
Tulsa,State Senate,Robert Founds,DEM,720406,0,0,260,260,25
Tulsa,State House,Mike Ritze,REP,720406,0,0,837,837,80
Tulsa,State House,Tom Bates,DEM,720406,0,0,350,350,80
Tulsa,President,Donald Trump,REP,720407,0,0,1000,1000,
Tulsa,President,Gary Johnson,LIB,720407,0,0,67,67,
Tulsa,President,Hillary Clinton,DEM,720407,0,0,233,233,
Tulsa,U.S. Senate,James Lankford,REP,720407,0,0,1039,1039,
Tulsa,U.S. Senate,Robert Murphy,LIB,720407,0,0,36,36,
Tulsa,U.S. Senate,Mike Workman,DEM,720407,0,0,193,193,
Tulsa,U.S. Senate,Mark Beard,IND,720407,0,0,18,18,
Tulsa,U.S. Senate,Sean Braddy,IND,720407,0,0,20,20,
Tulsa,State Senate,Joe Newhouse,REP,720407,0,0,1041,1041,25
Tulsa,State Senate,Robert Founds,DEM,720407,0,0,251,251,25
Tulsa,State House,Mike Ritze,REP,720407,0,0,954,954,80
Tulsa,State House,Tom Bates,DEM,720407,0,0,337,337,80
Tulsa,President,Donald Trump,REP,720408,0,0,937,937,
Tulsa,President,Gary Johnson,LIB,720408,0,0,67,67,
Tulsa,President,Hillary Clinton,DEM,720408,0,0,253,253,
Tulsa,U.S. Senate,James Lankford,REP,720408,0,0,974,974,
Tulsa,U.S. Senate,Robert Murphy,LIB,720408,0,0,33,33,
Tulsa,U.S. Senate,Mike Workman,DEM,720408,0,0,196,196,
Tulsa,U.S. Senate,Mark Beard,IND,720408,0,0,24,24,
Tulsa,U.S. Senate,Sean Braddy,IND,720408,0,0,30,30,
Tulsa,State Senate,Nathan Dahm,REP,720408,0,0,922,922,33
Tulsa,State Senate,Kimberly Fobbs,DEM,720408,0,0,323,323,33
Tulsa,State House,Mike Ritze,REP,720408,0,0,872,872,80
Tulsa,State House,Tom Bates,DEM,720408,0,0,373,373,80
Tulsa,President,Donald Trump,REP,720409,0,0,920,920,
Tulsa,President,Gary Johnson,LIB,720409,0,0,88,88,
Tulsa,President,Hillary Clinton,DEM,720409,0,0,270,270,
Tulsa,U.S. Senate,James Lankford,REP,720409,0,0,973,973,
Tulsa,U.S. Senate,Robert Murphy,LIB,720409,0,0,55,55,
Tulsa,U.S. Senate,Mike Workman,DEM,720409,0,0,209,209,
Tulsa,U.S. Senate,Mark Beard,IND,720409,0,0,22,22,
Tulsa,U.S. Senate,Sean Braddy,IND,720409,0,0,22,22,
Tulsa,State Senate,Joe Newhouse,REP,720409,0,0,968,968,25
Tulsa,State Senate,Robert Founds,DEM,720409,0,0,296,296,25
Tulsa,State House,Mike Ritze,REP,720409,0,0,862,862,80
Tulsa,State House,Tom Bates,DEM,720409,0,0,402,402,80
Tulsa,President,Donald Trump,REP,720410,0,0,509,509,
Tulsa,President,Gary Johnson,LIB,720410,0,0,31,31,
Tulsa,President,Hillary Clinton,DEM,720410,0,0,111,111,
Tulsa,U.S. Senate,James Lankford,REP,720410,0,0,557,557,
Tulsa,U.S. Senate,Robert Murphy,LIB,720410,0,0,16,16,
Tulsa,U.S. Senate,Mike Workman,DEM,720410,0,0,81,81,
Tulsa,U.S. Senate,Mark Beard,IND,720410,0,0,6,6,
Tulsa,U.S. Senate,Sean Braddy,IND,720410,0,0,5,5,
Tulsa,State Senate,Joe Newhouse,REP,720410,0,0,550,550,25
Tulsa,State Senate,Robert Founds,DEM,720410,0,0,109,109,25
Tulsa,State House,Scott Mceachin,REP,720410,0,0,528,528,67
Tulsa,State House,Zac Davis,LIB,720410,0,0,18,18,67
Tulsa,State House,Lori Decter Wright,DEM,720410,0,0,109,109,67
Tulsa,President,Donald Trump,REP,720411,0,0,463,463,
Tulsa,President,Gary Johnson,LIB,720411,0,0,39,39,
Tulsa,President,Hillary Clinton,DEM,720411,0,0,134,134,
Tulsa,U.S. Senate,James Lankford,REP,720411,0,0,472,472,
Tulsa,U.S. Senate,Robert Murphy,LIB,720411,0,0,29,29,
Tulsa,U.S. Senate,Mike Workman,DEM,720411,0,0,111,111,
Tulsa,U.S. Senate,Mark Beard,IND,720411,0,0,14,14,
Tulsa,U.S. Senate,Sean Braddy,IND,720411,0,0,7,7,
Tulsa,State Senate,Nathan Dahm,REP,720411,0,0,468,468,33
Tulsa,State Senate,Kimberly Fobbs,DEM,720411,0,0,160,160,33
Tulsa,State House,Mike Ritze,REP,720411,0,0,451,451,80
Tulsa,State House,Tom Bates,DEM,720411,0,0,173,173,80
Tulsa,President,Donald Trump,REP,720451,0,0,669,669,
Tulsa,President,Gary Johnson,LIB,720451,0,0,63,63,
Tulsa,President,Hillary Clinton,DEM,720451,0,0,219,219,
Tulsa,U.S. Senate,James Lankford,REP,720451,0,0,680,680,
Tulsa,U.S. Senate,Robert Murphy,LIB,720451,0,0,32,32,
Tulsa,U.S. Senate,Mike Workman,DEM,720451,0,0,188,188,
Tulsa,U.S. Senate,Mark Beard,IND,720451,0,0,19,19,
Tulsa,U.S. Senate,Sean Braddy,IND,720451,0,0,23,23,
Tulsa,State House,David Brumbaugh,REP,720451,0,0,674,674,76
Tulsa,State House,Glenda Puett,DEM,720451,0,0,260,260,76
Tulsa,President,Donald Trump,REP,720452,0,0,1125,1125,
Tulsa,President,Gary Johnson,LIB,720452,0,0,94,94,
Tulsa,President,Hillary Clinton,DEM,720452,0,0,399,399,
Tulsa,U.S. Senate,James Lankford,REP,720452,0,0,1163,1163,
Tulsa,U.S. Senate,Robert Murphy,LIB,720452,0,0,41,41,
Tulsa,U.S. Senate,Mike Workman,DEM,720452,0,0,335,335,
Tulsa,U.S. Senate,Mark Beard,IND,720452,0,0,25,25,
Tulsa,U.S. Senate,Sean Braddy,IND,720452,0,0,32,32,
Tulsa,State Senate,Nathan Dahm,REP,720452,0,0,1097,1097,33
Tulsa,State Senate,Kimberly Fobbs,DEM,720452,0,0,478,478,33
Tulsa,President,Donald Trump,REP,720453,0,0,708,708,
Tulsa,President,Gary Johnson,LIB,720453,0,0,68,68,
Tulsa,President,Hillary Clinton,DEM,720453,0,0,266,266,
Tulsa,U.S. Senate,James Lankford,REP,720453,0,0,751,751,
Tulsa,U.S. Senate,Robert Murphy,LIB,720453,0,0,45,45,
Tulsa,U.S. Senate,Mike Workman,DEM,720453,0,0,200,200,
Tulsa,U.S. Senate,Mark Beard,IND,720453,0,0,13,13,
Tulsa,U.S. Senate,Sean Braddy,IND,720453,0,0,24,24,
Tulsa,President,Donald Trump,REP,720454,0,0,909,909,
Tulsa,President,Gary Johnson,LIB,720454,0,0,91,91,
Tulsa,President,Hillary Clinton,DEM,720454,0,0,508,508,
Tulsa,U.S. Senate,James Lankford,REP,720454,0,0,998,998,
Tulsa,U.S. Senate,Robert Murphy,LIB,720454,0,0,46,46,
Tulsa,U.S. Senate,Mike Workman,DEM,720454,0,0,406,406,
Tulsa,U.S. Senate,Mark Beard,IND,720454,0,0,29,29,
Tulsa,U.S. Senate,Sean Braddy,IND,720454,0,0,29,29,
Tulsa,State Senate,Nathan Dahm,REP,720454,0,0,948,948,33
Tulsa,State Senate,Kimberly Fobbs,DEM,720454,0,0,553,553,33
Tulsa,State House,David Brumbaugh,REP,720454,0,0,964,964,76
Tulsa,State House,Glenda Puett,DEM,720454,0,0,526,526,76
Tulsa,President,Donald Trump,REP,720455,0,0,428,428,
Tulsa,President,Gary Johnson,LIB,720455,0,0,37,37,
Tulsa,President,Hillary Clinton,DEM,720455,0,0,179,179,
Tulsa,U.S. Senate,James Lankford,REP,720455,0,0,450,450,
Tulsa,U.S. Senate,Robert Murphy,LIB,720455,0,0,14,14,
Tulsa,U.S. Senate,Mike Workman,DEM,720455,0,0,160,160,
Tulsa,U.S. Senate,Mark Beard,IND,720455,0,0,13,13,
Tulsa,U.S. Senate,Sean Braddy,IND,720455,0,0,13,13,
Tulsa,State Senate,Nathan Dahm,REP,720455,0,0,442,442,33
Tulsa,State Senate,Kimberly Fobbs,DEM,720455,0,0,206,206,33
Tulsa,State House,David Brumbaugh,REP,720455,0,0,439,439,76
Tulsa,State House,Glenda Puett,DEM,720455,0,0,203,203,76
Tulsa,President,Donald Trump,REP,720456,0,0,698,698,
Tulsa,President,Gary Johnson,LIB,720456,0,0,53,53,
Tulsa,President,Hillary Clinton,DEM,720456,0,0,230,230,
Tulsa,U.S. Senate,James Lankford,REP,720456,0,0,703,703,
Tulsa,U.S. Senate,Robert Murphy,LIB,720456,0,0,34,34,
Tulsa,U.S. Senate,Mike Workman,DEM,720456,0,0,196,196,
Tulsa,U.S. Senate,Mark Beard,IND,720456,0,0,24,24,
Tulsa,U.S. Senate,Sean Braddy,IND,720456,0,0,27,27,
Tulsa,State Senate,Nathan Dahm,REP,720456,0,0,708,708,33
Tulsa,State Senate,Kimberly Fobbs,DEM,720456,0,0,273,273,33
Tulsa,State House,David Brumbaugh,REP,720456,0,0,721,721,76
Tulsa,State House,Glenda Puett,DEM,720456,0,0,254,254,76
Tulsa,President,Donald Trump,REP,720457,0,0,5,5,
Tulsa,President,Gary Johnson,LIB,720457,0,0,0,0,
Tulsa,President,Hillary Clinton,DEM,720457,0,0,2,2,
Tulsa,U.S. Senate,James Lankford,REP,720457,0,0,6,6,
Tulsa,U.S. Senate,Robert Murphy,LIB,720457,0,0,0,0,
Tulsa,U.S. Senate,Mike Workman,DEM,720457,0,0,1,1,
Tulsa,U.S. Senate,Mark Beard,IND,720457,0,0,0,0,
Tulsa,U.S. Senate,Sean Braddy,IND,720457,0,0,0,0,
Tulsa,President,Donald Trump,REP,720458,0,0,1194,1194,
Tulsa,President,Gary Johnson,LIB,720458,0,0,113,113,
Tulsa,President,Hillary Clinton,DEM,720458,0,0,431,431,
Tulsa,U.S. Senate,James Lankford,REP,720458,0,0,1235,1235,
Tulsa,U.S. Senate,Robert Murphy,LIB,720458,0,0,56,56,
Tulsa,U.S. Senate,Mike Workman,DEM,720458,0,0,375,375,
Tulsa,U.S. Senate,Mark Beard,IND,720458,0,0,31,31,
Tulsa,U.S. Senate,Sean Braddy,IND,720458,0,0,43,43,
Tulsa,State Senate,Nathan Dahm,REP,720458,0,0,1207,1207,33
Tulsa,State Senate,Kimberly Fobbs,DEM,720458,0,0,519,519,33
Tulsa,State House,David Brumbaugh,REP,720458,0,0,1224,1224,76
Tulsa,State House,Glenda Puett,DEM,720458,0,0,485,485,76
Tulsa,President,Donald Trump,REP,720459,0,0,493,493,
Tulsa,President,Gary Johnson,LIB,720459,0,0,37,37,
Tulsa,President,Hillary Clinton,DEM,720459,0,0,163,163,
Tulsa,U.S. Senate,James Lankford,REP,720459,0,0,498,498,
Tulsa,U.S. Senate,Robert Murphy,LIB,720459,0,0,15,15,
Tulsa,U.S. Senate,Mike Workman,DEM,720459,0,0,128,128,
Tulsa,U.S. Senate,Mark Beard,IND,720459,0,0,19,19,
Tulsa,U.S. Senate,Sean Braddy,IND,720459,0,0,20,20,
Tulsa,State Senate,Nathan Dahm,REP,720459,0,0,489,489,33
Tulsa,State Senate,Kimberly Fobbs,DEM,720459,0,0,189,189,33
Tulsa,State House,Mike Ritze,REP,720459,0,0,465,465,80
Tulsa,State House,Tom Bates,DEM,720459,0,0,201,201,80
Tulsa,President,Donald Trump,REP,720460,0,0,641,641,
Tulsa,President,Gary Johnson,LIB,720460,0,0,36,36,
Tulsa,President,Hillary Clinton,DEM,720460,0,0,173,173,
Tulsa,U.S. Senate,James Lankford,REP,720460,0,0,679,679,
Tulsa,U.S. Senate,Robert Murphy,LIB,720460,0,0,24,24,
Tulsa,U.S. Senate,Mike Workman,DEM,720460,0,0,134,134,
Tulsa,U.S. Senate,Mark Beard,IND,720460,0,0,7,7,
Tulsa,U.S. Senate,Sean Braddy,IND,720460,0,0,12,12,
Tulsa,State Senate,Joe Newhouse,REP,720460,0,0,704,704,25
Tulsa,State Senate,Robert Founds,DEM,720460,0,0,149,149,25
Tulsa,State House,Mike Ritze,REP,720460,0,0,646,646,80
Tulsa,State House,Tom Bates,DEM,720460,0,0,207,207,80
Tulsa,President,Donald Trump,REP,720461,0,0,637,637,
Tulsa,President,Gary Johnson,LIB,720461,0,0,81,81,
Tulsa,President,Hillary Clinton,DEM,720461,0,0,255,255,
Tulsa,U.S. Senate,James Lankford,REP,720461,0,0,663,663,
Tulsa,U.S. Senate,Robert Murphy,LIB,720461,0,0,34,34,
Tulsa,U.S. Senate,Mike Workman,DEM,720461,0,0,207,207,
Tulsa,U.S. Senate,Mark Beard,IND,720461,0,0,30,30,
Tulsa,U.S. Senate,Sean Braddy,IND,720461,0,0,35,35,
Tulsa,State Senate,Nathan Dahm,REP,720461,0,0,661,661,33
Tulsa,State Senate,Kimberly Fobbs,DEM,720461,0,0,304,304,33
Tulsa,State House,Mike Ritze,REP,720461,0,0,627,627,80
Tulsa,State House,Tom Bates,DEM,720461,0,0,333,333,80
Tulsa,President,Donald Trump,REP,720462,0,0,981,981,
Tulsa,President,Gary Johnson,LIB,720462,0,0,89,89,
Tulsa,President,Hillary Clinton,DEM,720462,0,0,362,362,
Tulsa,U.S. Senate,James Lankford,REP,720462,0,0,1025,1025,
Tulsa,U.S. Senate,Robert Murphy,LIB,720462,0,0,46,46,
Tulsa,U.S. Senate,Mike Workman,DEM,720462,0,0,297,297,
Tulsa,U.S. Senate,Mark Beard,IND,720462,0,0,23,23,
Tulsa,U.S. Senate,Sean Braddy,IND,720462,0,0,38,38,
Tulsa,State Senate,Nathan Dahm,REP,720462,0,0,1024,1024,33
Tulsa,State Senate,Kimberly Fobbs,DEM,720462,0,0,395,395,33
Tulsa,State House,David Brumbaugh,REP,720462,0,0,1019,1019,76
Tulsa,State House,Glenda Puett,DEM,720462,0,0,384,384,76
Tulsa,President,Donald Trump,REP,720463,0,0,607,607,
Tulsa,President,Gary Johnson,LIB,720463,0,0,60,60,
Tulsa,President,Hillary Clinton,DEM,720463,0,0,243,243,
Tulsa,U.S. Senate,James Lankford,REP,720463,0,0,621,621,
Tulsa,U.S. Senate,Robert Murphy,LIB,720463,0,0,29,29,
Tulsa,U.S. Senate,Mike Workman,DEM,720463,0,0,215,215,
Tulsa,U.S. Senate,Mark Beard,IND,720463,0,0,14,14,
Tulsa,U.S. Senate,Sean Braddy,IND,720463,0,0,24,24,
Tulsa,State Senate,Nathan Dahm,REP,720463,0,0,604,604,33
Tulsa,State Senate,Kimberly Fobbs,DEM,720463,0,0,296,296,33
Tulsa,State House,David Brumbaugh,REP,720463,0,0,617,617,76
Tulsa,State House,Glenda Puett,DEM,720463,0,0,274,274,76
Tulsa,President,Donald Trump,REP,720464,0,0,1261,1261,
Tulsa,President,Gary Johnson,LIB,720464,0,0,102,102,
Tulsa,President,Hillary Clinton,DEM,720464,0,0,392,392,
Tulsa,U.S. Senate,James Lankford,REP,720464,0,0,1293,1293,
Tulsa,U.S. Senate,Robert Murphy,LIB,720464,0,0,51,51,
Tulsa,U.S. Senate,Mike Workman,DEM,720464,0,0,320,320,
Tulsa,U.S. Senate,Mark Beard,IND,720464,0,0,28,28,
Tulsa,U.S. Senate,Sean Braddy,IND,720464,0,0,49,49,
Tulsa,State Senate,Nathan Dahm,REP,720464,0,0,1243,1243,33
Tulsa,State Senate,Kimberly Fobbs,DEM,720464,0,0,485,485,33
Tulsa,State House,Mike Ritze,REP,720464,0,0,1156,1156,80
Tulsa,State House,Tom Bates,DEM,720464,0,0,570,570,80
Tulsa,President,Donald Trump,REP,720465,0,0,874,874,
Tulsa,President,Gary Johnson,LIB,720465,0,0,103,103,
Tulsa,President,Hillary Clinton,DEM,720465,0,0,599,599,
Tulsa,U.S. Senate,James Lankford,REP,720465,0,0,940,940,
Tulsa,U.S. Senate,Robert Murphy,LIB,720465,0,0,63,63,
Tulsa,U.S. Senate,Mike Workman,DEM,720465,0,0,492,492,
Tulsa,U.S. Senate,Mark Beard,IND,720465,0,0,31,31,
Tulsa,U.S. Senate,Sean Braddy,IND,720465,0,0,46,46,
Tulsa,State House,David Brumbaugh,REP,720465,0,0,939,939,76
Tulsa,State House,Glenda Puett,DEM,720465,0,0,617,617,76
Tulsa,President,Donald Trump,REP,720466,0,0,859,859,
Tulsa,President,Gary Johnson,LIB,720466,0,0,93,93,
Tulsa,President,Hillary Clinton,DEM,720466,0,0,307,307,
Tulsa,U.S. Senate,James Lankford,REP,720466,0,0,912,912,
Tulsa,U.S. Senate,Robert Murphy,LIB,720466,0,0,40,40,
Tulsa,U.S. Senate,Mike Workman,DEM,720466,0,0,261,261,
Tulsa,U.S. Senate,Mark Beard,IND,720466,0,0,27,27,
Tulsa,U.S. Senate,Sean Braddy,IND,720466,0,0,20,20,
Tulsa,President,Donald Trump,REP,720467,0,0,212,212,
Tulsa,President,Gary Johnson,LIB,720467,0,0,19,19,
Tulsa,President,Hillary Clinton,DEM,720467,0,0,80,80,
Tulsa,U.S. Senate,James Lankford,REP,720467,0,0,225,225,
Tulsa,U.S. Senate,Robert Murphy,LIB,720467,0,0,7,7,
Tulsa,U.S. Senate,Mike Workman,DEM,720467,0,0,62,62,
Tulsa,U.S. Senate,Mark Beard,IND,720467,0,0,4,4,
Tulsa,U.S. Senate,Sean Braddy,IND,720467,0,0,11,11,
Tulsa,State Senate,Joe Newhouse,REP,720467,0,0,236,236,25
Tulsa,State Senate,Robert Founds,DEM,720467,0,0,72,72,25
Tulsa,State House,Mike Ritze,REP,720467,0,0,213,213,80
Tulsa,State House,Tom Bates,DEM,720467,0,0,97,97,80
Tulsa,President,Donald Trump,REP,720468,0,0,953,953,
Tulsa,President,Gary Johnson,LIB,720468,0,0,100,100,
Tulsa,President,Hillary Clinton,DEM,720468,0,0,441,441,
Tulsa,U.S. Senate,James Lankford,REP,720468,0,0,1020,1020,
Tulsa,U.S. Senate,Robert Murphy,LIB,720468,0,0,56,56,
Tulsa,U.S. Senate,Mike Workman,DEM,720468,0,0,343,343,
Tulsa,U.S. Senate,Mark Beard,IND,720468,0,0,26,26,
Tulsa,U.S. Senate,Sean Braddy,IND,720468,0,0,43,43,
Tulsa,State Senate,Nathan Dahm,REP,720468,0,0,994,994,33
Tulsa,State Senate,Kimberly Fobbs,DEM,720468,0,0,482,482,33
Tulsa,State House,David Brumbaugh,REP,720468,0,0,984,984,76
Tulsa,State House,Glenda Puett,DEM,720468,0,0,486,486,76
Tulsa,President,Donald Trump,REP,720469,0,0,239,239,
Tulsa,President,Gary Johnson,LIB,720469,0,0,25,25,
Tulsa,President,Hillary Clinton,DEM,720469,0,0,93,93,
Tulsa,U.S. Senate,James Lankford,REP,720469,0,0,236,236,
Tulsa,U.S. Senate,Robert Murphy,LIB,720469,0,0,17,17,
Tulsa,U.S. Senate,Mike Workman,DEM,720469,0,0,80,80,
Tulsa,U.S. Senate,Mark Beard,IND,720469,0,0,8,8,
Tulsa,U.S. Senate,Sean Braddy,IND,720469,0,0,12,12,
Tulsa,President,Donald Trump,REP,720470,0,0,896,896,
Tulsa,President,Gary Johnson,LIB,720470,0,0,83,83,
Tulsa,President,Hillary Clinton,DEM,720470,0,0,476,476,
Tulsa,U.S. Senate,James Lankford,REP,720470,0,0,981,981,
Tulsa,U.S. Senate,Robert Murphy,LIB,720470,0,0,42,42,
Tulsa,U.S. Senate,Mike Workman,DEM,720470,0,0,382,382,
Tulsa,U.S. Senate,Mark Beard,IND,720470,0,0,18,18,
Tulsa,U.S. Senate,Sean Braddy,IND,720470,0,0,25,25,
Tulsa,State Senate,Nathan Dahm,REP,720470,0,0,929,929,33
Tulsa,State Senate,Kimberly Fobbs,DEM,720470,0,0,510,510,33
Tulsa,State House,David Brumbaugh,REP,720470,0,0,962,962,76
Tulsa,State House,Glenda Puett,DEM,720470,0,0,470,470,76
Tulsa,President,Donald Trump,REP,720471,0,0,493,493,
Tulsa,President,Gary Johnson,LIB,720471,0,0,29,29,
Tulsa,President,Hillary Clinton,DEM,720471,0,0,148,148,
Tulsa,U.S. Senate,James Lankford,REP,720471,0,0,531,531,
Tulsa,U.S. Senate,Robert Murphy,LIB,720471,0,0,15,15,
Tulsa,U.S. Senate,Mike Workman,DEM,720471,0,0,113,113,
Tulsa,U.S. Senate,Mark Beard,IND,720471,0,0,10,10,
Tulsa,U.S. Senate,Sean Braddy,IND,720471,0,0,8,8,
Tulsa,State Senate,Joe Newhouse,REP,720471,0,0,539,539,25
Tulsa,State Senate,Robert Founds,DEM,720471,0,0,133,133,25
Tulsa,State House,David Brumbaugh,REP,720471,0,0,504,504,76
Tulsa,State House,Glenda Puett,DEM,720471,0,0,163,163,76
Tulsa,President,Donald Trump,REP,720472,0,0,384,384,
Tulsa,President,Gary Johnson,LIB,720472,0,0,33,33,
Tulsa,President,Hillary Clinton,DEM,720472,0,0,125,125,
Tulsa,U.S. Senate,James Lankford,REP,720472,0,0,416,416,
Tulsa,U.S. Senate,Robert Murphy,LIB,720472,0,0,19,19,
Tulsa,U.S. Senate,Mike Workman,DEM,720472,0,0,99,99,
Tulsa,U.S. Senate,Mark Beard,IND,720472,0,0,3,3,
Tulsa,U.S. Senate,Sean Braddy,IND,720472,0,0,12,12,
Tulsa,State Senate,Nathan Dahm,REP,720472,0,0,391,391,33
Tulsa,State Senate,Kimberly Fobbs,DEM,720472,0,0,154,154,33
Tulsa,State House,Mike Ritze,REP,720472,0,0,358,358,80
Tulsa,State House,Tom Bates,DEM,720472,0,0,188,188,80
Tulsa,President,Donald Trump,REP,720473,0,0,619,619,
Tulsa,President,Gary Johnson,LIB,720473,0,0,56,56,
Tulsa,President,Hillary Clinton,DEM,720473,0,0,231,231,
Tulsa,U.S. Senate,James Lankford,REP,720473,0,0,646,646,
Tulsa,U.S. Senate,Robert Murphy,LIB,720473,0,0,34,34,
Tulsa,U.S. Senate,Mike Workman,DEM,720473,0,0,184,184,
Tulsa,U.S. Senate,Mark Beard,IND,720473,0,0,19,19,
Tulsa,U.S. Senate,Sean Braddy,IND,720473,0,0,22,22,
Tulsa,State Senate,Nathan Dahm,REP,720473,0,0,619,619,33
Tulsa,State Senate,Kimberly Fobbs,DEM,720473,0,0,283,283,33
Tulsa,State House,Mike Ritze,REP,720473,0,0,590,590,80
Tulsa,State House,Tom Bates,DEM,720473,0,0,311,311,80
Tulsa,President,Donald Trump,REP,720474,0,0,979,979,
Tulsa,President,Gary Johnson,LIB,720474,0,0,74,74,
Tulsa,President,Hillary Clinton,DEM,720474,0,0,388,388,
Tulsa,U.S. Senate,James Lankford,REP,720474,0,0,1015,1015,
Tulsa,U.S. Senate,Robert Murphy,LIB,720474,0,0,41,41,
Tulsa,U.S. Senate,Mike Workman,DEM,720474,0,0,322,322,
Tulsa,U.S. Senate,Mark Beard,IND,720474,0,0,22,22,
Tulsa,U.S. Senate,Sean Braddy,IND,720474,0,0,26,26,
Tulsa,State Senate,Nathan Dahm,REP,720474,0,0,971,971,33
Tulsa,State Senate,Kimberly Fobbs,DEM,720474,0,0,450,450,33
Tulsa,State House,David Brumbaugh,REP,720474,0,0,990,990,76
Tulsa,State House,Glenda Puett,DEM,720474,0,0,425,425,76
Tulsa,President,Donald Trump,REP,720475,0,0,1178,1178,
Tulsa,President,Gary Johnson,LIB,720475,0,0,104,104,
Tulsa,President,Hillary Clinton,DEM,720475,0,0,456,456,
Tulsa,U.S. Senate,James Lankford,REP,720475,0,0,1262,1262,
Tulsa,U.S. Senate,Robert Murphy,LIB,720475,0,0,42,42,
Tulsa,U.S. Senate,Mike Workman,DEM,720475,0,0,364,364,
Tulsa,U.S. Senate,Mark Beard,IND,720475,0,0,29,29,
Tulsa,U.S. Senate,Sean Braddy,IND,720475,0,0,45,45,
Tulsa,State House,Dan Kirby,REP,720475,0,0,1201,1201,75
Tulsa,State House,Karen Gaddis,DEM,720475,0,0,525,525,75
Tulsa,President,Donald Trump,REP,720476,0,0,459,459,
Tulsa,President,Gary Johnson,LIB,720476,0,0,31,31,
Tulsa,President,Hillary Clinton,DEM,720476,0,0,124,124,
Tulsa,U.S. Senate,James Lankford,REP,720476,0,0,477,477,
Tulsa,U.S. Senate,Robert Murphy,LIB,720476,0,0,19,19,
Tulsa,U.S. Senate,Mike Workman,DEM,720476,0,0,102,102,
Tulsa,U.S. Senate,Mark Beard,IND,720476,0,0,5,5,
Tulsa,U.S. Senate,Sean Braddy,IND,720476,0,0,8,8,
Tulsa,President,Donald Trump,REP,720501,0,0,595,595,
Tulsa,President,Gary Johnson,LIB,720501,0,0,42,42,
Tulsa,President,Hillary Clinton,DEM,720501,0,0,141,141,
Tulsa,U.S. Senate,James Lankford,REP,720501,0,0,620,620,
Tulsa,U.S. Senate,Robert Murphy,LIB,720501,0,0,22,22,
Tulsa,U.S. Senate,Mike Workman,DEM,720501,0,0,120,120,
Tulsa,U.S. Senate,Mark Beard,IND,720501,0,0,10,10,
Tulsa,U.S. Senate,Sean Braddy,IND,720501,0,0,10,10,
Tulsa,State House,Sean Roberts,REP,720501,0,0,587,587,36
Tulsa,State House,Cathy Ross,DEM,720501,0,0,181,181,36
Tulsa,President,Donald Trump,REP,720502,0,0,1100,1100,
Tulsa,President,Gary Johnson,LIB,720502,0,0,86,86,
Tulsa,President,Hillary Clinton,DEM,720502,0,0,295,295,
Tulsa,U.S. Senate,James Lankford,REP,720502,0,0,1099,1099,
Tulsa,U.S. Senate,Robert Murphy,LIB,720502,0,0,56,56,
Tulsa,U.S. Senate,Mike Workman,DEM,720502,0,0,250,250,
Tulsa,U.S. Senate,Mark Beard,IND,720502,0,0,27,27,
Tulsa,U.S. Senate,Sean Braddy,IND,720502,0,0,35,35,
Tulsa,President,Donald Trump,REP,720503,0,0,746,746,
Tulsa,President,Gary Johnson,LIB,720503,0,0,48,48,
Tulsa,President,Hillary Clinton,DEM,720503,0,0,138,138,
Tulsa,U.S. Senate,James Lankford,REP,720503,0,0,720,720,
Tulsa,U.S. Senate,Robert Murphy,LIB,720503,0,0,24,24,
Tulsa,U.S. Senate,Mike Workman,DEM,720503,0,0,141,141,
Tulsa,U.S. Senate,Mark Beard,IND,720503,0,0,16,16,
Tulsa,U.S. Senate,Sean Braddy,IND,720503,0,0,25,25,
Tulsa,President,Donald Trump,REP,720504,0,0,906,906,
Tulsa,President,Gary Johnson,LIB,720504,0,0,55,55,
Tulsa,President,Hillary Clinton,DEM,720504,0,0,255,255,
Tulsa,U.S. Senate,James Lankford,REP,720504,0,0,912,912,
Tulsa,U.S. Senate,Robert Murphy,LIB,720504,0,0,27,27,
Tulsa,U.S. Senate,Mike Workman,DEM,720504,0,0,221,221,
Tulsa,U.S. Senate,Mark Beard,IND,720504,0,0,31,31,
Tulsa,U.S. Senate,Sean Braddy,IND,720504,0,0,22,22,
Tulsa,President,Donald Trump,REP,720551,0,0,220,220,
Tulsa,President,Gary Johnson,LIB,720551,0,0,17,17,
Tulsa,President,Hillary Clinton,DEM,720551,0,0,89,89,
Tulsa,U.S. Senate,James Lankford,REP,720551,0,0,220,220,
Tulsa,U.S. Senate,Robert Murphy,LIB,720551,0,0,9,9,
Tulsa,U.S. Senate,Mike Workman,DEM,720551,0,0,73,73,
Tulsa,U.S. Senate,Mark Beard,IND,720551,0,0,7,7,
Tulsa,U.S. Senate,Sean Braddy,IND,720551,0,0,10,10,
Tulsa,President,Donald Trump,REP,720552,0,0,471,471,
Tulsa,President,Gary Johnson,LIB,720552,0,0,31,31,
Tulsa,President,Hillary Clinton,DEM,720552,0,0,137,137,
Tulsa,U.S. Senate,James Lankford,REP,720552,0,0,463,463,
Tulsa,U.S. Senate,Robert Murphy,LIB,720552,0,0,11,11,
Tulsa,U.S. Senate,Mike Workman,DEM,720552,0,0,132,132,
Tulsa,U.S. Senate,Mark Beard,IND,720552,0,0,16,16,
Tulsa,U.S. Senate,Sean Braddy,IND,720552,0,0,12,12,
Tulsa,State House,Sean Roberts,REP,720552,0,0,445,445,36
Tulsa,State House,Cathy Ross,DEM,720552,0,0,182,182,36
Tulsa,President,Donald Trump,REP,720553,0,0,256,256,
Tulsa,President,Gary Johnson,LIB,720553,0,0,18,18,
Tulsa,President,Hillary Clinton,DEM,720553,0,0,78,78,
Tulsa,U.S. Senate,James Lankford,REP,720553,0,0,257,257,
Tulsa,U.S. Senate,Robert Murphy,LIB,720553,0,0,6,6,
Tulsa,U.S. Senate,Mike Workman,DEM,720553,0,0,70,70,
Tulsa,U.S. Senate,Mark Beard,IND,720553,0,0,10,10,
Tulsa,U.S. Senate,Sean Braddy,IND,720553,0,0,5,5,
Tulsa,President,Donald Trump,REP,720700,0,0,1045,1045,
Tulsa,President,Gary Johnson,LIB,720700,0,0,95,95,
Tulsa,President,Hillary Clinton,DEM,720700,0,0,344,344,
Tulsa,U.S. Senate,James Lankford,REP,720700,0,0,1129,1129,
Tulsa,U.S. Senate,Robert Murphy,LIB,720700,0,0,40,40,
Tulsa,U.S. Senate,Mike Workman,DEM,720700,0,0,249,249,
Tulsa,U.S. Senate,Mark Beard,IND,720700,0,0,21,21,
Tulsa,U.S. Senate,Sean Braddy,IND,720700,0,0,35,35,
Tulsa,State Senate,Dan Newberry,REP,720700,0,0,998,998,37
Tulsa,State Senate,Lloyd Snow,DEM,720700,0,0,433,433,37
Tulsa,State Senate,Shawn Ketcher,IND,720700,0,0,47,47,37
Tulsa,State House,Chuck Strohm,REP,720700,0,0,1046,1046,69
Tulsa,State House,Paul Sullivan,DEM,720700,0,0,410,410,69
Tulsa,President,Donald Trump,REP,720701,0,0,1106,1106,
Tulsa,President,Gary Johnson,LIB,720701,0,0,114,114,
Tulsa,President,Hillary Clinton,DEM,720701,0,0,415,415,
Tulsa,U.S. Senate,James Lankford,REP,720701,0,0,1165,1165,
Tulsa,U.S. Senate,Robert Murphy,LIB,720701,0,0,62,62,
Tulsa,U.S. Senate,Mike Workman,DEM,720701,0,0,340,340,
Tulsa,U.S. Senate,Mark Beard,IND,720701,0,0,32,32,
Tulsa,U.S. Senate,Sean Braddy,IND,720701,0,0,25,25,
Tulsa,State Senate,Dan Newberry,REP,720701,0,0,1072,1072,37
Tulsa,State Senate,Lloyd Snow,DEM,720701,0,0,486,486,37
Tulsa,State Senate,Shawn Ketcher,IND,720701,0,0,59,59,37
Tulsa,President,Donald Trump,REP,720702,0,0,586,586,
Tulsa,President,Gary Johnson,LIB,720702,0,0,59,59,
Tulsa,President,Hillary Clinton,DEM,720702,0,0,266,266,
Tulsa,U.S. Senate,James Lankford,REP,720702,0,0,604,604,
Tulsa,U.S. Senate,Robert Murphy,LIB,720702,0,0,31,31,
Tulsa,U.S. Senate,Mike Workman,DEM,720702,0,0,208,208,
Tulsa,U.S. Senate,Mark Beard,IND,720702,0,0,28,28,
Tulsa,U.S. Senate,Sean Braddy,IND,720702,0,0,36,36,
Tulsa,State Senate,Dan Newberry,REP,720702,0,0,524,524,37
Tulsa,State Senate,Lloyd Snow,DEM,720702,0,0,335,335,37
Tulsa,State Senate,Shawn Ketcher,IND,720702,0,0,53,53,37
Tulsa,State House,Chuck Strohm,REP,720702,0,0,547,547,69
Tulsa,State House,Paul Sullivan,DEM,720702,0,0,349,349,69
Tulsa,President,Donald Trump,REP,720703,0,0,1063,1063,
Tulsa,President,Gary Johnson,LIB,720703,0,0,122,122,
Tulsa,President,Hillary Clinton,DEM,720703,0,0,442,442,
Tulsa,U.S. Senate,James Lankford,REP,720703,0,0,1183,1183,
Tulsa,U.S. Senate,Robert Murphy,LIB,720703,0,0,47,47,
Tulsa,U.S. Senate,Mike Workman,DEM,720703,0,0,359,359,
Tulsa,U.S. Senate,Mark Beard,IND,720703,0,0,24,24,
Tulsa,U.S. Senate,Sean Braddy,IND,720703,0,0,31,31,
Tulsa,State Senate,Dan Newberry,REP,720703,0,0,1080,1080,37
Tulsa,State Senate,Lloyd Snow,DEM,720703,0,0,495,495,37
Tulsa,State Senate,Shawn Ketcher,IND,720703,0,0,60,60,37
Tulsa,President,Donald Trump,REP,720704,0,0,1233,1233,
Tulsa,President,Gary Johnson,LIB,720704,0,0,123,123,
Tulsa,President,Hillary Clinton,DEM,720704,0,0,327,327,
Tulsa,U.S. Senate,James Lankford,REP,720704,0,0,1320,1320,
Tulsa,U.S. Senate,Robert Murphy,LIB,720704,0,0,61,61,
Tulsa,U.S. Senate,Mike Workman,DEM,720704,0,0,255,255,
Tulsa,U.S. Senate,Mark Beard,IND,720704,0,0,22,22,
Tulsa,U.S. Senate,Sean Braddy,IND,720704,0,0,28,28,
Tulsa,State Senate,Joe Newhouse,REP,720704,0,0,1319,1319,25
Tulsa,State Senate,Robert Founds,DEM,720704,0,0,349,349,25
Tulsa,State House,Chuck Strohm,REP,720704,0,0,1224,1224,69
Tulsa,State House,Paul Sullivan,DEM,720704,0,0,430,430,69
Tulsa,President,Donald Trump,REP,720705,0,0,728,728,
Tulsa,President,Gary Johnson,LIB,720705,0,0,65,65,
Tulsa,President,Hillary Clinton,DEM,720705,0,0,252,252,
Tulsa,U.S. Senate,James Lankford,REP,720705,0,0,721,721,
Tulsa,U.S. Senate,Robert Murphy,LIB,720705,0,0,44,44,
Tulsa,U.S. Senate,Mike Workman,DEM,720705,0,0,223,223,
Tulsa,U.S. Senate,Mark Beard,IND,720705,0,0,18,18,
Tulsa,U.S. Senate,Sean Braddy,IND,720705,0,0,27,27,
Tulsa,President,Donald Trump,REP,720706,0,0,1389,1389,
Tulsa,President,Gary Johnson,LIB,720706,0,0,97,97,
Tulsa,President,Hillary Clinton,DEM,720706,0,0,348,348,
Tulsa,U.S. Senate,James Lankford,REP,720706,0,0,1372,1372,
Tulsa,U.S. Senate,Robert Murphy,LIB,720706,0,0,55,55,
Tulsa,U.S. Senate,Mike Workman,DEM,720706,0,0,310,310,
Tulsa,U.S. Senate,Mark Beard,IND,720706,0,0,39,39,
Tulsa,U.S. Senate,Sean Braddy,IND,720706,0,0,45,45,
Tulsa,State Senate,Dan Newberry,REP,720706,0,0,1257,1257,37
Tulsa,State Senate,Lloyd Snow,DEM,720706,0,0,456,456,37
Tulsa,State Senate,Shawn Ketcher,IND,720706,0,0,103,103,37
Tulsa,President,Donald Trump,REP,720707,0,0,628,628,
Tulsa,President,Gary Johnson,LIB,720707,0,0,44,44,
Tulsa,President,Hillary Clinton,DEM,720707,0,0,189,189,
Tulsa,U.S. Senate,James Lankford,REP,720707,0,0,633,633,
Tulsa,U.S. Senate,Robert Murphy,LIB,720707,0,0,17,17,
Tulsa,U.S. Senate,Mike Workman,DEM,720707,0,0,167,167,
Tulsa,U.S. Senate,Mark Beard,IND,720707,0,0,21,21,
Tulsa,U.S. Senate,Sean Braddy,IND,720707,0,0,19,19,
Tulsa,President,Donald Trump,REP,720708,0,0,726,726,
Tulsa,President,Gary Johnson,LIB,720708,0,0,64,64,
Tulsa,President,Hillary Clinton,DEM,720708,0,0,247,247,
Tulsa,U.S. Senate,James Lankford,REP,720708,0,0,741,741,
Tulsa,U.S. Senate,Robert Murphy,LIB,720708,0,0,38,38,
Tulsa,U.S. Senate,Mike Workman,DEM,720708,0,0,213,213,
Tulsa,U.S. Senate,Mark Beard,IND,720708,0,0,18,18,
Tulsa,U.S. Senate,Sean Braddy,IND,720708,0,0,29,29,
Tulsa,President,Donald Trump,REP,720709,0,0,781,781,
Tulsa,President,Gary Johnson,LIB,720709,0,0,69,69,
Tulsa,President,Hillary Clinton,DEM,720709,0,0,316,316,
Tulsa,U.S. Senate,James Lankford,REP,720709,0,0,836,836,
Tulsa,U.S. Senate,Robert Murphy,LIB,720709,0,0,34,34,
Tulsa,U.S. Senate,Mike Workman,DEM,720709,0,0,237,237,
Tulsa,U.S. Senate,Mark Beard,IND,720709,0,0,18,18,
Tulsa,U.S. Senate,Sean Braddy,IND,720709,0,0,43,43,
Tulsa,State Senate,Dan Newberry,REP,720709,0,0,756,756,37
Tulsa,State Senate,Lloyd Snow,DEM,720709,0,0,364,364,37
Tulsa,State Senate,Shawn Ketcher,IND,720709,0,0,45,45,37
Tulsa,State House,Chuck Strohm,REP,720709,0,0,749,749,69
Tulsa,State House,Paul Sullivan,DEM,720709,0,0,400,400,69
Tulsa,President,Donald Trump,REP,720710,0,0,314,314,
Tulsa,President,Gary Johnson,LIB,720710,0,0,9,9,
Tulsa,President,Hillary Clinton,DEM,720710,0,0,46,46,
Tulsa,U.S. Senate,James Lankford,REP,720710,0,0,304,304,
Tulsa,U.S. Senate,Robert Murphy,LIB,720710,0,0,8,8,
Tulsa,U.S. Senate,Mike Workman,DEM,720710,0,0,43,43,
Tulsa,U.S. Senate,Mark Beard,IND,720710,0,0,3,3,
Tulsa,U.S. Senate,Sean Braddy,IND,720710,0,0,7,7,
Tulsa,State Senate,Nathan Dahm,REP,720710,0,0,293,293,33
Tulsa,State Senate,Kimberly Fobbs,DEM,720710,0,0,65,65,33
Tulsa,President,Donald Trump,REP,720750,0,0,919,919,
Tulsa,President,Gary Johnson,LIB,720750,0,0,62,62,
Tulsa,President,Hillary Clinton,DEM,720750,0,0,252,252,
Tulsa,U.S. Senate,James Lankford,REP,720750,0,0,933,933,
Tulsa,U.S. Senate,Robert Murphy,LIB,720750,0,0,31,31,
Tulsa,U.S. Senate,Mike Workman,DEM,720750,0,0,211,211,
Tulsa,U.S. Senate,Mark Beard,IND,720750,0,0,17,17,
Tulsa,U.S. Senate,Sean Braddy,IND,720750,0,0,31,31,
Tulsa,State House,Dale Derby,REP,720750,0,0,830,830,74
Tulsa,State House,Jeri Moberly,DEM,720750,0,0,391,391,74
Tulsa,President,Donald Trump,REP,720751,0,0,962,962,
Tulsa,President,Gary Johnson,LIB,720751,0,0,89,89,
Tulsa,President,Hillary Clinton,DEM,720751,0,0,338,338,
Tulsa,U.S. Senate,James Lankford,REP,720751,0,0,1013,1013,
Tulsa,U.S. Senate,Robert Murphy,LIB,720751,0,0,37,37,
Tulsa,U.S. Senate,Mike Workman,DEM,720751,0,0,277,277,
Tulsa,U.S. Senate,Mark Beard,IND,720751,0,0,22,22,
Tulsa,U.S. Senate,Sean Braddy,IND,720751,0,0,30,30,
Tulsa,State House,Dale Derby,REP,720751,0,0,880,880,74
Tulsa,State House,Jeri Moberly,DEM,720751,0,0,497,497,74
Tulsa,President,Donald Trump,REP,720752,0,0,824,824,
Tulsa,President,Gary Johnson,LIB,720752,0,0,47,47,
Tulsa,President,Hillary Clinton,DEM,720752,0,0,225,225,
Tulsa,U.S. Senate,James Lankford,REP,720752,0,0,835,835,
Tulsa,U.S. Senate,Robert Murphy,LIB,720752,0,0,29,29,
Tulsa,U.S. Senate,Mike Workman,DEM,720752,0,0,196,196,
Tulsa,U.S. Senate,Mark Beard,IND,720752,0,0,22,22,
Tulsa,U.S. Senate,Sean Braddy,IND,720752,0,0,13,13,
Tulsa,State House,Sean Roberts,REP,720752,0,0,788,788,36
Tulsa,State House,Cathy Ross,DEM,720752,0,0,282,282,36
Tulsa,President,Donald Trump,REP,720753,0,0,627,627,
Tulsa,President,Gary Johnson,LIB,720753,0,0,49,49,
Tulsa,President,Hillary Clinton,DEM,720753,0,0,224,224,
Tulsa,U.S. Senate,James Lankford,REP,720753,0,0,616,616,
Tulsa,U.S. Senate,Robert Murphy,LIB,720753,0,0,31,31,
Tulsa,U.S. Senate,Mike Workman,DEM,720753,0,0,187,187,
Tulsa,U.S. Senate,Mark Beard,IND,720753,0,0,27,27,
Tulsa,U.S. Senate,Sean Braddy,IND,720753,0,0,33,33,
Tulsa,President,Donald Trump,REP,720754,0,0,1164,1164,
Tulsa,President,Gary Johnson,LIB,720754,0,0,102,102,
Tulsa,President,Hillary Clinton,DEM,720754,0,0,357,357,
Tulsa,U.S. Senate,James Lankford,REP,720754,0,0,1153,1153,
Tulsa,U.S. Senate,Robert Murphy,LIB,720754,0,0,66,66,
Tulsa,U.S. Senate,Mike Workman,DEM,720754,0,0,310,310,
Tulsa,U.S. Senate,Mark Beard,IND,720754,0,0,36,36,
Tulsa,U.S. Senate,Sean Braddy,IND,720754,0,0,40,40,
Tulsa,State House,Dale Derby,REP,720754,0,0,1050,1050,74
Tulsa,State House,Jeri Moberly,DEM,720754,0,0,548,548,74
Tulsa,President,Donald Trump,REP,720755,0,0,1564,1564,
Tulsa,President,Gary Johnson,LIB,720755,0,0,124,124,
Tulsa,President,Hillary Clinton,DEM,720755,0,0,487,487,
Tulsa,U.S. Senate,James Lankford,REP,720755,0,0,1624,1624,
Tulsa,U.S. Senate,Robert Murphy,LIB,720755,0,0,60,60,
Tulsa,U.S. Senate,Mike Workman,DEM,720755,0,0,405,405,
Tulsa,U.S. Senate,Mark Beard,IND,720755,0,0,39,39,
Tulsa,U.S. Senate,Sean Braddy,IND,720755,0,0,38,38,
Tulsa,State House,Dale Derby,REP,720755,0,0,1439,1439,74
Tulsa,State House,Jeri Moberly,DEM,720755,0,0,724,724,74
Tulsa,President,Donald Trump,REP,720756,0,0,56,56,
Tulsa,President,Gary Johnson,LIB,720756,0,0,3,3,
Tulsa,President,Hillary Clinton,DEM,720756,0,0,21,21,
Tulsa,U.S. Senate,James Lankford,REP,720756,0,0,58,58,
Tulsa,U.S. Senate,Robert Murphy,LIB,720756,0,0,2,2,
Tulsa,U.S. Senate,Mike Workman,DEM,720756,0,0,18,18,
Tulsa,U.S. Senate,Mark Beard,IND,720756,0,0,3,3,
Tulsa,U.S. Senate,Sean Braddy,IND,720756,0,0,0,0,
Tulsa,President,Donald Trump,REP,720757,0,0,1586,1586,
Tulsa,President,Gary Johnson,LIB,720757,0,0,117,117,
Tulsa,President,Hillary Clinton,DEM,720757,0,0,450,450,
Tulsa,U.S. Senate,James Lankford,REP,720757,0,0,1621,1621,
Tulsa,U.S. Senate,Robert Murphy,LIB,720757,0,0,58,58,
Tulsa,U.S. Senate,Mike Workman,DEM,720757,0,0,376,376,
Tulsa,U.S. Senate,Mark Beard,IND,720757,0,0,37,37,
Tulsa,U.S. Senate,Sean Braddy,IND,720757,0,0,48,48,
Tulsa,State House,Dale Derby,REP,720757,0,0,1427,1427,74
Tulsa,State House,Jeri Moberly,DEM,720757,0,0,716,716,74
Tulsa,President,Donald Trump,REP,720758,0,0,360,360,
Tulsa,President,Gary Johnson,LIB,720758,0,0,35,35,
Tulsa,President,Hillary Clinton,DEM,720758,0,0,128,128,
Tulsa,U.S. Senate,James Lankford,REP,720758,0,0,387,387,
Tulsa,U.S. Senate,Robert Murphy,LIB,720758,0,0,16,16,
Tulsa,U.S. Senate,Mike Workman,DEM,720758,0,0,101,101,
Tulsa,U.S. Senate,Mark Beard,IND,720758,0,0,6,6,
Tulsa,U.S. Senate,Sean Braddy,IND,720758,0,0,14,14,
Tulsa,State House,Sean Roberts,REP,720758,0,0,369,369,36
Tulsa,State House,Cathy Ross,DEM,720758,0,0,149,149,36
Tulsa,President,Donald Trump,REP,720759,0,0,834,834,
Tulsa,President,Gary Johnson,LIB,720759,0,0,88,88,
Tulsa,President,Hillary Clinton,DEM,720759,0,0,294,294,
Tulsa,U.S. Senate,James Lankford,REP,720759,0,0,861,861,
Tulsa,U.S. Senate,Robert Murphy,LIB,720759,0,0,46,46,
Tulsa,U.S. Senate,Mike Workman,DEM,720759,0,0,232,232,
Tulsa,U.S. Senate,Mark Beard,IND,720759,0,0,28,28,
Tulsa,U.S. Senate,Sean Braddy,IND,720759,0,0,45,45,
Tulsa,State House,Dale Derby,REP,720759,0,0,741,741,74
Tulsa,State House,Jeri Moberly,DEM,720759,0,0,475,475,74
Tulsa,President,Donald Trump,REP,720760,0,0,883,883,
Tulsa,President,Gary Johnson,LIB,720760,0,0,95,95,
Tulsa,President,Hillary Clinton,DEM,720760,0,0,275,275,
Tulsa,U.S. Senate,James Lankford,REP,720760,0,0,895,895,
Tulsa,U.S. Senate,Robert Murphy,LIB,720760,0,0,47,47,
Tulsa,U.S. Senate,Mike Workman,DEM,720760,0,0,238,238,
Tulsa,U.S. Senate,Mark Beard,IND,720760,0,0,29,29,
Tulsa,U.S. Senate,Sean Braddy,IND,720760,0,0,31,31,
Tulsa,State House,Dale Derby,REP,720760,0,0,799,799,74
Tulsa,State House,Jeri Moberly,DEM,720760,0,0,433,433,74
Tulsa,President,Donald Trump,REP,720801,0,0,642,642,
Tulsa,President,Gary Johnson,LIB,720801,0,0,29,29,
Tulsa,President,Hillary Clinton,DEM,720801,0,0,166,166,
Tulsa,U.S. Senate,James Lankford,REP,720801,0,0,648,648,
Tulsa,U.S. Senate,Robert Murphy,LIB,720801,0,0,17,17,
Tulsa,U.S. Senate,Mike Workman,DEM,720801,0,0,142,142,
Tulsa,U.S. Senate,Mark Beard,IND,720801,0,0,16,16,
Tulsa,U.S. Senate,Sean Braddy,IND,720801,0,0,11,11,
Tulsa,State Senate,Dan Newberry,REP,720801,0,0,423,423,37
Tulsa,State Senate,Lloyd Snow,DEM,720801,0,0,395,395,37
Tulsa,State Senate,Shawn Ketcher,IND,720801,0,0,19,19,37
Tulsa,State House,Jadine Nollan,REP,720801,0,0,664,664,66
Tulsa,State House,Dianna Phillips,DEM,720801,0,0,165,165,66
Tulsa,President,Donald Trump,REP,720802,0,0,406,406,
Tulsa,President,Gary Johnson,LIB,720802,0,0,18,18,
Tulsa,President,Hillary Clinton,DEM,720802,0,0,134,134,
Tulsa,U.S. Senate,James Lankford,REP,720802,0,0,389,389,
Tulsa,U.S. Senate,Robert Murphy,LIB,720802,0,0,19,19,
Tulsa,U.S. Senate,Mike Workman,DEM,720802,0,0,120,120,
Tulsa,U.S. Senate,Mark Beard,IND,720802,0,0,15,15,
Tulsa,U.S. Senate,Sean Braddy,IND,720802,0,0,8,8,
Tulsa,State Senate,Dan Newberry,REP,720802,0,0,334,334,37
Tulsa,State Senate,Lloyd Snow,DEM,720802,0,0,192,192,37
Tulsa,State Senate,Shawn Ketcher,IND,720802,0,0,22,22,37
Tulsa,President,Donald Trump,REP,720851,0,0,513,513,
Tulsa,President,Gary Johnson,LIB,720851,0,0,46,46,
Tulsa,President,Hillary Clinton,DEM,720851,0,0,238,238,
Tulsa,U.S. Senate,James Lankford,REP,720851,0,0,539,539,
Tulsa,U.S. Senate,Robert Murphy,LIB,720851,0,0,31,31,
Tulsa,U.S. Senate,Mike Workman,DEM,720851,0,0,196,196,
Tulsa,U.S. Senate,Mark Beard,IND,720851,0,0,20,20,
Tulsa,U.S. Senate,Sean Braddy,IND,720851,0,0,14,14,
Tulsa,State Senate,Dan Newberry,REP,720851,0,0,348,348,37
Tulsa,State Senate,Lloyd Snow,DEM,720851,0,0,437,437,37
Tulsa,State Senate,Shawn Ketcher,IND,720851,0,0,25,25,37
Tulsa,State House,Jadine Nollan,REP,720851,0,0,592,592,66
Tulsa,State House,Dianna Phillips,DEM,720851,0,0,211,211,66
Tulsa,President,Donald Trump,REP,720852,0,0,400,400,
Tulsa,President,Gary Johnson,LIB,720852,0,0,60,60,
Tulsa,President,Hillary Clinton,DEM,720852,0,0,224,224,
Tulsa,U.S. Senate,James Lankford,REP,720852,0,0,390,390,
Tulsa,U.S. Senate,Robert Murphy,LIB,720852,0,0,32,32,
Tulsa,U.S. Senate,Mike Workman,DEM,720852,0,0,208,208,
Tulsa,U.S. Senate,Mark Beard,IND,720852,0,0,12,12,
Tulsa,U.S. Senate,Sean Braddy,IND,720852,0,0,35,35,
Tulsa,State Senate,Dan Newberry,REP,720852,0,0,257,257,37
Tulsa,State Senate,Lloyd Snow,DEM,720852,0,0,397,397,37
Tulsa,State Senate,Shawn Ketcher,IND,720852,0,0,27,27,37
Tulsa,State House,Jadine Nollan,REP,720852,0,0,454,454,66
Tulsa,State House,Dianna Phillips,DEM,720852,0,0,224,224,66
Tulsa,President,Donald Trump,REP,720853,0,0,525,525,
Tulsa,President,Gary Johnson,LIB,720853,0,0,53,53,
Tulsa,President,Hillary Clinton,DEM,720853,0,0,184,184,
Tulsa,U.S. Senate,James Lankford,REP,720853,0,0,538,538,
Tulsa,U.S. Senate,Robert Murphy,LIB,720853,0,0,24,24,
Tulsa,U.S. Senate,Mike Workman,DEM,720853,0,0,160,160,
Tulsa,U.S. Senate,Mark Beard,IND,720853,0,0,13,13,
Tulsa,U.S. Senate,Sean Braddy,IND,720853,0,0,23,23,
Tulsa,State Senate,Dan Newberry,REP,720853,0,0,394,394,37
Tulsa,State Senate,Lloyd Snow,DEM,720853,0,0,345,345,37
Tulsa,State Senate,Shawn Ketcher,IND,720853,0,0,24,24,37
Tulsa,State House,Jadine Nollan,REP,720853,0,0,552,552,66
Tulsa,State House,Dianna Phillips,DEM,720853,0,0,204,204,66
Tulsa,President,Donald Trump,REP,720854,0,0,1114,1114,
Tulsa,President,Gary Johnson,LIB,720854,0,0,62,62,
Tulsa,President,Hillary Clinton,DEM,720854,0,0,353,353,
Tulsa,U.S. Senate,James Lankford,REP,720854,0,0,1153,1153,
Tulsa,U.S. Senate,Robert Murphy,LIB,720854,0,0,33,33,
Tulsa,U.S. Senate,Mike Workman,DEM,720854,0,0,288,288,
Tulsa,U.S. Senate,Mark Beard,IND,720854,0,0,17,17,
Tulsa,U.S. Senate,Sean Braddy,IND,720854,0,0,24,24,
Tulsa,State Senate,Dan Newberry,REP,720854,0,0,720,720,37
Tulsa,State Senate,Lloyd Snow,DEM,720854,0,0,773,773,37
Tulsa,State Senate,Shawn Ketcher,IND,720854,0,0,41,41,37
Tulsa,State House,Jadine Nollan,REP,720854,0,0,1217,1217,66
Tulsa,State House,Dianna Phillips,DEM,720854,0,0,295,295,66
Tulsa,President,Donald Trump,REP,720855,0,0,1042,1042,
Tulsa,President,Gary Johnson,LIB,720855,0,0,72,72,
Tulsa,President,Hillary Clinton,DEM,720855,0,0,292,292,
Tulsa,U.S. Senate,James Lankford,REP,720855,0,0,1063,1063,
Tulsa,U.S. Senate,Robert Murphy,LIB,720855,0,0,35,35,
Tulsa,U.S. Senate,Mike Workman,DEM,720855,0,0,235,235,
Tulsa,U.S. Senate,Mark Beard,IND,720855,0,0,31,31,
Tulsa,U.S. Senate,Sean Braddy,IND,720855,0,0,32,32,
Tulsa,State Senate,Dan Newberry,REP,720855,0,0,710,710,37
Tulsa,State Senate,Lloyd Snow,DEM,720855,0,0,639,639,37
Tulsa,State Senate,Shawn Ketcher,IND,720855,0,0,56,56,37
Tulsa,State House,Jadine Nollan,REP,720855,0,0,1106,1106,66
Tulsa,State House,Dianna Phillips,DEM,720855,0,0,286,286,66
Tulsa,President,Donald Trump,REP,720856,0,0,1114,1114,
Tulsa,President,Gary Johnson,LIB,720856,0,0,63,63,
Tulsa,President,Hillary Clinton,DEM,720856,0,0,365,365,
Tulsa,U.S. Senate,James Lankford,REP,720856,0,0,1150,1150,
Tulsa,U.S. Senate,Robert Murphy,LIB,720856,0,0,41,41,
Tulsa,U.S. Senate,Mike Workman,DEM,720856,0,0,287,287,
Tulsa,U.S. Senate,Mark Beard,IND,720856,0,0,25,25,
Tulsa,U.S. Senate,Sean Braddy,IND,720856,0,0,25,25,
Tulsa,State Senate,Dan Newberry,REP,720856,0,0,808,808,37
Tulsa,State Senate,Lloyd Snow,DEM,720856,0,0,696,696,37
Tulsa,State Senate,Shawn Ketcher,IND,720856,0,0,34,34,37
Tulsa,State House,Jadine Nollan,REP,720856,0,0,1199,1199,66
Tulsa,State House,Dianna Phillips,DEM,720856,0,0,322,322,66
Tulsa,President,Donald Trump,REP,720857,0,0,680,680,
Tulsa,President,Gary Johnson,LIB,720857,0,0,58,58,
Tulsa,President,Hillary Clinton,DEM,720857,0,0,307,307,
Tulsa,U.S. Senate,James Lankford,REP,720857,0,0,680,680,
Tulsa,U.S. Senate,Robert Murphy,LIB,720857,0,0,28,28,
Tulsa,U.S. Senate,Mike Workman,DEM,720857,0,0,264,264,
Tulsa,U.S. Senate,Mark Beard,IND,720857,0,0,29,29,
Tulsa,U.S. Senate,Sean Braddy,IND,720857,0,0,33,33,
Tulsa,State Senate,Dan Newberry,REP,720857,0,0,463,463,37
Tulsa,State Senate,Lloyd Snow,DEM,720857,0,0,531,531,37
Tulsa,State Senate,Shawn Ketcher,IND,720857,0,0,51,51,37
Tulsa,State House,Jadine Nollan,REP,720857,0,0,706,706,66
Tulsa,State House,Dianna Phillips,DEM,720857,0,0,327,327,66
Tulsa,President,Donald Trump,REP,720858,0,0,385,385,
Tulsa,President,Gary Johnson,LIB,720858,0,0,29,29,
Tulsa,President,Hillary Clinton,DEM,720858,0,0,97,97,
Tulsa,U.S. Senate,James Lankford,REP,720858,0,0,384,384,
Tulsa,U.S. Senate,Robert Murphy,LIB,720858,0,0,20,20,
Tulsa,U.S. Senate,Mike Workman,DEM,720858,0,0,96,96,
Tulsa,U.S. Senate,Mark Beard,IND,720858,0,0,8,8,
Tulsa,U.S. Senate,Sean Braddy,IND,720858,0,0,5,5,
Tulsa,State Senate,Dan Newberry,REP,720858,0,0,291,291,37
Tulsa,State Senate,Lloyd Snow,DEM,720858,0,0,205,205,37
Tulsa,State Senate,Shawn Ketcher,IND,720858,0,0,20,20,37
Tulsa,State House,Kyle Hilbert,REP,720858,0,0,321,321,29
Tulsa,State House,Macy Gleason,DEM,720858,0,0,186,186,29
Tulsa,President,Donald Trump,REP,720880,0,0,896,896,
Tulsa,President,Gary Johnson,LIB,720880,0,0,46,46,
Tulsa,President,Hillary Clinton,DEM,720880,0,0,221,221,
Tulsa,U.S. Senate,James Lankford,REP,720880,0,0,877,877,
Tulsa,U.S. Senate,Robert Murphy,LIB,720880,0,0,36,36,
Tulsa,U.S. Senate,Mike Workman,DEM,720880,0,0,199,199,
Tulsa,U.S. Senate,Mark Beard,IND,720880,0,0,25,25,
Tulsa,U.S. Senate,Sean Braddy,IND,720880,0,0,19,19,
Tulsa,State Senate,Dan Newberry,REP,720880,0,0,678,678,37
Tulsa,State Senate,Lloyd Snow,DEM,720880,0,0,433,433,37
Tulsa,State Senate,Shawn Ketcher,IND,720880,0,0,48,48,37
Tulsa,State House,Kyle Hilbert,REP,720880,0,0,702,702,29
Tulsa,State House,Macy Gleason,DEM,720880,0,0,439,439,29
Tulsa,President,Donald Trump,REP,720881,0,0,597,597,
Tulsa,President,Gary Johnson,LIB,720881,0,0,52,52,
Tulsa,President,Hillary Clinton,DEM,720881,0,0,177,177,
Tulsa,U.S. Senate,James Lankford,REP,720881,0,0,608,608,
Tulsa,U.S. Senate,Robert Murphy,LIB,720881,0,0,19,19,
Tulsa,U.S. Senate,Mike Workman,DEM,720881,0,0,159,159,
Tulsa,U.S. Senate,Mark Beard,IND,720881,0,0,23,23,
Tulsa,U.S. Senate,Sean Braddy,IND,720881,0,0,15,15,
Tulsa,State Senate,Dan Newberry,REP,720881,0,0,411,411,37
Tulsa,State Senate,Lloyd Snow,DEM,720881,0,0,381,381,37
Tulsa,State Senate,Shawn Ketcher,IND,720881,0,0,35,35,37
Tulsa,State House,Jadine Nollan,REP,720881,0,0,623,623,66
Tulsa,State House,Dianna Phillips,DEM,720881,0,0,194,194,66
Tulsa,President,Donald Trump,REP,720900,0,0,1018,1018,
Tulsa,President,Gary Johnson,LIB,720900,0,0,65,65,
Tulsa,President,Hillary Clinton,DEM,720900,0,0,222,222,
Tulsa,U.S. Senate,James Lankford,REP,720900,0,0,1001,1001,
Tulsa,U.S. Senate,Robert Murphy,LIB,720900,0,0,22,22,
Tulsa,U.S. Senate,Mike Workman,DEM,720900,0,0,213,213,
Tulsa,U.S. Senate,Mark Beard,IND,720900,0,0,26,26,
Tulsa,U.S. Senate,Sean Braddy,IND,720900,0,0,32,32,
Tulsa,State House,Sean Roberts,REP,720900,0,0,972,972,36
Tulsa,State House,Cathy Ross,DEM,720900,0,0,313,313,36
Tulsa,President,Donald Trump,REP,729999,8544,8756,0,17300,
Tulsa,President,Gary Johnson,LIB,729999,860,759,0,1619,
Tulsa,President,Hillary Clinton,DEM,729999,6144,8183,0,14327,
Tulsa,U.S. Senate,James Lankford,REP,729999,9669,9464,0,19133,
Tulsa,U.S. Senate,Robert Murphy,LIB,729999,383,480,0,863,
Tulsa,U.S. Senate,Mike Workman,DEM,729999,4928,6960,0,11888,
Tulsa,U.S. Senate,Mark Beard,IND,729999,176,271,0,447,
Tulsa,U.S. Senate,Sean Braddy,IND,729999,378,438,0,816,
Tulsa,State Senate,Joe Newhouse,REP,729999,1931,2153,0,4084,25
Tulsa,State Senate,Robert Founds,DEM,729999,742,1035,0,1777,25
Tulsa,State Senate,Nathan Dahm,REP,729999,1340,1448,0,2788,33
Tulsa,State Senate,Kimberly Fobbs,DEM,729999,729,995,0,1724,33
Tulsa,State Senate,Gary Stanislawski,REP,729999,1606,1538,0,3144,35
Tulsa,State Senate,Frank Grove,LIB,729999,727,963,0,1690,35
Tulsa,State Senate,Dan Newberry,REP,729999,957,928,0,1885,37
Tulsa,State Senate,Lloyd Snow,DEM,729999,676,843,0,1519,37
Tulsa,State Senate,Shawn Ketcher,IND,729999,46,43,0,89,37
Tulsa,State Senate,Dave Rader,REP,729999,1453,1213,0,2666,39
Tulsa,State Senate,John Waldron,DEM,729999,1213,1486,0,2699,39
Tulsa,State House,Scott Fetgatter,REP,729999,11,1,0,12,16
Tulsa,State House,Ronnie Kell,DEM,729999,4,1,0,5,16
Tulsa,State House,Terry O'Donnell,REP,729999,170,151,0,321,23
Tulsa,State House,Keith Welch Sr.,DEM,729999,95,163,0,258,23
Tulsa,State House,Kyle Hilbert,REP,729999,60,41,0,101,29
Tulsa,State House,Macy Gleason,DEM,729999,38,22,0,60,29
Tulsa,State House,Sean Roberts,REP,729999,191,140,0,331,36
Tulsa,State House,Cathy Ross,DEM,729999,56,59,0,115,36
Tulsa,State House,Jadine Nollan,REP,729999,452,461,0,913,66
Tulsa,State House,Dianna Phillips,DEM,729999,240,381,0,621,66
Tulsa,State House,Scott Mceachin,REP,729999,1147,1363,0,2510,67
Tulsa,State House,Zac Davis,LIB,729999,43,66,0,109,67
Tulsa,State House,Lori Decter Wright,DEM,729999,441,670,0,1111,67
Tulsa,State House,Chuck Strohm,REP,729999,979,960,0,1939,69
Tulsa,State House,Paul Sullivan,DEM,729999,502,508,0,1010,69
Tulsa,State House,Carol Bush,REP,729999,931,710,0,1641,70
Tulsa,State House,Tamara Morton,LIB,729999,59,60,0,119,70
Tulsa,State House,Joe Jennings,DEM,729999,550,664,0,1214,70
Tulsa,State House,Katie Henke,REP,729999,640,554,0,1194,71
Tulsa,State House,Millie Hardesty York,DEM,729999,461,602,0,1063,71
Tulsa,State House,Leland Cole,REP,729999,48,116,0,164,73
Tulsa,State House,Regina Goodwin,DEM,729999,504,1100,0,1604,73
Tulsa,State House,Dale Derby,REP,729999,506,339,0,845,74
Tulsa,State House,Jeri Moberly,DEM,729999,319,229,0,548,74
Tulsa,State House,Dan Kirby,REP,729999,449,491,0,940,75
Tulsa,State House,Karen Gaddis,DEM,729999,259,448,0,707,75
Tulsa,State House,David Brumbaugh,REP,729999,669,742,0,1411,76
Tulsa,State House,Glenda Puett,DEM,729999,322,510,0,832,76
Tulsa,State House,Molly Mckay,REP,729999,417,372,0,789,78
Tulsa,State House,Eugene Bell,LIB,729999,34,47,0,81,78
Tulsa,State House,Meloyde Blancett,DEM,729999,549,652,0,1201,78
Tulsa,State House,Weldon Watson,REP,729999,689,701,0,1390,79
Tulsa,State House,Teresa Marler,IND,729999,322,463,0,785,79
Tulsa,State House,Mike Ritze,REP,729999,690,710,0,1400,80
Tulsa,State House,Tom Bates,DEM,729999,371,385,0,756,80
Wagoner,President,Donald Trump,REP,730101,28,6,514,548,
Wagoner,President,Gary Johnson,LIB,730101,3,0,56,59,
Wagoner,President,Hillary Clinton,DEM,730101,11,3,182,196,
Wagoner,U.S. Senate,James Lankford,REP,730101,30,7,495,532,
Wagoner,U.S. Senate,Robert Murphy,LIB,730101,0,0,29,29,
Wagoner,U.S. Senate,Mike Workman,DEM,730101,10,2,180,192,
Wagoner,U.S. Senate,Mark Beard,IND,730101,3,0,26,29,
Wagoner,U.S. Senate,Sean Braddy,IND,730101,0,0,15,15,
Wagoner,State House,Terry O'Donnell,REP,730101,32,7,500,539,23
Wagoner,State House,Keith Welch Sr.,DEM,730101,10,2,238,250,23
Wagoner,President,Donald Trump,REP,730102,35,13,664,712,
Wagoner,President,Gary Johnson,LIB,730102,1,0,37,38,
Wagoner,President,Hillary Clinton,DEM,730102,10,9,130,149,
Wagoner,U.S. Senate,James Lankford,REP,730102,37,13,652,702,
Wagoner,U.S. Senate,Robert Murphy,LIB,730102,0,0,16,16,
Wagoner,U.S. Senate,Mike Workman,DEM,730102,12,8,125,145,
Wagoner,U.S. Senate,Mark Beard,IND,730102,0,1,17,18,
Wagoner,U.S. Senate,Sean Braddy,IND,730102,0,0,16,16,
Wagoner,State House,Tom Gann,REP,730102,38,10,650,698,8
Wagoner,State House,Darrell Moore,DEM,730102,11,12,177,200,8
Wagoner,President,Donald Trump,REP,730103,56,75,1375,1506,
Wagoner,President,Gary Johnson,LIB,730103,7,4,115,126,
Wagoner,President,Hillary Clinton,DEM,730103,31,33,497,561,
Wagoner,U.S. Senate,James Lankford,REP,730103,59,78,1387,1524,
Wagoner,U.S. Senate,Robert Murphy,LIB,730103,5,1,78,84,
Wagoner,U.S. Senate,Mike Workman,DEM,730103,26,33,415,474,
Wagoner,U.S. Senate,Mark Beard,IND,730103,0,0,45,45,
Wagoner,U.S. Senate,Sean Braddy,IND,730103,3,0,52,55,
Wagoner,President,Donald Trump,REP,730104,0,0,0,0,
Wagoner,President,Gary Johnson,LIB,730104,0,0,0,0,
Wagoner,President,Hillary Clinton,DEM,730104,0,0,0,0,
Wagoner,U.S. Senate,James Lankford,REP,730104,0,0,0,0,
Wagoner,U.S. Senate,Robert Murphy,LIB,730104,0,0,0,0,
Wagoner,U.S. Senate,Mike Workman,DEM,730104,0,0,0,0,
Wagoner,U.S. Senate,Mark Beard,IND,730104,0,0,0,0,
Wagoner,U.S. Senate,Sean Braddy,IND,730104,0,0,0,0,
Wagoner,State House,Kevin Mcdugle,REP,730104,0,0,0,0,12
Wagoner,State House,Darla Milligan,DEM,730104,0,0,0,0,12
Wagoner,President,Donald Trump,REP,730105,0,0,8,8,
Wagoner,President,Gary Johnson,LIB,730105,0,0,0,0,
Wagoner,President,Hillary Clinton,DEM,730105,0,0,0,0,
Wagoner,U.S. Senate,James Lankford,REP,730105,0,0,7,7,
Wagoner,U.S. Senate,Robert Murphy,LIB,730105,0,0,1,1,
Wagoner,U.S. Senate,Mike Workman,DEM,730105,0,0,0,0,
Wagoner,U.S. Senate,Mark Beard,IND,730105,0,0,0,0,
Wagoner,U.S. Senate,Sean Braddy,IND,730105,0,0,0,0,
Wagoner,State House,Tom Gann,REP,730105,0,0,7,7,8
Wagoner,State House,Darrell Moore,DEM,730105,0,0,1,1,8
Wagoner,President,Donald Trump,REP,730106,80,111,1265,1456,
Wagoner,President,Gary Johnson,LIB,730106,10,8,131,149,
Wagoner,President,Hillary Clinton,DEM,730106,38,34,438,510,
Wagoner,U.S. Senate,James Lankford,REP,730106,94,112,1316,1522,
Wagoner,U.S. Senate,Robert Murphy,LIB,730106,2,5,66,73,
Wagoner,U.S. Senate,Mike Workman,DEM,730106,33,30,350,413,
Wagoner,U.S. Senate,Mark Beard,IND,730106,1,1,40,42,
Wagoner,U.S. Senate,Sean Braddy,IND,730106,1,2,47,50,
Wagoner,President,Donald Trump,REP,730107,70,106,1137,1313,
Wagoner,President,Gary Johnson,LIB,730107,4,3,103,110,
Wagoner,President,Hillary Clinton,DEM,730107,30,38,339,407,
Wagoner,U.S. Senate,James Lankford,REP,730107,74,101,1144,1319,
Wagoner,U.S. Senate,Robert Murphy,LIB,730107,0,2,47,49,
Wagoner,U.S. Senate,Mike Workman,DEM,730107,29,40,287,356,
Wagoner,U.S. Senate,Mark Beard,IND,730107,0,1,35,36,
Wagoner,U.S. Senate,Sean Braddy,IND,730107,0,0,29,29,
Wagoner,President,Donald Trump,REP,730108,42,56,653,751,
Wagoner,President,Gary Johnson,LIB,730108,5,2,35,42,
Wagoner,President,Hillary Clinton,DEM,730108,16,33,160,209,
Wagoner,U.S. Senate,James Lankford,REP,730108,48,57,666,771,
Wagoner,U.S. Senate,Robert Murphy,LIB,730108,1,3,25,29,
Wagoner,U.S. Senate,Mike Workman,DEM,730108,15,28,138,181,
Wagoner,U.S. Senate,Mark Beard,IND,730108,0,1,13,14,
Wagoner,U.S. Senate,Sean Braddy,IND,730108,0,3,7,10,
Wagoner,State House,Kevin Mcdugle,REP,730108,40,52,623,715,12
Wagoner,State House,Darla Milligan,DEM,730108,24,40,223,287,12
Wagoner,President,Donald Trump,REP,730109,50,67,737,854,
Wagoner,President,Gary Johnson,LIB,730109,4,6,37,47,
Wagoner,President,Hillary Clinton,DEM,730109,15,25,136,176,
Wagoner,U.S. Senate,James Lankford,REP,730109,59,66,751,876,
Wagoner,U.S. Senate,Robert Murphy,LIB,730109,1,3,17,21,
Wagoner,U.S. Senate,Mike Workman,DEM,730109,12,25,114,151,
Wagoner,U.S. Senate,Mark Beard,IND,730109,0,1,15,16,
Wagoner,U.S. Senate,Sean Braddy,IND,730109,0,1,11,12,
Wagoner,State House,Kevin Mcdugle,REP,730109,56,62,695,813,12
Wagoner,State House,Darla Milligan,DEM,730109,13,33,204,250,12
Wagoner,President,Donald Trump,REP,730201,44,68,924,1036,
Wagoner,President,Gary Johnson,LIB,730201,3,3,61,67,
Wagoner,President,Hillary Clinton,DEM,730201,13,23,216,252,
Wagoner,U.S. Senate,James Lankford,REP,730201,47,68,914,1029,
Wagoner,U.S. Senate,Robert Murphy,LIB,730201,1,2,44,47,
Wagoner,U.S. Senate,Mike Workman,DEM,730201,11,21,187,219,
Wagoner,U.S. Senate,Mark Beard,IND,730201,0,0,23,23,
Wagoner,U.S. Senate,Sean Braddy,IND,730201,1,0,22,23,
Wagoner,State House,Kevin Mcdugle,REP,730201,41,60,806,907,12
Wagoner,State House,Darla Milligan,DEM,730201,20,31,383,434,12
Wagoner,President,Donald Trump,REP,730202,31,100,1014,1145,
Wagoner,President,Gary Johnson,LIB,730202,2,8,54,64,
Wagoner,President,Hillary Clinton,DEM,730202,14,11,193,218,
Wagoner,U.S. Senate,James Lankford,REP,730202,32,92,1010,1134,
Wagoner,U.S. Senate,Robert Murphy,LIB,730202,0,3,29,32,
Wagoner,U.S. Senate,Mike Workman,DEM,730202,14,13,184,211,
Wagoner,U.S. Senate,Mark Beard,IND,730202,0,5,12,17,
Wagoner,U.S. Senate,Sean Braddy,IND,730202,0,5,17,22,
Wagoner,State House,Kevin Mcdugle,REP,730202,30,87,847,964,12
Wagoner,State House,Darla Milligan,DEM,730202,16,31,405,452,12
Wagoner,President,Donald Trump,REP,730203,35,204,829,1068,
Wagoner,President,Gary Johnson,LIB,730203,5,11,48,64,
Wagoner,President,Hillary Clinton,DEM,730203,22,69,238,329,
Wagoner,U.S. Senate,James Lankford,REP,730203,31,198,798,1027,
Wagoner,U.S. Senate,Robert Murphy,LIB,730203,4,8,28,40,
Wagoner,U.S. Senate,Mike Workman,DEM,730203,13,60,236,309,
Wagoner,U.S. Senate,Mark Beard,IND,730203,2,4,17,23,
Wagoner,U.S. Senate,Sean Braddy,IND,730203,7,5,28,40,
Wagoner,State House,Kevin Mcdugle,REP,730203,25,161,584,770,12
Wagoner,State House,Darla Milligan,DEM,730203,30,120,522,672,12
Wagoner,President,Donald Trump,REP,730204,22,51,538,611,
Wagoner,President,Gary Johnson,LIB,730204,1,2,23,26,
Wagoner,President,Hillary Clinton,DEM,730204,5,24,176,205,
Wagoner,U.S. Senate,James Lankford,REP,730204,20,49,531,600,
Wagoner,U.S. Senate,Robert Murphy,LIB,730204,1,2,15,18,
Wagoner,U.S. Senate,Mike Workman,DEM,730204,6,22,151,179,
Wagoner,U.S. Senate,Mark Beard,IND,730204,1,1,19,21,
Wagoner,U.S. Senate,Sean Braddy,IND,730204,0,0,16,16,
Wagoner,State House,Kevin Mcdugle,REP,730204,18,46,467,531,12
Wagoner,State House,Darla Milligan,DEM,730204,10,28,257,295,12
Wagoner,President,Donald Trump,REP,730205,1,7,100,108,
Wagoner,President,Gary Johnson,LIB,730205,0,0,6,6,
Wagoner,President,Hillary Clinton,DEM,730205,1,2,30,33,
Wagoner,U.S. Senate,James Lankford,REP,730205,1,7,100,108,
Wagoner,U.S. Senate,Robert Murphy,LIB,730205,0,0,1,1,
Wagoner,U.S. Senate,Mike Workman,DEM,730205,0,2,26,28,
Wagoner,U.S. Senate,Mark Beard,IND,730205,0,0,3,3,
Wagoner,U.S. Senate,Sean Braddy,IND,730205,0,0,3,3,
Wagoner,State House,Kevin Mcdugle,REP,730205,1,7,94,102,12
Wagoner,State House,Darla Milligan,DEM,730205,1,2,38,41,12
Wagoner,President,Donald Trump,REP,730206,0,4,36,40,
Wagoner,President,Gary Johnson,LIB,730206,0,0,2,2,
Wagoner,President,Hillary Clinton,DEM,730206,0,0,8,8,
Wagoner,U.S. Senate,James Lankford,REP,730206,0,4,35,39,
Wagoner,U.S. Senate,Robert Murphy,LIB,730206,0,0,2,2,
Wagoner,U.S. Senate,Mike Workman,DEM,730206,0,0,6,6,
Wagoner,U.S. Senate,Mark Beard,IND,730206,0,0,0,0,
Wagoner,U.S. Senate,Sean Braddy,IND,730206,0,0,2,2,
Wagoner,State House,Kevin Mcdugle,REP,730206,0,3,33,36,12
Wagoner,State House,Darla Milligan,DEM,730206,0,1,11,12,12
Wagoner,President,Donald Trump,REP,730207,5,29,177,211,
Wagoner,President,Gary Johnson,LIB,730207,0,0,30,30,
Wagoner,President,Hillary Clinton,DEM,730207,4,15,212,231,
Wagoner,U.S. Senate,James Lankford,REP,730207,4,28,184,216,
Wagoner,U.S. Senate,Robert Murphy,LIB,730207,1,1,11,13,
Wagoner,U.S. Senate,Mike Workman,DEM,730207,4,15,200,219,
Wagoner,U.S. Senate,Mark Beard,IND,730207,0,0,9,9,
Wagoner,U.S. Senate,Sean Braddy,IND,730207,0,0,12,12,
Wagoner,State House,Kevin Mcdugle,REP,730207,3,25,146,174,12
Wagoner,State House,Darla Milligan,DEM,730207,6,19,274,299,12
Wagoner,President,Donald Trump,REP,730208,47,282,942,1271,
Wagoner,President,Gary Johnson,LIB,730208,3,28,88,119,
Wagoner,President,Hillary Clinton,DEM,730208,14,111,320,445,
Wagoner,U.S. Senate,James Lankford,REP,730208,45,291,911,1247,
Wagoner,U.S. Senate,Robert Murphy,LIB,730208,0,8,31,39,
Wagoner,U.S. Senate,Mike Workman,DEM,730208,18,109,342,469,
Wagoner,U.S. Senate,Mark Beard,IND,730208,0,6,28,34,
Wagoner,U.S. Senate,Sean Braddy,IND,730208,0,4,28,32,
Wagoner,State House,Kevin Mcdugle,REP,730208,37,223,635,895,12
Wagoner,State House,Darla Milligan,DEM,730208,26,193,702,921,12
Wagoner,President,Donald Trump,REP,730209,9,43,240,292,
Wagoner,President,Gary Johnson,LIB,730209,2,1,9,12,
Wagoner,President,Hillary Clinton,DEM,730209,7,16,83,106,
Wagoner,U.S. Senate,James Lankford,REP,730209,11,41,245,297,
Wagoner,U.S. Senate,Robert Murphy,LIB,730209,0,0,5,5,
Wagoner,U.S. Senate,Mike Workman,DEM,730209,7,17,71,95,
Wagoner,U.S. Senate,Mark Beard,IND,730209,0,2,2,4,
Wagoner,U.S. Senate,Sean Braddy,IND,730209,0,0,3,3,
Wagoner,State House,Kevin Mcdugle,REP,730209,8,38,192,238,12
Wagoner,State House,Darla Milligan,DEM,730209,10,23,131,164,12
Wagoner,President,Donald Trump,REP,730210,21,97,786,904,
Wagoner,President,Gary Johnson,LIB,730210,2,5,50,57,
Wagoner,President,Hillary Clinton,DEM,730210,8,32,243,283,
Wagoner,U.S. Senate,James Lankford,REP,730210,21,103,765,889,
Wagoner,U.S. Senate,Robert Murphy,LIB,730210,0,2,22,24,
Wagoner,U.S. Senate,Mike Workman,DEM,730210,10,26,250,286,
Wagoner,U.S. Senate,Mark Beard,IND,730210,0,2,23,25,
Wagoner,U.S. Senate,Sean Braddy,IND,730210,0,1,14,15,
Wagoner,State House,Kevin Mcdugle,REP,730210,11,74,474,559,12
Wagoner,State House,Darla Milligan,DEM,730210,20,61,601,682,12
Wagoner,President,Donald Trump,REP,730301,50,87,846,983,
Wagoner,President,Gary Johnson,LIB,730301,3,2,70,75,
Wagoner,President,Hillary Clinton,DEM,730301,20,29,248,297,
Wagoner,U.S. Senate,James Lankford,REP,730301,54,89,867,1010,
Wagoner,U.S. Senate,Robert Murphy,LIB,730301,4,0,34,38,
Wagoner,U.S. Senate,Mike Workman,DEM,730301,15,26,213,254,
Wagoner,U.S. Senate,Mark Beard,IND,730301,0,1,20,21,
Wagoner,U.S. Senate,Sean Braddy,IND,730301,1,1,20,22,
Wagoner,President,Donald Trump,REP,730302,109,109,1164,1382,
Wagoner,President,Gary Johnson,LIB,730302,8,3,56,67,
Wagoner,President,Hillary Clinton,DEM,730302,43,31,290,364,
Wagoner,U.S. Senate,James Lankford,REP,730302,115,118,1201,1434,
Wagoner,U.S. Senate,Robert Murphy,LIB,730302,3,1,35,39,
Wagoner,U.S. Senate,Mike Workman,DEM,730302,32,24,228,284,
Wagoner,U.S. Senate,Mark Beard,IND,730302,4,0,17,21,
Wagoner,U.S. Senate,Sean Braddy,IND,730302,5,2,23,30,
Wagoner,President,Donald Trump,REP,730303,25,31,491,547,
Wagoner,President,Gary Johnson,LIB,730303,3,3,45,51,
Wagoner,President,Hillary Clinton,DEM,730303,8,10,123,141,
Wagoner,U.S. Senate,James Lankford,REP,730303,25,36,518,579,
Wagoner,U.S. Senate,Robert Murphy,LIB,730303,1,0,20,21,
Wagoner,U.S. Senate,Mike Workman,DEM,730303,8,7,102,117,
Wagoner,U.S. Senate,Mark Beard,IND,730303,2,0,10,12,
Wagoner,U.S. Senate,Sean Braddy,IND,730303,1,1,10,12,
Wagoner,State House,Kevin Mcdugle,REP,730303,25,33,483,541,12
Wagoner,State House,Darla Milligan,DEM,730303,12,11,172,195,12
Wagoner,President,Donald Trump,REP,730304,32,40,735,807,
Wagoner,President,Gary Johnson,LIB,730304,2,4,58,64,
Wagoner,President,Hillary Clinton,DEM,730304,25,15,204,244,
Wagoner,U.S. Senate,James Lankford,REP,730304,34,42,737,813,
Wagoner,U.S. Senate,Robert Murphy,LIB,730304,1,0,30,31,
Wagoner,U.S. Senate,Mike Workman,DEM,730304,22,15,182,219,
Wagoner,U.S. Senate,Mark Beard,IND,730304,1,1,17,19,
Wagoner,U.S. Senate,Sean Braddy,IND,730304,2,0,25,27,
Wagoner,President,Donald Trump,REP,730305,4,13,84,101,
Wagoner,President,Gary Johnson,LIB,730305,0,3,4,7,
Wagoner,President,Hillary Clinton,DEM,730305,1,1,19,21,
Wagoner,U.S. Senate,James Lankford,REP,730305,4,13,82,99,
Wagoner,U.S. Senate,Robert Murphy,LIB,730305,0,2,4,6,
Wagoner,U.S. Senate,Mike Workman,DEM,730305,1,2,16,19,
Wagoner,U.S. Senate,Mark Beard,IND,730305,0,0,3,3,
Wagoner,U.S. Senate,Sean Braddy,IND,730305,0,0,2,2,
Wagoner,State House,Kevin Mcdugle,REP,730305,3,14,81,98,12
Wagoner,State House,Darla Milligan,DEM,730305,2,3,23,28,12
Wagoner,President,Donald Trump,REP,730306,70,61,1079,1210,
Wagoner,President,Gary Johnson,LIB,730306,3,5,63,71,
Wagoner,President,Hillary Clinton,DEM,730306,17,23,246,286,
Wagoner,U.S. Senate,James Lankford,REP,730306,71,62,1075,1208,
Wagoner,U.S. Senate,Robert Murphy,LIB,730306,3,0,47,50,
Wagoner,U.S. Senate,Mike Workman,DEM,730306,14,21,197,232,
Wagoner,U.S. Senate,Mark Beard,IND,730306,0,3,28,31,
Wagoner,U.S. Senate,Sean Braddy,IND,730306,1,2,31,34,
Wagoner,State House,Mike Ritze,REP,730306,71,65,1044,1180,80
Wagoner,State House,Tom Bates,DEM,730306,18,24,320,362,80
Wagoner,President,Donald Trump,REP,730307,57,58,840,955,
Wagoner,President,Gary Johnson,LIB,730307,3,0,42,45,
Wagoner,President,Hillary Clinton,DEM,730307,11,26,153,190,
Wagoner,U.S. Senate,James Lankford,REP,730307,55,61,831,947,
Wagoner,U.S. Senate,Robert Murphy,LIB,730307,1,1,27,29,
Wagoner,U.S. Senate,Mike Workman,DEM,730307,12,21,135,168,
Wagoner,U.S. Senate,Mark Beard,IND,730307,1,0,17,18,
Wagoner,U.S. Senate,Sean Braddy,IND,730307,0,0,18,18,
Wagoner,State House,Scott Fetgatter,REP,730307,56,57,805,918,16
Wagoner,State House,Ronnie Kell,DEM,730307,11,25,211,247,16
Wagoner,President,Donald Trump,REP,730308,35,73,676,784,
Wagoner,President,Gary Johnson,LIB,730308,1,0,27,28,
Wagoner,President,Hillary Clinton,DEM,730308,5,13,178,196,
Wagoner,U.S. Senate,James Lankford,REP,730308,39,72,654,765,
Wagoner,U.S. Senate,Robert Murphy,LIB,730308,0,1,28,29,
Wagoner,U.S. Senate,Mike Workman,DEM,730308,4,14,155,173,
Wagoner,U.S. Senate,Mark Beard,IND,730308,1,0,11,12,
Wagoner,U.S. Senate,Sean Braddy,IND,730308,0,0,22,22,
Wagoner,State House,Scott Fetgatter,REP,730308,36,60,616,712,16
Wagoner,State House,Ronnie Kell,DEM,730308,8,24,242,274,16
Wagoner,President,Donald Trump,REP,730309,24,31,807,862,
Wagoner,President,Gary Johnson,LIB,730309,1,2,60,63,
Wagoner,President,Hillary Clinton,DEM,730309,15,18,198,231,
Wagoner,U.S. Senate,James Lankford,REP,730309,24,31,782,837,
Wagoner,U.S. Senate,Robert Murphy,LIB,730309,1,2,22,25,
Wagoner,U.S. Senate,Mike Workman,DEM,730309,11,18,197,226,
Wagoner,U.S. Senate,Mark Beard,IND,730309,0,0,31,31,
Wagoner,U.S. Senate,Sean Braddy,IND,730309,0,0,26,26,
Wagoner,State House,Kevin Mcdugle,REP,730309,19,28,692,739,12
Wagoner,State House,Darla Milligan,DEM,730309,18,22,364,404,12
Wagoner,President,Donald Trump,REP,730310,15,11,360,386,
Wagoner,President,Gary Johnson,LIB,730310,0,0,23,23,
Wagoner,President,Hillary Clinton,DEM,730310,5,2,69,76,
Wagoner,U.S. Senate,James Lankford,REP,730310,13,11,342,366,
Wagoner,U.S. Senate,Robert Murphy,LIB,730310,0,1,16,17,
Wagoner,U.S. Senate,Mike Workman,DEM,730310,7,1,70,78,
Wagoner,U.S. Senate,Mark Beard,IND,730310,0,0,11,11,
Wagoner,U.S. Senate,Sean Braddy,IND,730310,0,0,8,8,
Wagoner,State House,Scott Fetgatter,REP,730310,12,11,291,314,16
Wagoner,State House,Ronnie Kell,DEM,730310,8,2,153,163,16
Wagoner,President,Donald Trump,REP,730311,5,15,204,224,
Wagoner,President,Gary Johnson,LIB,730311,0,0,4,4,
Wagoner,President,Hillary Clinton,DEM,730311,0,3,57,60,
Wagoner,U.S. Senate,James Lankford,REP,730311,5,17,206,228,
Wagoner,U.S. Senate,Robert Murphy,LIB,730311,0,0,4,4,
Wagoner,U.S. Senate,Mike Workman,DEM,730311,0,3,39,42,
Wagoner,U.S. Senate,Mark Beard,IND,730311,0,0,3,3,
Wagoner,U.S. Senate,Sean Braddy,IND,730311,0,0,10,10,
Wagoner,State House,Scott Fetgatter,REP,730311,5,15,171,191,16
Wagoner,State House,Ronnie Kell,DEM,730311,0,5,89,94,16
Wagoner,President,Donald Trump,REP,730312,36,54,604,694,
Wagoner,President,Gary Johnson,LIB,730312,2,4,34,40,
Wagoner,President,Hillary Clinton,DEM,730312,6,21,161,188,
Wagoner,U.S. Senate,James Lankford,REP,730312,36,60,592,688,
Wagoner,U.S. Senate,Robert Murphy,LIB,730312,2,1,15,18,
Wagoner,U.S. Senate,Mike Workman,DEM,730312,5,17,157,179,
Wagoner,U.S. Senate,Mark Beard,IND,730312,0,1,9,10,
Wagoner,U.S. Senate,Sean Braddy,IND,730312,1,0,22,23,
Wagoner,State House,Kevin Mcdugle,REP,730312,31,50,469,550,12
Wagoner,State House,Darla Milligan,DEM,730312,12,28,327,367,12
Wagoner,President,Donald Trump,REP,730313,7,26,203,236,
Wagoner,President,Gary Johnson,LIB,730313,1,1,14,16,
Wagoner,President,Hillary Clinton,DEM,730313,6,15,90,111,
Wagoner,U.S. Senate,James Lankford,REP,730313,8,27,191,226,
Wagoner,U.S. Senate,Robert Murphy,LIB,730313,0,0,10,10,
Wagoner,U.S. Senate,Mike Workman,DEM,730313,6,12,95,113,
Wagoner,U.S. Senate,Mark Beard,IND,730313,0,1,2,3,
Wagoner,U.S. Senate,Sean Braddy,IND,730313,0,1,5,6,
Wagoner,State House,Kevin Mcdugle,REP,730313,5,21,140,166,12
Wagoner,State House,Darla Milligan,DEM,730313,9,21,163,193,12
Washington,President,Donald Trump,REP,740011,28,123,481,632,
Washington,President,Gary Johnson,LIB,740011,1,10,51,62,
Washington,President,Hillary Clinton,DEM,740011,14,46,186,246,
Washington,U.S. Senate,James Lankford,REP,740011,31,129,533,693,
Washington,U.S. Senate,Robert Murphy,LIB,740011,2,2,24,28,
Washington,U.S. Senate,Mike Workman,DEM,740011,10,39,146,195,
Washington,U.S. Senate,Mark Beard,IND,740011,0,4,14,18,
Washington,U.S. Senate,Sean Braddy,IND,740011,0,2,8,10,
Washington,State Senate,Julie Daniels,REP,740011,30,105,483,618,29
Washington,State Senate,Robert Jobe,DEM,740011,13,71,237,321,29
Washington,President,Donald Trump,REP,740012,7,39,145,191,
Washington,President,Gary Johnson,LIB,740012,3,3,10,16,
Washington,President,Hillary Clinton,DEM,740012,4,9,62,75,
Washington,U.S. Senate,James Lankford,REP,740012,8,46,162,216,
Washington,U.S. Senate,Robert Murphy,LIB,740012,2,0,7,9,
Washington,U.S. Senate,Mike Workman,DEM,740012,4,6,49,59,
Washington,U.S. Senate,Mark Beard,IND,740012,0,0,3,3,
Washington,U.S. Senate,Sean Braddy,IND,740012,0,1,3,4,
Washington,State Senate,Julie Daniels,REP,740012,9,43,146,198,29
Washington,State Senate,Robert Jobe,DEM,740012,5,10,74,89,29
Washington,President,Donald Trump,REP,740013,23,75,650,748,
Washington,President,Gary Johnson,LIB,740013,2,9,43,54,
Washington,President,Hillary Clinton,DEM,740013,5,42,164,211,
Washington,U.S. Senate,James Lankford,REP,740013,21,80,651,752,
Washington,U.S. Senate,Robert Murphy,LIB,740013,2,2,35,39,
Washington,U.S. Senate,Mike Workman,DEM,740013,5,38,141,184,
Washington,U.S. Senate,Mark Beard,IND,740013,0,2,12,14,
Washington,U.S. Senate,Sean Braddy,IND,740013,0,3,17,20,
Washington,State Senate,Julie Daniels,REP,740013,22,72,606,700,29
Washington,State Senate,Robert Jobe,DEM,740013,6,52,244,302,29
Washington,State House,Travis Dunlap,REP,740013,21,80,664,765,10
Washington,State House,Eric Epperson,DEM,740013,5,43,188,236,10
Washington,President,Donald Trump,REP,740015,27,110,712,849,
Washington,President,Gary Johnson,LIB,740015,2,9,68,79,
Washington,President,Hillary Clinton,DEM,740015,13,40,222,275,
Washington,U.S. Senate,James Lankford,REP,740015,30,117,727,874,
Washington,U.S. Senate,Robert Murphy,LIB,740015,0,4,35,39,
Washington,U.S. Senate,Mike Workman,DEM,740015,11,32,187,230,
Washington,U.S. Senate,Mark Beard,IND,740015,0,3,23,26,
Washington,U.S. Senate,Sean Braddy,IND,740015,0,3,21,24,
Washington,State Senate,Julie Daniels,REP,740015,27,109,694,830,29
Washington,State Senate,Robert Jobe,DEM,740015,14,48,296,358,29
Washington,State House,Travis Dunlap,REP,740015,30,119,753,902,10
Washington,State House,Eric Epperson,DEM,740015,12,38,235,285,10
Washington,President,Donald Trump,REP,740022,123,456,1099,1678,
Washington,President,Gary Johnson,LIB,740022,7,34,107,148,
Washington,President,Hillary Clinton,DEM,740022,66,201,309,576,
Washington,U.S. Senate,James Lankford,REP,740022,136,514,1192,1842,
Washington,U.S. Senate,Robert Murphy,LIB,740022,7,16,37,60,
Washington,U.S. Senate,Mike Workman,DEM,740022,51,143,225,419,
Washington,U.S. Senate,Mark Beard,IND,740022,1,11,38,50,
Washington,U.S. Senate,Sean Braddy,IND,740022,2,8,27,37,
Washington,State Senate,Julie Daniels,REP,740022,136,482,1109,1727,29
Washington,State Senate,Robert Jobe,DEM,740022,60,206,395,661,29
Washington,President,Donald Trump,REP,740027,6,53,276,335,
Washington,President,Gary Johnson,LIB,740027,1,0,37,38,
Washington,President,Hillary Clinton,DEM,740027,14,29,102,145,
Washington,U.S. Senate,James Lankford,REP,740027,8,55,281,344,
Washington,U.S. Senate,Robert Murphy,LIB,740027,0,0,14,14,
Washington,U.S. Senate,Mike Workman,DEM,740027,11,22,97,130,
Washington,U.S. Senate,Mark Beard,IND,740027,2,3,14,19,
Washington,U.S. Senate,Sean Braddy,IND,740027,0,1,6,7,
Washington,State Senate,Julie Daniels,REP,740027,9,51,255,315,29
Washington,State Senate,Robert Jobe,DEM,740027,13,32,155,200,29
Washington,State House,Travis Dunlap,REP,740027,6,58,288,352,10
Washington,State House,Eric Epperson,DEM,740027,15,24,117,156,10
Washington,President,Donald Trump,REP,740028,89,330,1282,1701,
Washington,President,Gary Johnson,LIB,740028,14,49,124,187,
Washington,President,Hillary Clinton,DEM,740028,27,155,370,552,
Washington,U.S. Senate,James Lankford,REP,740028,97,378,1385,1860,
Washington,U.S. Senate,Robert Murphy,LIB,740028,3,20,54,77,
Washington,U.S. Senate,Mike Workman,DEM,740028,22,117,278,417,
Washington,U.S. Senate,Mark Beard,IND,740028,3,6,43,52,
Washington,U.S. Senate,Sean Braddy,IND,740028,3,9,32,44,
Washington,State Senate,Julie Daniels,REP,740028,87,352,1286,1725,29
Washington,State Senate,Robert Jobe,DEM,740028,40,172,492,704,29
Washington,President,Donald Trump,REP,740031,41,193,912,1146,
Washington,President,Gary Johnson,LIB,740031,6,21,140,167,
Washington,President,Hillary Clinton,DEM,740031,39,135,476,650,
Washington,U.S. Senate,James Lankford,REP,740031,47,200,961,1208,
Washington,U.S. Senate,Robert Murphy,LIB,740031,2,13,64,79,
Washington,U.S. Senate,Mike Workman,DEM,740031,35,107,391,533,
Washington,U.S. Senate,Mark Beard,IND,740031,1,15,63,79,
Washington,U.S. Senate,Sean Braddy,IND,740031,1,12,51,64,
Washington,State Senate,Julie Daniels,REP,740031,46,198,927,1171,29
Washington,State Senate,Robert Jobe,DEM,740031,36,149,593,778,29
Washington,President,Donald Trump,REP,740033,11,25,329,365,
Washington,President,Gary Johnson,LIB,740033,1,5,48,54,
Washington,President,Hillary Clinton,DEM,740033,8,23,183,214,
Washington,U.S. Senate,James Lankford,REP,740033,9,25,315,349,
Washington,U.S. Senate,Robert Murphy,LIB,740033,0,1,22,23,
Washington,U.S. Senate,Mike Workman,DEM,740033,9,23,174,206,
Washington,U.S. Senate,Mark Beard,IND,740033,0,1,20,21,
Washington,U.S. Senate,Sean Braddy,IND,740033,2,1,22,25,
Washington,State Senate,Julie Daniels,REP,740033,8,24,318,350,29
Washington,State Senate,Robert Jobe,DEM,740033,11,29,227,267,29
Washington,President,Donald Trump,REP,740046,20,29,329,378,
Washington,President,Gary Johnson,LIB,740046,0,2,27,29,
Washington,President,Hillary Clinton,DEM,740046,3,12,148,163,
Washington,U.S. Senate,James Lankford,REP,740046,19,30,323,372,
Washington,U.S. Senate,Robert Murphy,LIB,740046,1,2,19,22,
Washington,U.S. Senate,Mike Workman,DEM,740046,2,8,130,140,
Washington,U.S. Senate,Mark Beard,IND,740046,0,0,13,13,
Washington,U.S. Senate,Sean Braddy,IND,740046,0,3,17,20,
Washington,State Senate,Julie Daniels,REP,740046,18,26,318,362,29
Washington,State Senate,Robert Jobe,DEM,740046,4,16,181,201,29
Washington,State House,Travis Dunlap,REP,740046,19,30,328,377,10
Washington,State House,Eric Epperson,DEM,740046,3,12,173,188,10
Washington,President,Donald Trump,REP,740048,21,58,456,535,
Washington,President,Gary Johnson,LIB,740048,3,8,59,70,
Washington,President,Hillary Clinton,DEM,740048,15,33,166,214,
Washington,U.S. Senate,James Lankford,REP,740048,22,62,460,544,
Washington,U.S. Senate,Robert Murphy,LIB,740048,3,2,23,28,
Washington,U.S. Senate,Mike Workman,DEM,740048,11,23,157,191,
Washington,U.S. Senate,Mark Beard,IND,740048,1,5,22,28,
Washington,U.S. Senate,Sean Braddy,IND,740048,2,6,8,16,
Washington,State Senate,Julie Daniels,REP,740048,23,57,410,490,29
Washington,State Senate,Robert Jobe,DEM,740048,16,41,259,316,29
Washington,State House,Travis Dunlap,REP,740048,24,61,471,556,10
Washington,State House,Eric Epperson,DEM,740048,15,36,196,247,10
Washington,President,Donald Trump,REP,740051,31,153,728,912,
Washington,President,Gary Johnson,LIB,740051,2,11,56,69,
Washington,President,Hillary Clinton,DEM,740051,22,54,201,277,
Washington,U.S. Senate,James Lankford,REP,740051,39,165,776,980,
Washington,U.S. Senate,Robert Murphy,LIB,740051,3,4,19,26,
Washington,U.S. Senate,Mike Workman,DEM,740051,15,41,168,224,
Washington,U.S. Senate,Mark Beard,IND,740051,0,4,14,18,
Washington,U.S. Senate,Sean Braddy,IND,740051,0,3,9,12,
Washington,State Senate,Julie Daniels,REP,740051,33,157,693,883,29
Washington,State Senate,Robert Jobe,DEM,740051,22,59,292,373,29
Washington,State House,Travis Dunlap,REP,740051,38,170,774,982,10
Washington,State House,Eric Epperson,DEM,740051,18,47,209,274,10
Washington,President,Donald Trump,REP,740054,47,150,915,1112,
Washington,President,Gary Johnson,LIB,740054,6,16,95,117,
Washington,President,Hillary Clinton,DEM,740054,27,67,290,384,
Washington,U.S. Senate,James Lankford,REP,740054,52,163,983,1198,
Washington,U.S. Senate,Robert Murphy,LIB,740054,1,4,41,46,
Washington,U.S. Senate,Mike Workman,DEM,740054,23,57,228,308,
Washington,U.S. Senate,Mark Beard,IND,740054,2,4,28,34,
Washington,U.S. Senate,Sean Braddy,IND,740054,1,5,20,26,
Washington,State Senate,Julie Daniels,REP,740054,52,150,905,1107,29
Washington,State Senate,Robert Jobe,DEM,740054,26,81,384,491,29
Washington,President,Donald Trump,REP,740062,49,71,858,978,
Washington,President,Gary Johnson,LIB,740062,1,3,48,52,
Washington,President,Hillary Clinton,DEM,740062,20,18,195,233,
Washington,U.S. Senate,James Lankford,REP,740062,49,75,832,956,
Washington,U.S. Senate,Robert Murphy,LIB,740062,0,2,29,31,
Washington,U.S. Senate,Mike Workman,DEM,740062,19,14,188,221,
Washington,U.S. Senate,Mark Beard,IND,740062,1,1,27,29,
Washington,U.S. Senate,Sean Braddy,IND,740062,0,2,19,21,
Washington,State Senate,Julie Daniels,REP,740062,46,74,757,877,29
Washington,State Senate,Robert Jobe,DEM,740062,23,20,336,379,29
Washington,State House,Travis Dunlap,REP,740062,48,74,814,936,10
Washington,State House,Eric Epperson,DEM,740062,20,20,273,313,10
Washington,President,Donald Trump,REP,740071,23,43,669,735,
Washington,President,Gary Johnson,LIB,740071,2,0,30,32,
Washington,President,Hillary Clinton,DEM,740071,2,14,123,139,
Washington,U.S. Senate,James Lankford,REP,740071,26,47,640,713,
Washington,U.S. Senate,Robert Murphy,LIB,740071,0,0,18,18,
Washington,U.S. Senate,Mike Workman,DEM,740071,2,10,126,138,
Washington,U.S. Senate,Mark Beard,IND,740071,0,1,22,23,
Washington,U.S. Senate,Sean Braddy,IND,740071,0,0,11,11,
Washington,State Senate,Julie Daniels,REP,740071,23,44,498,565,29
Washington,State Senate,Robert Jobe,DEM,740071,5,14,318,337,29
Washington,State House,Travis Dunlap,REP,740071,25,41,613,679,10
Washington,State House,Eric Epperson,DEM,740071,3,16,198,217,10
Washington,President,Donald Trump,REP,740073,12,29,369,410,
Washington,President,Gary Johnson,LIB,740073,3,0,14,17,
Washington,President,Hillary Clinton,DEM,740073,1,13,53,67,
Washington,U.S. Senate,James Lankford,REP,740073,14,33,376,423,
Washington,U.S. Senate,Robert Murphy,LIB,740073,0,0,4,4,
Washington,U.S. Senate,Mike Workman,DEM,740073,0,9,46,55,
Washington,U.S. Senate,Mark Beard,IND,740073,0,0,5,5,
Washington,U.S. Senate,Sean Braddy,IND,740073,2,0,8,10,
Washington,State Senate,Julie Daniels,REP,740073,12,28,312,352,29
Washington,State Senate,Robert Jobe,DEM,740073,3,14,126,143,29
Washington,State House,Travis Dunlap,REP,740073,15,32,359,406,10
Washington,State House,Eric Epperson,DEM,740073,0,10,79,89,10
Washington,President,Donald Trump,REP,740074,9,40,312,361,
Washington,President,Gary Johnson,LIB,740074,0,1,11,12,
Washington,President,Hillary Clinton,DEM,740074,3,10,51,64,
Washington,U.S. Senate,James Lankford,REP,740074,9,41,321,371,
Washington,U.S. Senate,Robert Murphy,LIB,740074,0,1,8,9,
Washington,U.S. Senate,Mike Workman,DEM,740074,3,8,38,49,
Washington,U.S. Senate,Mark Beard,IND,740074,0,0,4,4,
Washington,U.S. Senate,Sean Braddy,IND,740074,0,1,2,3,
Washington,State Senate,Julie Daniels,REP,740074,9,39,262,310,29
Washington,State Senate,Robert Jobe,DEM,740074,3,11,111,125,29
Washington,State House,Travis Dunlap,REP,740074,9,43,296,348,10
Washington,State House,Eric Epperson,DEM,740074,3,7,75,85,10
Washington,President,Donald Trump,REP,740075,18,48,480,546,
Washington,President,Gary Johnson,LIB,740075,3,5,34,42,
Washington,President,Hillary Clinton,DEM,740075,2,11,93,106,
Washington,U.S. Senate,James Lankford,REP,740075,20,54,511,585,
Washington,U.S. Senate,Robert Murphy,LIB,740075,0,1,10,11,
Washington,U.S. Senate,Mike Workman,DEM,740075,2,8,65,75,
Washington,U.S. Senate,Mark Beard,IND,740075,0,0,10,10,
Washington,U.S. Senate,Sean Braddy,IND,740075,0,1,5,6,
Washington,State Senate,Julie Daniels,REP,740075,19,45,444,508,29
Washington,State Senate,Robert Jobe,DEM,740075,3,19,156,178,29
Washington,President,Donald Trump,REP,740076,14,20,363,397,
Washington,President,Gary Johnson,LIB,740076,1,2,11,14,
Washington,President,Hillary Clinton,DEM,740076,3,14,68,85,
Washington,U.S. Senate,James Lankford,REP,740076,13,20,352,385,
Washington,U.S. Senate,Robert Murphy,LIB,740076,0,1,6,7,
Washington,U.S. Senate,Mike Workman,DEM,740076,4,15,66,85,
Washington,U.S. Senate,Mark Beard,IND,740076,0,0,4,4,
Washington,U.S. Senate,Sean Braddy,IND,740076,0,0,9,9,
Washington,State Senate,Julie Daniels,REP,740076,9,19,294,322,29
Washington,State Senate,Robert Jobe,DEM,740076,8,17,140,165,29
Washington,President,Donald Trump,REP,740077,10,27,590,627,
Washington,President,Gary Johnson,LIB,740077,0,0,23,23,
Washington,President,Hillary Clinton,DEM,740077,3,9,107,119,
Washington,U.S. Senate,James Lankford,REP,740077,9,27,570,606,
Washington,U.S. Senate,Robert Murphy,LIB,740077,0,1,12,13,
Washington,U.S. Senate,Mike Workman,DEM,740077,2,8,114,124,
Washington,U.S. Senate,Mark Beard,IND,740077,0,0,10,10,
Washington,U.S. Senate,Sean Braddy,IND,740077,2,0,11,13,
Washington,State Senate,Julie Daniels,REP,740077,10,27,517,554,29
Washington,State Senate,Robert Jobe,DEM,740077,2,9,186,197,29
Washington,President,Donald Trump,REP,740078,16,29,476,521,
Washington,President,Gary Johnson,LIB,740078,3,1,27,31,
Washington,President,Hillary Clinton,DEM,740078,6,10,108,124,
Washington,U.S. Senate,James Lankford,REP,740078,15,31,466,512,
Washington,U.S. Senate,Robert Murphy,LIB,740078,1,0,17,18,
Washington,U.S. Senate,Mike Workman,DEM,740078,6,8,102,116,
Washington,U.S. Senate,Mark Beard,IND,740078,1,0,10,11,
Washington,U.S. Senate,Sean Braddy,IND,740078,1,1,15,17,
Washington,State Senate,Julie Daniels,REP,740078,15,25,429,469,29
Washington,State Senate,Robert Jobe,DEM,740078,8,15,180,203,29
Washington,State House,Travis Dunlap,REP,740078,17,26,461,504,10
Washington,State House,Eric Epperson,DEM,740078,7,14,143,164,10
Washington,President,Donald Trump,REP,740079,8,25,503,536,
Washington,President,Gary Johnson,LIB,740079,3,1,20,24,
Washington,President,Hillary Clinton,DEM,740079,11,5,96,112,
Washington,U.S. Senate,James Lankford,REP,740079,8,26,483,517,
Washington,U.S. Senate,Robert Murphy,LIB,740079,1,0,13,14,
Washington,U.S. Senate,Mike Workman,DEM,740079,13,5,95,113,
Washington,U.S. Senate,Mark Beard,IND,740079,0,0,11,11,
Washington,U.S. Senate,Sean Braddy,IND,740079,0,0,10,10,
Washington,State Senate,Julie Daniels,REP,740079,7,24,432,463,29
Washington,State Senate,Robert Jobe,DEM,740079,15,7,177,199,29
Washington,State House,Travis Dunlap,REP,740079,7,25,467,499,10
Washington,State House,Eric Epperson,DEM,740079,14,6,139,159,10
Washington,President,Donald Trump,REP,740711,10,20,102,132,
Washington,President,Gary Johnson,LIB,740711,0,3,11,14,
Washington,President,Hillary Clinton,DEM,740711,0,7,10,17,
Washington,U.S. Senate,James Lankford,REP,740711,10,24,111,145,
Washington,U.S. Senate,Robert Murphy,LIB,740711,0,2,4,6,
Washington,U.S. Senate,Mike Workman,DEM,740711,0,4,7,11,
Washington,U.S. Senate,Mark Beard,IND,740711,0,0,2,2,
Washington,U.S. Senate,Sean Braddy,IND,740711,0,0,0,0,
Washington,State Senate,Julie Daniels,REP,740711,8,21,98,127,29
Washington,State Senate,Robert Jobe,DEM,740711,2,9,25,36,29
Washington,State House,Travis Dunlap,REP,740711,10,22,106,138,10
Washington,State House,Eric Epperson,DEM,740711,0,8,15,23,10
Washita,President,Donald Trump,REP,750003,11,2,110,123,
Washita,President,Gary Johnson,LIB,750003,2,0,6,8,
Washita,President,Hillary Clinton,DEM,750003,3,1,16,20,
Washita,U.S. Senate,James Lankford,REP,750003,11,1,112,124,
Washita,U.S. Senate,Robert Murphy,LIB,750003,1,0,2,3,
Washita,U.S. Senate,Mike Workman,DEM,750003,2,2,15,19,
Washita,U.S. Senate,Mark Beard,IND,750003,2,0,1,3,
Washita,U.S. Senate,Sean Braddy,IND,750003,0,0,0,0,
Washita,U.S. House,Frank Lucas,REP,750003,10,1,115,126,03
Washita,U.S. House,Frankie Robbins,DEM,750003,6,2,15,23,03
Washita,State House,Todd Russ,REP,750003,10,1,101,112,55
Washita,State House,Wayne Walters,DEM,750003,6,2,30,38,55
Washita,President,Donald Trump,REP,750004,27,183,516,726,
Washita,President,Gary Johnson,LIB,750004,4,8,29,41,
Washita,President,Hillary Clinton,DEM,750004,13,34,104,151,
Washita,U.S. Senate,James Lankford,REP,750004,34,182,534,750,
Washita,U.S. Senate,Robert Murphy,LIB,750004,1,3,16,20,
Washita,U.S. Senate,Mike Workman,DEM,750004,8,37,76,121,
Washita,U.S. Senate,Mark Beard,IND,750004,0,1,12,13,
Washita,U.S. Senate,Sean Braddy,IND,750004,1,4,13,18,
Washita,U.S. House,Frank Lucas,REP,750004,36,189,559,784,03
Washita,U.S. House,Frankie Robbins,DEM,750004,7,36,92,135,03
Washita,State House,Todd Russ,REP,750004,33,139,420,592,55
Washita,State House,Wayne Walters,DEM,750004,10,87,233,330,55
Washita,President,Donald Trump,REP,750007,13,20,303,336,
Washita,President,Gary Johnson,LIB,750007,0,0,17,17,
Washita,President,Hillary Clinton,DEM,750007,1,0,18,19,
Washita,U.S. Senate,James Lankford,REP,750007,14,17,317,348,
Washita,U.S. Senate,Robert Murphy,LIB,750007,0,0,6,6,
Washita,U.S. Senate,Mike Workman,DEM,750007,1,0,16,17,
Washita,U.S. Senate,Mark Beard,IND,750007,0,1,1,2,
Washita,U.S. Senate,Sean Braddy,IND,750007,0,0,0,0,
Washita,U.S. House,Frank Lucas,REP,750007,14,18,321,353,03
Washita,U.S. House,Frankie Robbins,DEM,750007,1,0,19,20,03
Washita,State House,Todd Russ,REP,750007,12,17,282,311,55
Washita,State House,Wayne Walters,DEM,750007,3,3,55,61,55
Washita,President,Donald Trump,REP,750009,7,28,156,191,
Washita,President,Gary Johnson,LIB,750009,1,1,5,7,
Washita,President,Hillary Clinton,DEM,750009,3,1,19,23,
Washita,U.S. Senate,James Lankford,REP,750009,8,29,159,196,
Washita,U.S. Senate,Robert Murphy,LIB,750009,0,1,1,2,
Washita,U.S. Senate,Mike Workman,DEM,750009,3,1,18,22,
Washita,U.S. Senate,Mark Beard,IND,750009,0,0,1,1,
Washita,U.S. Senate,Sean Braddy,IND,750009,0,0,2,2,
Washita,U.S. House,Frank Lucas,REP,750009,8,29,162,199,03
Washita,U.S. House,Frankie Robbins,DEM,750009,3,1,17,21,03
Washita,State House,Todd Russ,REP,750009,6,25,145,176,55
Washita,State House,Wayne Walters,DEM,750009,5,5,35,45,55
Washita,President,Donald Trump,REP,750012,5,12,206,223,
Washita,President,Gary Johnson,LIB,750012,1,0,9,10,
Washita,President,Hillary Clinton,DEM,750012,0,1,27,28,
Washita,U.S. Senate,James Lankford,REP,750012,5,12,197,214,
Washita,U.S. Senate,Robert Murphy,LIB,750012,0,0,6,6,
Washita,U.S. Senate,Mike Workman,DEM,750012,0,1,24,25,
Washita,U.S. Senate,Mark Beard,IND,750012,1,0,8,9,
Washita,U.S. Senate,Sean Braddy,IND,750012,0,0,4,4,
Washita,U.S. House,Frank Lucas,REP,750012,6,13,208,227,03
Washita,U.S. House,Frankie Robbins,DEM,750012,0,0,30,30,03
Washita,State House,Todd Russ,REP,750012,6,8,162,176,55
Washita,State House,Wayne Walters,DEM,750012,0,5,81,86,55
Washita,President,Donald Trump,REP,750014,9,17,447,473,
Washita,President,Gary Johnson,LIB,750014,0,0,14,14,
Washita,President,Hillary Clinton,DEM,750014,2,1,42,45,
Washita,U.S. Senate,James Lankford,REP,750014,9,16,436,461,
Washita,U.S. Senate,Robert Murphy,LIB,750014,0,0,5,5,
Washita,U.S. Senate,Mike Workman,DEM,750014,0,1,43,44,
Washita,U.S. Senate,Mark Beard,IND,750014,1,0,9,10,
Washita,U.S. Senate,Sean Braddy,IND,750014,0,0,10,10,
Washita,U.S. House,Frank Lucas,REP,750014,9,16,446,471,03
Washita,U.S. House,Frankie Robbins,DEM,750014,1,1,56,58,03
Washita,State House,Todd Russ,REP,750014,7,10,260,277,55
Washita,State House,Wayne Walters,DEM,750014,4,7,243,254,55
Washita,President,Donald Trump,REP,750016,28,26,427,481,
Washita,President,Gary Johnson,LIB,750016,1,2,28,31,
Washita,President,Hillary Clinton,DEM,750016,3,3,55,61,
Washita,U.S. Senate,James Lankford,REP,750016,27,29,407,463,
Washita,U.S. Senate,Robert Murphy,LIB,750016,1,0,14,15,
Washita,U.S. Senate,Mike Workman,DEM,750016,4,2,59,65,
Washita,U.S. Senate,Mark Beard,IND,750016,0,0,18,18,
Washita,U.S. Senate,Sean Braddy,IND,750016,0,0,8,8,
Washita,U.S. House,Frank Lucas,REP,750016,28,30,442,500,03
Washita,U.S. House,Frankie Robbins,DEM,750016,4,1,64,69,03
Washita,State House,Todd Russ,REP,750016,24,21,272,317,55
Washita,State House,Wayne Walters,DEM,750016,8,9,237,254,55
Washita,President,Donald Trump,REP,750017,3,21,166,190,
Washita,President,Gary Johnson,LIB,750017,0,0,11,11,
Washita,President,Hillary Clinton,DEM,750017,3,4,29,36,
Washita,U.S. Senate,James Lankford,REP,750017,2,21,174,197,
Washita,U.S. Senate,Robert Murphy,LIB,750017,0,0,6,6,
Washita,U.S. Senate,Mike Workman,DEM,750017,4,3,22,29,
Washita,U.S. Senate,Mark Beard,IND,750017,0,1,2,3,
Washita,U.S. Senate,Sean Braddy,IND,750017,0,0,0,0,
Washita,U.S. House,Frank Lucas,REP,750017,2,20,177,199,03
Washita,U.S. House,Frankie Robbins,DEM,750017,4,5,26,35,03
Washita,State House,Todd Russ,REP,750017,1,14,124,139,55
Washita,State House,Wayne Walters,DEM,750017,5,11,80,96,55
Washita,President,Donald Trump,REP,750018,12,16,209,237,
Washita,President,Gary Johnson,LIB,750018,2,1,11,14,
Washita,President,Hillary Clinton,DEM,750018,4,10,31,45,
Washita,U.S. Senate,James Lankford,REP,750018,12,19,211,242,
Washita,U.S. Senate,Robert Murphy,LIB,750018,0,0,4,4,
Washita,U.S. Senate,Mike Workman,DEM,750018,6,8,26,40,
Washita,U.S. Senate,Mark Beard,IND,750018,0,0,0,0,
Washita,U.S. Senate,Sean Braddy,IND,750018,0,0,6,6,
Washita,U.S. House,Frank Lucas,REP,750018,12,19,208,239,03
Washita,U.S. House,Frankie Robbins,DEM,750018,6,8,39,53,03
Washita,State House,Todd Russ,REP,750018,9,12,127,148,55
Washita,State House,Wayne Walters,DEM,750018,9,15,123,147,55
Washita,President,Donald Trump,REP,750019,13,17,356,386,
Washita,President,Gary Johnson,LIB,750019,0,2,9,11,
Washita,President,Hillary Clinton,DEM,750019,1,2,51,54,
Washita,U.S. Senate,James Lankford,REP,750019,13,17,364,394,
Washita,U.S. Senate,Robert Murphy,LIB,750019,0,0,5,5,
Washita,U.S. Senate,Mike Workman,DEM,750019,1,4,45,50,
Washita,U.S. Senate,Mark Beard,IND,750019,0,0,2,2,
Washita,U.S. Senate,Sean Braddy,IND,750019,0,0,1,1,
Washita,U.S. House,Frank Lucas,REP,750019,12,16,368,396,03
Washita,U.S. House,Frankie Robbins,DEM,750019,2,5,46,53,03
Washita,State House,Todd Russ,REP,750019,8,6,209,223,55
Washita,State House,Wayne Walters,DEM,750019,6,15,208,229,55
Washita,President,Donald Trump,REP,750020,8,11,155,174,
Washita,President,Gary Johnson,LIB,750020,0,0,7,7,
Washita,President,Hillary Clinton,DEM,750020,3,3,27,33,
Washita,U.S. Senate,James Lankford,REP,750020,7,10,156,173,
Washita,U.S. Senate,Robert Murphy,LIB,750020,0,1,1,2,
Washita,U.S. Senate,Mike Workman,DEM,750020,3,3,27,33,
Washita,U.S. Senate,Mark Beard,IND,750020,0,0,1,1,
Washita,U.S. Senate,Sean Braddy,IND,750020,0,0,1,1,
Washita,U.S. House,Frank Lucas,REP,750020,10,11,158,179,03
Washita,U.S. House,Frankie Robbins,DEM,750020,1,3,27,31,03
Washita,State House,Todd Russ,REP,750020,8,11,134,153,55
Washita,State House,Wayne Walters,DEM,750020,2,3,52,57,55
Washita,President,Donald Trump,REP,750030,17,53,244,314,
Washita,President,Gary Johnson,LIB,750030,0,2,16,18,
Washita,President,Hillary Clinton,DEM,750030,6,11,56,73,
Washita,U.S. Senate,James Lankford,REP,750030,19,53,251,323,
Washita,U.S. Senate,Robert Murphy,LIB,750030,0,0,3,3,
Washita,U.S. Senate,Mike Workman,DEM,750030,3,10,50,63,
Washita,U.S. Senate,Mark Beard,IND,750030,0,1,9,10,
Washita,U.S. Senate,Sean Braddy,IND,750030,0,2,2,4,
Washita,U.S. House,Frank Lucas,REP,750030,19,53,261,333,03
Washita,U.S. House,Frankie Robbins,DEM,750030,3,13,53,69,03
Washita,State House,Todd Russ,REP,750030,15,40,190,245,55
Washita,State House,Wayne Walters,DEM,750030,7,26,125,158,55
Woods,President,Donald Trump,REP,760001,30,170,566,766,
Woods,President,Gary Johnson,LIB,760001,2,8,48,58,
Woods,President,Hillary Clinton,DEM,760001,9,61,105,175,
Woods,U.S. Senate,James Lankford,REP,760001,31,180,594,805,
Woods,U.S. Senate,Robert Murphy,LIB,760001,0,6,27,33,
Woods,U.S. Senate,Mike Workman,DEM,760001,8,46,77,131,
Woods,U.S. Senate,Mark Beard,IND,760001,3,3,8,14,
Woods,U.S. Senate,Sean Braddy,IND,760001,0,4,8,12,
Woods,U.S. House,Frank Lucas,REP,760001,34,183,605,822,03
Woods,U.S. House,Frankie Robbins,DEM,760001,8,53,104,165,03
Woods,President,Donald Trump,REP,760002,19,31,457,507,
Woods,President,Gary Johnson,LIB,760002,1,1,30,32,
Woods,President,Hillary Clinton,DEM,760002,5,11,43,59,
Woods,U.S. Senate,James Lankford,REP,760002,20,33,464,517,
Woods,U.S. Senate,Robert Murphy,LIB,760002,0,0,11,11,
Woods,U.S. Senate,Mike Workman,DEM,760002,4,10,37,51,
Woods,U.S. Senate,Mark Beard,IND,760002,1,0,8,9,
Woods,U.S. Senate,Sean Braddy,IND,760002,0,0,9,9,
Woods,U.S. House,Frank Lucas,REP,760002,21,33,469,523,03
Woods,U.S. House,Frankie Robbins,DEM,760002,4,10,55,69,03
Woods,President,Donald Trump,REP,760003,14,60,241,315,
Woods,President,Gary Johnson,LIB,760003,1,3,22,26,
Woods,President,Hillary Clinton,DEM,760003,7,24,56,87,
Woods,U.S. Senate,James Lankford,REP,760003,14,68,266,348,
Woods,U.S. Senate,Robert Murphy,LIB,760003,1,3,9,13,
Woods,U.S. Senate,Mike Workman,DEM,760003,4,15,36,55,
Woods,U.S. Senate,Mark Beard,IND,760003,0,1,3,4,
Woods,U.S. Senate,Sean Braddy,IND,760003,1,0,4,5,
Woods,U.S. House,Frank Lucas,REP,760003,15,69,270,354,03
Woods,U.S. House,Frankie Robbins,DEM,760003,4,16,44,64,03
Woods,President,Donald Trump,REP,760004,9,14,122,145,
Woods,President,Gary Johnson,LIB,760004,1,1,7,9,
Woods,President,Hillary Clinton,DEM,760004,2,5,22,29,
Woods,U.S. Senate,James Lankford,REP,760004,9,16,125,150,
Woods,U.S. Senate,Robert Murphy,LIB,760004,0,0,5,5,
Woods,U.S. Senate,Mike Workman,DEM,760004,3,4,16,23,
Woods,U.S. Senate,Mark Beard,IND,760004,0,0,0,0,
Woods,U.S. Senate,Sean Braddy,IND,760004,0,0,3,3,
Woods,U.S. House,Frank Lucas,REP,760004,9,18,128,155,03
Woods,U.S. House,Frankie Robbins,DEM,760004,3,2,21,26,03
Woods,President,Donald Trump,REP,760005,35,256,687,978,
Woods,President,Gary Johnson,LIB,760005,5,11,53,69,
Woods,President,Hillary Clinton,DEM,760005,11,24,115,150,
Woods,U.S. Senate,James Lankford,REP,760005,36,256,695,987,
Woods,U.S. Senate,Robert Murphy,LIB,760005,2,5,24,31,
Woods,U.S. Senate,Mike Workman,DEM,760005,10,19,100,129,
Woods,U.S. Senate,Mark Beard,IND,760005,1,7,11,19,
Woods,U.S. Senate,Sean Braddy,IND,760005,0,3,17,20,
Woods,U.S. House,Frank Lucas,REP,760005,42,259,714,1015,03
Woods,U.S. House,Frankie Robbins,DEM,760005,7,26,122,155,03
Woods,President,Donald Trump,REP,760008,26,9,201,236,
Woods,President,Gary Johnson,LIB,760008,0,0,5,5,
Woods,President,Hillary Clinton,DEM,760008,2,0,20,22,
Woods,U.S. Senate,James Lankford,REP,760008,24,9,200,233,
Woods,U.S. Senate,Robert Murphy,LIB,760008,2,0,4,6,
Woods,U.S. Senate,Mike Workman,DEM,760008,1,0,14,15,
Woods,U.S. Senate,Mark Beard,IND,760008,0,0,2,2,
Woods,U.S. Senate,Sean Braddy,IND,760008,0,0,4,4,
Woods,U.S. House,Frank Lucas,REP,760008,25,9,198,232,03
Woods,U.S. House,Frankie Robbins,DEM,760008,2,0,21,23,03
Woodward,President,Donald Trump,REP,770101,22,139,442,603,
Woodward,President,Gary Johnson,LIB,770101,1,1,45,47,
Woodward,President,Hillary Clinton,DEM,770101,4,21,78,103,
Woodward,U.S. Senate,James Lankford,REP,770101,23,141,446,610,
Woodward,U.S. Senate,Robert Murphy,LIB,770101,0,2,24,26,
Woodward,U.S. Senate,Mike Workman,DEM,770101,1,13,65,79,
Woodward,U.S. Senate,Mark Beard,IND,770101,1,5,11,17,
Woodward,U.S. Senate,Sean Braddy,IND,770101,0,1,13,14,
Woodward,U.S. House,Frank Lucas,REP,770101,25,141,473,639,03
Woodward,U.S. House,Frankie Robbins,DEM,770101,2,21,78,101,03
Woodward,President,Donald Trump,REP,770102,14,53,294,361,
Woodward,President,Gary Johnson,LIB,770102,0,0,35,35,
Woodward,President,Hillary Clinton,DEM,770102,1,7,54,62,
Woodward,U.S. Senate,James Lankford,REP,770102,14,56,293,363,
Woodward,U.S. Senate,Robert Murphy,LIB,770102,0,1,16,17,
Woodward,U.S. Senate,Mike Workman,DEM,770102,1,3,48,52,
Woodward,U.S. Senate,Mark Beard,IND,770102,0,0,17,17,
Woodward,U.S. Senate,Sean Braddy,IND,770102,0,2,6,8,
Woodward,U.S. House,Frank Lucas,REP,770102,14,58,316,388,03
Woodward,U.S. House,Frankie Robbins,DEM,770102,1,4,62,67,03
Woodward,President,Donald Trump,REP,770104,2,0,3,5,
Woodward,President,Gary Johnson,LIB,770104,0,0,0,0,
Woodward,President,Hillary Clinton,DEM,770104,0,0,0,0,
Woodward,U.S. Senate,James Lankford,REP,770104,2,0,3,5,
Woodward,U.S. Senate,Robert Murphy,LIB,770104,0,0,0,0,
Woodward,U.S. Senate,Mike Workman,DEM,770104,0,0,0,0,
Woodward,U.S. Senate,Mark Beard,IND,770104,0,0,0,0,
Woodward,U.S. Senate,Sean Braddy,IND,770104,0,0,0,0,
Woodward,U.S. House,Frank Lucas,REP,770104,2,0,3,5,03
Woodward,U.S. House,Frankie Robbins,DEM,770104,0,0,0,0,03
Woodward,President,Donald Trump,REP,770105,30,74,692,796,
Woodward,President,Gary Johnson,LIB,770105,2,2,31,35,
Woodward,President,Hillary Clinton,DEM,770105,7,3,75,85,
Woodward,U.S. Senate,James Lankford,REP,770105,31,73,694,798,
Woodward,U.S. Senate,Robert Murphy,LIB,770105,0,2,11,13,
Woodward,U.S. Senate,Mike Workman,DEM,770105,7,1,70,78,
Woodward,U.S. Senate,Mark Beard,IND,770105,1,0,4,5,
Woodward,U.S. Senate,Sean Braddy,IND,770105,0,2,13,15,
Woodward,U.S. House,Frank Lucas,REP,770105,30,76,701,807,03
Woodward,U.S. House,Frankie Robbins,DEM,770105,8,2,83,93,03
Woodward,President,Donald Trump,REP,770106,6,14,71,91,
Woodward,President,Gary Johnson,LIB,770106,0,0,2,2,
Woodward,President,Hillary Clinton,DEM,770106,0,0,9,9,
Woodward,U.S. Senate,James Lankford,REP,770106,6,10,76,92,
Woodward,U.S. Senate,Robert Murphy,LIB,770106,0,1,1,2,
Woodward,U.S. Senate,Mike Workman,DEM,770106,0,0,5,5,
Woodward,U.S. Senate,Mark Beard,IND,770106,0,2,1,3,
Woodward,U.S. Senate,Sean Braddy,IND,770106,0,1,0,1,
Woodward,U.S. House,Frank Lucas,REP,770106,6,14,76,96,03
Woodward,U.S. House,Frankie Robbins,DEM,770106,0,0,6,6,03
Woodward,President,Donald Trump,REP,770201,35,203,570,808,
Woodward,President,Gary Johnson,LIB,770201,2,7,47,56,
Woodward,President,Hillary Clinton,DEM,770201,6,33,104,143,
Woodward,U.S. Senate,James Lankford,REP,770201,35,199,582,816,
Woodward,U.S. Senate,Robert Murphy,LIB,770201,0,1,18,19,
Woodward,U.S. Senate,Mike Workman,DEM,770201,7,31,89,127,
Woodward,U.S. Senate,Mark Beard,IND,770201,0,3,17,20,
Woodward,U.S. Senate,Sean Braddy,IND,770201,0,3,11,14,
Woodward,U.S. House,Frank Lucas,REP,770201,37,199,597,833,03
Woodward,U.S. House,Frankie Robbins,DEM,770201,6,37,116,159,03
Woodward,President,Donald Trump,REP,770202,30,261,755,1046,
Woodward,President,Gary Johnson,LIB,770202,1,15,61,77,
Woodward,President,Hillary Clinton,DEM,770202,11,45,108,164,
Woodward,U.S. Senate,James Lankford,REP,770202,30,268,770,1068,
Woodward,U.S. Senate,Robert Murphy,LIB,770202,1,9,23,33,
Woodward,U.S. Senate,Mike Workman,DEM,770202,11,36,94,141,
Woodward,U.S. Senate,Mark Beard,IND,770202,0,3,19,22,
Woodward,U.S. Senate,Sean Braddy,IND,770202,0,2,15,17,
Woodward,U.S. House,Frank Lucas,REP,770202,33,276,790,1099,03
Woodward,U.S. House,Frankie Robbins,DEM,770202,9,37,120,166,03
Woodward,President,Donald Trump,REP,770203,9,50,369,428,
Woodward,President,Gary Johnson,LIB,770203,1,1,13,15,
Woodward,President,Hillary Clinton,DEM,770203,2,4,32,38,
Woodward,U.S. Senate,James Lankford,REP,770203,12,51,365,428,
Woodward,U.S. Senate,Robert Murphy,LIB,770203,0,0,6,6,
Woodward,U.S. Senate,Mike Workman,DEM,770203,0,4,28,32,
Woodward,U.S. Senate,Mark Beard,IND,770203,0,0,6,6,
Woodward,U.S. Senate,Sean Braddy,IND,770203,0,0,5,5,
Woodward,U.S. House,Frank Lucas,REP,770203,12,50,363,425,03
Woodward,U.S. House,Frankie Robbins,DEM,770203,0,4,41,45,03
Woodward,President,Donald Trump,REP,770204,9,17,162,188,
Woodward,President,Gary Johnson,LIB,770204,0,2,10,12,
Woodward,President,Hillary Clinton,DEM,770204,0,4,14,18,
Woodward,U.S. Senate,James Lankford,REP,770204,9,18,166,193,
Woodward,U.S. Senate,Robert Murphy,LIB,770204,0,2,3,5,
Woodward,U.S. Senate,Mike Workman,DEM,770204,0,4,12,16,
Woodward,U.S. Senate,Mark Beard,IND,770204,0,0,0,0,
Woodward,U.S. Senate,Sean Braddy,IND,770204,0,0,2,2,
Woodward,U.S. House,Frank Lucas,REP,770204,8,19,166,193,03
Woodward,U.S. House,Frankie Robbins,DEM,770204,1,5,14,20,03
Woodward,President,Donald Trump,REP,770301,11,41,136,188,
Woodward,President,Gary Johnson,LIB,770301,0,2,11,13,
Woodward,President,Hillary Clinton,DEM,770301,1,18,25,44,
Woodward,U.S. Senate,James Lankford,REP,770301,11,42,141,194,
Woodward,U.S. Senate,Robert Murphy,LIB,770301,0,1,4,5,
Woodward,U.S. Senate,Mike Workman,DEM,770301,1,17,20,38,
Woodward,U.S. Senate,Mark Beard,IND,770301,0,1,3,4,
Woodward,U.S. Senate,Sean Braddy,IND,770301,0,1,5,6,
Woodward,U.S. House,Frank Lucas,REP,770301,9,46,147,202,03
Woodward,U.S. House,Frankie Robbins,DEM,770301,2,16,24,42,03
Woodward,President,Donald Trump,REP,770302,13,70,176,259,
Woodward,President,Gary Johnson,LIB,770302,0,2,5,7,
Woodward,President,Hillary Clinton,DEM,770302,2,11,12,25,
Woodward,U.S. Senate,James Lankford,REP,770302,14,71,170,255,
Woodward,U.S. Senate,Robert Murphy,LIB,770302,0,1,6,7,
Woodward,U.S. Senate,Mike Workman,DEM,770302,0,9,13,22,
Woodward,U.S. Senate,Mark Beard,IND,770302,0,2,1,3,
Woodward,U.S. Senate,Sean Braddy,IND,770302,0,0,2,2,
Woodward,U.S. House,Frank Lucas,REP,770302,13,73,171,257,03
Woodward,U.S. House,Frankie Robbins,DEM,770302,0,8,18,26,03
Woodward,President,Donald Trump,REP,770303,0,0,0,0,
Woodward,President,Gary Johnson,LIB,770303,0,0,0,0,
Woodward,President,Hillary Clinton,DEM,770303,0,0,0,0,
Woodward,U.S. Senate,James Lankford,REP,770303,0,0,0,0,
Woodward,U.S. Senate,Robert Murphy,LIB,770303,0,0,0,0,
Woodward,U.S. Senate,Mike Workman,DEM,770303,0,0,0,0,
Woodward,U.S. Senate,Mark Beard,IND,770303,0,0,0,0,
Woodward,U.S. Senate,Sean Braddy,IND,770303,0,0,0,0,
Woodward,U.S. House,Frank Lucas,REP,770303,0,0,0,0,03
Woodward,U.S. House,Frankie Robbins,DEM,770303,0,0,0,0,03
Woodward,President,Donald Trump,REP,770304,3,38,150,191,
Woodward,President,Gary Johnson,LIB,770304,0,2,9,11,
Woodward,President,Hillary Clinton,DEM,770304,0,5,16,21,
Woodward,U.S. Senate,James Lankford,REP,770304,2,37,143,182,
Woodward,U.S. Senate,Robert Murphy,LIB,770304,0,2,8,10,
Woodward,U.S. Senate,Mike Workman,DEM,770304,0,4,16,20,
Woodward,U.S. Senate,Mark Beard,IND,770304,1,1,3,5,
Woodward,U.S. Senate,Sean Braddy,IND,770304,0,1,4,5,
Woodward,U.S. House,Frank Lucas,REP,770304,3,36,150,189,03
Woodward,U.S. House,Frankie Robbins,DEM,770304,0,7,22,29,03
Woodward,President,Donald Trump,REP,770306,42,318,898,1258,
Woodward,President,Gary Johnson,LIB,770306,6,9,45,60,
Woodward,President,Hillary Clinton,DEM,770306,9,46,88,143,
Woodward,U.S. Senate,James Lankford,REP,770306,47,314,913,1274,
Woodward,U.S. Senate,Robert Murphy,LIB,770306,1,6,24,31,
Woodward,U.S. Senate,Mike Workman,DEM,770306,10,41,77,128,
Woodward,U.S. Senate,Mark Beard,IND,770306,0,3,8,11,
Woodward,U.S. Senate,Sean Braddy,IND,770306,0,6,7,13,
Woodward,U.S. House,Frank Lucas,REP,770306,49,322,920,1291,03
Woodward,U.S. House,Frankie Robbins,DEM,770306,9,45,101,155,03
Woodward,President,Donald Trump,REP,770307,2,3,120,125,
Woodward,President,Gary Johnson,LIB,770307,0,0,5,5,
Woodward,President,Hillary Clinton,DEM,770307,0,1,17,18,
Woodward,U.S. Senate,James Lankford,REP,770307,2,2,119,123,
Woodward,U.S. Senate,Robert Murphy,LIB,770307,0,0,2,2,
Woodward,U.S. Senate,Mike Workman,DEM,770307,0,2,14,16,
Woodward,U.S. Senate,Mark Beard,IND,770307,0,0,3,3,
Woodward,U.S. Senate,Sean Braddy,IND,770307,0,0,2,2,
Woodward,U.S. House,Frank Lucas,REP,770307,2,4,121,127,03
Woodward,U.S. House,Frankie Robbins,DEM,770307,0,0,17,17,03
Woodward,State House,Casey Murdock,REP,770307,2,3,115,120,61
Woodward,State House,Ashlee Renee Ortiz,DEM,770307,0,1,23,24,61
